Unnamed_0,time_index,RNA_nuc,RNA_cyto,RNA_total,rep,conc
13,0,42,78,120,1,0
316,0,11,15,26,2,0
229,0,47,111,158,1,0
127,0,31,35,66,2,0
277,0,14,33,47,3,0
360,0,3,21,24,3,0
129,0,23,31,54,1,0
145,0,3,3,6,1,0
296,0,8,22,30,1,0
143,0,2,2,4,1,0
24,0,32,97,129,1,0
86,0,31,30,61,2,0
77,0,15,35,50,3,0
321,0,18,50,68,3,0
77,0,27,47,74,2,0
76,0,37,93,130,1,0
316,0,20,34,54,3,0
396,0,35,42,77,1,0
280,0,56,129,185,1,0
251,0,8,30,38,2,0
182,0,19,31,50,3,0
428,0,3,19,22,3,0
193,0,33,110,143,2,0
361,0,40,63,103,1,0
20,0,42,70,112,3,0
183,0,11,25,36,2,0
332,0,39,112,151,2,0
80,0,22,44,66,1,0
16,0,37,66,103,1,0
22,0,3,7,10,2,0
319,0,14,31,45,3,0
346,0,23,8,31,3,0
124,0,26,42,68,3,0
245,0,15,18,33,3,0
166,0,13,28,41,3,0
202,0,12,48,60,3,0
94,0,41,85,126,3,0
213,0,4,18,22,1,0
31,0,15,56,71,2,0
449,0,17,27,44,3,0
173,0,26,75,101,1,0
382,0,6,10,16,3,0
260,0,5,15,20,3,0
362,0,7,19,26,3,0
26,0,20,44,64,3,0
185,0,19,52,71,3,0
38,0,22,43,65,3,0
269,0,14,25,39,1,0
177,0,37,84,121,3,0
239,0,10,19,29,2,0
201,0,9,15,24,1,0
202,0,7,19,26,2,0
274,0,4,29,33,1,0
320,0,43,70,113,3,0
323,0,1,4,5,2,0
204,0,10,28,38,2,0
358,0,20,44,64,3,0
308,0,1,4,5,2,0
124,0,32,100,132,1,0
73,0,0,2,2,2,0
216,0,10,24,34,1,0
168,0,0,12,12,1,0
133,0,16,32,48,2,0
321,0,19,43,62,2,0
163,0,33,40,73,2,0
194,0,22,41,63,3,0
233,0,3,8,11,2,0
37,0,17,36,53,2,0
335,0,6,28,34,3,0
271,0,21,49,70,3,0
290,0,35,34,69,3,0
285,0,8,9,17,1,0
280,0,11,36,47,2,0
67,0,20,58,78,3,0
305,0,17,44,61,3,0
40,0,48,144,192,3,0
273,0,24,74,98,2,0
472,0,15,27,42,3,0
146,0,18,49,67,3,0
383,0,27,68,95,3,0
237,0,13,32,45,2,0
158,0,46,65,111,2,0
227,0,21,32,53,3,0
297,0,19,18,37,1,0
75,0,26,50,76,1,0
149,0,2,12,14,3,0
236,0,4,14,18,2,0
13,0,25,69,94,3,0
135,0,3,8,11,2,0
176,0,13,41,54,2,0
183,0,20,24,44,1,0
84,0,19,13,32,1,0
70,0,6,40,46,2,0
347,0,7,20,27,2,0
23,0,45,68,113,3,0
244,0,12,38,50,1,0
196,0,28,45,73,2,0
306,0,0,10,10,1,0
195,0,24,59,83,1,0
103,0,53,53,106,3,0
3475,90,27,91,118,1,100
3285,90,17,25,42,2,100
3448,90,129,178,307,2,100
3362,90,27,85,112,1,100
3380,90,4,32,36,1,100
4153,90,109,92,201,3,100
4169,90,19,27,46,3,100
4228,90,107,290,397,3,100
3365,90,45,76,121,1,100
4316,90,44,171,215,3,100
3290,90,24,76,100,1,100
3322,90,93,201,294,2,100
3383,90,65,141,206,1,100
3963,90,99,166,265,3,100
3499,90,70,113,183,1,100
3403,90,12,74,86,1,100
4077,90,60,55,115,3,100
4311,90,71,121,192,3,100
3602,90,38,71,109,1,100
3229,90,151,258,409,2,100
4015,90,115,193,308,3,100
3906,90,105,157,262,3,100
3512,90,97,167,264,1,100
3431,90,33,97,130,1,100
3914,90,113,72,185,3,100
3939,90,68,181,249,3,100
3241,90,58,123,181,2,100
4088,90,52,71,123,3,100
3537,90,190,425,615,1,100
3322,90,81,210,291,1,100
4243,90,103,155,258,3,100
3399,90,49,66,115,1,100
3310,90,69,161,230,1,100
3330,90,41,90,131,1,100
4061,90,56,71,127,3,100
3414,90,188,303,491,1,100
3429,90,133,199,332,2,100
4315,90,32,49,81,3,100
3937,90,23,16,39,3,100
3440,90,77,111,188,2,100
3459,90,67,66,133,2,100
4312,90,31,40,71,3,100
3318,90,28,62,90,1,100
4318,90,27,81,108,3,100
3989,90,48,67,115,3,100
3960,90,101,196,297,3,100
3418,90,97,274,371,1,100
3503,90,29,36,65,1,100
3466,90,127,200,327,2,100
3182,90,165,190,355,2,100
3998,90,94,74,168,3,100
3908,90,11,21,32,3,100
3234,90,63,154,217,2,100
3553,90,44,99,143,1,100
3300,90,35,36,71,2,100
4277,90,104,255,359,3,100
4236,90,155,205,360,3,100
4167,90,117,206,323,3,100
3508,90,33,57,90,1,100
3564,90,40,75,115,1,100
4216,90,203,422,625,3,100
3238,90,90,126,216,2,100
3562,90,208,228,436,1,100
3325,90,173,287,460,1,100
3930,90,49,74,123,3,100
4124,90,59,122,181,3,100
4161,90,56,98,154,3,100
3276,90,58,123,181,2,100
3557,90,29,94,123,1,100
3593,90,78,105,183,1,100
3419,90,140,196,336,2,100
3617,90,83,149,232,1,100
3173,90,193,277,470,2,100
4334,90,55,146,201,3,100
4260,90,116,210,326,3,100
3923,90,70,131,201,3,100
4035,90,66,96,162,3,100
4317,90,83,115,198,3,100
3342,90,52,107,159,2,100
3889,90,98,180,278,3,100
3992,90,108,137,245,3,100
4278,90,86,120,206,3,100
4099,90,143,238,381,3,100
3134,90,82,207,289,2,100
4221,90,48,62,110,3,100
4224,90,29,38,67,3,100
4341,90,80,165,245,3,100
3881,90,33,46,79,3,100
4340,90,283,284,567,3,100
3337,90,173,257,430,2,100
4079,90,121,154,275,3,100
3253,90,84,182,266,2,100
3494,90,98,158,256,1,100
3588,90,82,132,214,1,100
3953,90,45,36,81,3,100
3411,90,24,37,61,2,100
3427,90,99,153,252,2,100
3352,90,118,252,370,1,100
3263,90,88,154,242,1,100
4047,90,111,76,187,3,100
4596,180,61,120,181,2,100
4572,180,133,220,353,2,100
4569,180,85,187,272,2,100
4538,180,80,143,223,2,100
4454,180,8,18,26,2,100
4891,180,86,198,284,1,100
5410,180,74,43,117,3,100
4732,180,29,46,75,1,100
5775,180,79,67,146,3,100
4455,180,8,6,14,2,100
5802,180,140,143,283,3,100
5660,180,33,71,104,3,100
4639,180,150,344,494,1,100
4435,180,87,88,175,2,100
5681,180,101,135,236,3,100
4696,180,71,99,170,1,100
4607,180,87,140,227,2,100
4700,180,61,76,137,1,100
5647,180,208,205,413,3,100
4670,180,52,82,134,1,100
4303,180,50,94,144,2,100
4460,180,131,73,204,2,100
4579,180,86,150,236,2,100
4875,180,42,73,115,1,100
5738,180,77,66,143,3,100
4256,180,39,64,103,2,100
4442,180,95,174,269,2,100
5650,180,81,134,215,3,100
4681,180,59,134,193,1,100
5453,180,98,137,235,3,100
5491,180,47,114,161,3,100
5516,180,19,41,60,3,100
4771,180,74,127,201,1,100
4674,180,8,11,19,1,100
4666,180,61,211,272,1,100
4423,180,98,253,351,2,100
5676,180,74,146,220,3,100
4721,180,8,26,34,1,100
4999,180,18,17,35,1,100
4592,180,41,65,106,2,100
4899,180,27,72,99,1,100
5807,180,36,51,87,3,100
4592,180,86,128,214,1,100
5662,180,28,117,145,3,100
5588,180,24,46,70,3,100
4404,180,35,58,93,2,100
4580,180,146,184,330,2,100
4691,180,39,132,171,1,100
4825,180,55,53,108,1,100
5706,180,53,123,176,3,100
5349,180,76,120,196,3,100
5653,180,99,182,281,3,100
5810,180,78,113,191,3,100
4634,180,89,159,248,1,100
4800,180,47,100,147,1,100
5464,180,16,39,55,3,100
4927,180,50,99,149,1,100
5716,180,82,77,159,3,100
4627,180,44,77,121,1,100
5759,180,17,39,56,3,100
4583,180,57,71,128,2,100
4805,180,107,191,298,1,100
4500,180,22,34,56,2,100
4474,180,30,33,63,2,100
4549,180,40,64,104,2,100
4924,180,27,48,75,1,100
5760,180,21,18,39,3,100
4892,180,21,46,67,1,100
5632,180,144,176,320,3,100
4939,180,37,34,71,1,100
5594,180,55,70,125,3,100
4600,180,54,117,171,2,100
4624,180,157,203,360,1,100
4638,180,109,193,302,2,100
5688,180,60,106,166,3,100
5485,180,89,172,261,3,100
5343,180,72,143,215,3,100
4965,180,23,73,96,1,100
4984,180,28,83,111,1,100
5609,180,81,191,272,3,100
4295,180,69,84,153,2,100
4750,180,86,122,208,1,100
5602,180,91,96,187,3,100
5361,180,109,119,228,3,100
5616,180,104,205,309,3,100
4735,180,44,146,190,1,100
5465,180,72,138,210,3,100
4755,180,40,113,153,1,100
5808,180,32,57,89,3,100
4714,180,122,109,231,1,100
4331,180,259,356,615,2,100
4968,180,9,28,37,1,100
4930,180,52,149,201,1,100
5527,180,33,55,88,3,100
5556,180,40,94,134,3,100
4587,180,99,138,237,2,100
4429,180,69,83,152,2,100
5586,180,132,254,386,3,100
4432,180,57,88,145,2,100
4621,180,15,38,53,1,100
