Unnamed_0,time_index,RNA_nuc,RNA_cyto,RNA_total,rep,conc
194,0,69,105,174,1,0
171,0,80,188,268,1,0
81,0,5,32,37,1,0
72,0,58,70,128,1,0
186,0,19,44,63,1,0
202,0,9,52,61,1,0
397,0,29,84,113,1,0
410,0,65,138,203,1,0
369,0,11,20,31,1,0
143,0,2,2,4,1,0
164,0,7,13,20,1,0
233,0,4,8,12,1,0
106,0,2,5,7,1,0
260,0,8,16,24,1,0
278,0,27,34,61,1,0
50,0,10,8,18,1,0
400,0,43,111,154,1,0
49,0,13,3,16,1,0
205,0,9,12,21,1,0
123,0,56,40,96,1,0
408,0,0,0,0,1,0
112,0,17,26,43,1,0
232,0,19,60,79,1,0
73,0,56,43,99,1,0
36,0,24,41,65,1,0
282,0,28,58,86,1,0
2,0,77,100,177,1,0
29,0,8,24,32,1,0
395,0,15,65,80,1,0
331,0,7,12,19,1,0
146,0,27,37,64,1,0
349,0,24,55,79,1,0
214,0,32,58,90,1,0
270,0,13,18,31,1,0
29,0,8,24,32,1,0
201,0,9,15,24,1,0
338,0,11,15,26,1,0
236,0,9,30,39,1,0
68,0,115,109,224,1,0
320,0,46,62,108,1,0
51,0,40,77,117,1,0
80,0,22,44,66,1,0
449,10,19,19,38,1,100
31,0,44,47,91,1,0
281,0,5,15,20,1,0
471,10,54,81,135,1,100
295,0,5,20,25,1,0
326,0,4,12,16,1,0
266,0,24,42,66,1,0
161,0,23,18,41,1,0
331,0,7,12,19,1,0
236,0,9,30,39,1,0
121,0,9,8,17,1,0
328,0,19,29,48,1,0
299,0,69,74,143,1,0
465,10,9,4,13,1,100
326,0,4,12,16,1,0
89,0,19,42,61,1,0
190,0,4,20,24,1,0
351,0,3,4,7,1,0
144,0,14,27,41,1,0
371,0,6,8,14,1,0
106,0,2,5,7,1,0
431,10,25,62,87,1,100
332,0,4,2,6,1,0
167,0,10,14,24,1,0
200,0,24,50,74,1,0
170,0,66,129,195,1,0
103,0,28,47,75,1,0
335,0,8,46,54,1,0
178,0,18,36,54,1,0
192,0,3,15,18,1,0
80,0,22,44,66,1,0
28,0,14,35,49,1,0
3,0,7,63,70,1,0
107,0,13,37,50,1,0
8,0,50,91,141,1,0
19,0,11,18,29,1,0
160,0,29,50,79,1,0
108,0,7,23,30,1,0
118,0,2,7,9,1,0
179,0,21,56,77,1,0
3,0,7,63,70,1,0
112,0,17,26,43,1,0
208,0,16,25,41,1,0
200,0,24,50,74,1,0
322,0,23,77,100,1,0
342,0,8,6,14,1,0
227,0,42,87,129,1,0
168,0,0,12,12,1,0
232,0,19,60,79,1,0
60,0,29,42,71,1,0
278,0,27,34,61,1,0
321,0,20,26,46,1,0
9,0,14,39,53,1,0
313,0,34,96,130,1,0
488,10,38,62,100,1,100
120,0,9,35,44,1,0
189,0,19,26,45,1,0
396,0,35,42,77,1,0
3131,75,30,72,102,1,100
4325,150,60,119,179,1,100
3300,90,67,156,223,1,100
4034,120,48,90,138,1,100
3941,120,100,144,244,1,100
4091,150,47,133,180,1,100
3573,90,46,64,110,1,100
3587,90,132,329,461,1,100
3995,120,41,48,89,1,100
3468,90,75,127,202,1,100
4132,150,72,93,165,1,100
3450,90,91,217,308,1,100
4273,150,22,52,74,1,100
3998,120,58,64,122,1,100
3407,90,101,131,232,1,100
4151,150,8,44,52,1,100
4243,150,112,217,329,1,100
3400,90,117,155,272,1,100
3204,75,76,392,468,1,100
3254,90,64,108,172,1,100
3968,120,26,66,92,1,100
3555,90,75,153,228,1,100
3281,90,63,76,139,1,100
4256,150,69,159,228,1,100
4312,150,85,91,176,1,100
4056,120,95,174,269,1,100
4302,150,25,58,83,1,100
3304,90,53,100,153,1,100
3398,90,88,208,296,1,100
3276,90,136,371,507,1,100
4009,120,54,129,183,1,100
3927,120,40,82,122,1,100
4161,150,60,122,182,1,100
4025,120,45,96,141,1,100
3452,90,38,35,73,1,100
3568,90,107,238,345,1,100
3124,75,48,75,123,1,100
4112,150,14,42,56,1,100
3181,75,68,155,223,1,100
3341,90,30,96,126,1,100
4144,150,12,9,21,1,100
3237,75,65,136,201,1,100
3447,90,99,143,242,1,100
3252,90,126,231,357,1,100
3894,120,35,99,134,1,100
3159,75,79,79,158,1,100
3166,75,52,189,241,1,100
3241,75,106,183,289,1,100
3327,90,65,129,194,1,100
3594,90,51,112,163,1,100
3283,90,93,151,244,1,100
3255,90,301,681,982,1,100
3445,90,26,115,141,1,100
3596,90,83,203,286,1,100
3993,120,73,110,183,1,100
3398,90,88,208,296,1,100
3942,120,5,37,42,1,100
4060,120,45,66,111,1,100
4113,150,30,47,77,1,100
3382,90,49,126,175,1,100
3889,120,98,124,222,1,100
4327,150,15,24,39,1,100
3939,120,46,104,150,1,100
3421,90,40,158,198,1,100
3291,90,81,186,267,1,100
3469,90,87,136,223,1,100
3623,90,51,93,144,1,100
3461,90,69,175,244,1,100
3494,90,98,158,256,1,100
3335,90,110,289,399,1,100
4249,150,33,83,116,1,100
3481,90,46,116,162,1,100
4250,150,11,23,34,1,100
4277,150,25,30,55,1,100
3527,90,49,51,100,1,100
3315,90,62,116,178,1,100
4336,150,14,36,50,1,100
3540,90,112,165,277,1,100
3376,90,226,483,709,1,100
3349,90,44,56,100,1,100
3493,90,105,179,284,1,100
3597,90,24,32,56,1,100
4228,150,18,21,39,1,100
3593,90,78,105,183,1,100
4196,150,16,53,69,1,100
3190,75,70,161,231,1,100
3259,90,19,53,72,1,100
4257,150,42,152,194,1,100
3420,90,67,117,184,1,100
4245,150,25,63,88,1,100
3232,75,98,201,299,1,100
3337,90,48,144,192,1,100
3539,90,99,233,332,1,100
4117,150,138,157,295,1,100
3362,90,27,85,112,1,100
4050,120,64,138,202,1,100
4322,150,64,130,194,1,100
4155,150,50,54,104,1,100
3314,90,48,105,153,1,100
4099,150,29,40,69,1,100
4276,150,14,38,52,1,100
4340,150,32,38,70,1,100
4605,180,65,130,195,1,100
690,10,24,48,72,2,100
4749,180,98,190,288,1,100
4627,180,44,77,121,1,100
4339,150,41,104,145,1,100
4599,180,19,40,59,1,100
696,10,31,51,82,2,100
4963,180,50,144,194,1,100
4530,150,32,55,87,1,100
509,10,6,22,28,2,100
5007,180,101,175,276,1,100
4697,180,99,56,155,1,100
4390,150,40,87,127,1,100
4609,180,114,252,366,1,100
364,10,51,83,134,2,100
4719,180,68,116,184,1,100
4836,180,88,170,258,1,100
4505,150,45,45,90,1,100
4633,180,123,212,335,1,100
4297,150,36,72,108,1,100
4604,180,38,45,83,1,100
585,10,18,24,42,2,100
393,10,56,99,155,2,100
4320,150,21,35,56,1,100
4556,150,59,114,173,1,100
4900,180,21,49,70,1,100
424,10,11,5,16,2,100
4254,150,44,77,121,1,100
4674,180,8,11,19,1,100
4968,180,9,28,37,1,100
4965,180,23,73,96,1,100
4601,180,37,86,123,1,100
4802,180,41,65,106,1,100
594,10,71,146,217,2,100
325,0,5,32,37,2,0
587,10,11,30,41,2,100
4925,180,69,133,202,1,100
637,10,13,15,28,2,100
4843,180,98,129,227,1,100
724,10,36,26,62,2,100
4342,150,52,79,131,1,100
4870,180,47,80,127,1,100
531,10,3,10,13,2,100
4270,150,56,90,146,1,100
4453,150,29,28,57,1,100
437,10,19,41,60,2,100
545,10,14,6,20,2,100
4313,150,26,49,75,1,100
4696,180,71,99,170,1,100
4914,180,33,68,101,1,100
490,10,24,32,56,2,100
677,10,50,94,144,2,100
4536,150,40,73,113,1,100
676,10,81,144,225,2,100
4572,180,93,184,277,1,100
739,10,9,15,24,2,100
447,10,4,16,20,2,100
4809,180,51,94,145,1,100
4466,150,78,123,201,1,100
4624,180,157,203,360,1,100
581,10,34,38,72,2,100
4571,150,5,12,17,1,100
747,10,7,16,23,2,100
4736,180,27,67,94,1,100
4946,180,31,72,103,1,100
4411,150,31,75,106,1,100
746,10,44,122,166,2,100
4862,180,24,45,69,1,100
777,20,11,26,37,2,100
322,0,2,14,16,2,0
4986,180,76,67,143,1,100
472,10,22,39,61,2,100
4496,150,5,16,21,1,100
4864,180,38,46,84,1,100
338,0,29,58,87,2,0
4633,180,123,212,335,1,100
4528,150,10,14,24,1,100
725,10,4,6,10,2,100
4261,150,81,135,216,1,100
4508,150,71,149,220,1,100
638,10,11,14,25,2,100
4899,180,27,72,99,1,100
516,10,18,28,46,2,100
4791,180,132,220,352,1,100
574,10,33,58,91,2,100
4923,180,41,62,103,1,100
534,10,69,152,221,2,100
480,10,14,19,33,2,100
4808,180,61,109,170,1,100
694,10,36,63,99,2,100
4889,180,72,107,179,1,100
441,10,19,26,45,2,100
481,10,3,3,6,2,100
4424,150,43,110,153,1,100
610,10,31,32,63,2,100
798,20,24,64,88,2,100
4740,180,126,229,355,1,100
536,10,18,13,31,2,100
