Unnamed: 0,time_index,RNA_nuc,RNA_cyto,RNA_total,rep,conc
0,0,19,93,112,1,0.0
1,0,12,107,119,1,0.0
2,0,62,293,355,1,0.0
3,0,34,221,255,1,0.0
4,0,10,45,55,1,0.0
5,0,33,175,208,1,0.0
6,0,31,186,217,1,0.0
7,0,24,171,195,1,0.0
8,0,1,11,12,1,0.0
9,0,16,93,109,1,0.0
10,0,2,9,11,1,0.0
11,0,3,29,32,1,0.0
12,0,21,158,179,1,0.0
13,0,24,167,191,1,0.0
14,0,17,91,108,1,0.0
15,0,3,23,26,1,0.0
16,0,19,62,81,1,0.0
17,0,13,33,46,1,0.0
18,0,15,113,128,1,0.0
19,0,46,148,194,1,0.0
20,0,19,84,103,1,0.0
21,0,33,111,144,1,0.0
22,0,44,230,274,1,0.0
23,0,15,74,89,1,0.0
24,0,27,175,202,1,0.0
25,0,17,79,96,1,0.0
26,0,8,51,59,1,0.0
27,0,32,107,139,1,0.0
28,0,34,142,176,1,0.0
29,0,77,198,275,1,0.0
30,0,49,196,245,1,0.0
31,0,46,238,284,1,0.0
32,0,27,118,145,1,0.0
33,0,30,86,116,1,0.0
34,0,48,76,124,1,0.0
35,0,75,226,301,1,0.0
36,0,20,47,67,1,0.0
37,0,5,12,17,1,0.0
38,0,28,56,84,1,0.0
39,0,2,2,4,1,0.0
40,0,4,16,20,1,0.0
41,0,15,58,73,1,0.0
42,0,13,34,47,1,0.0
43,0,53,148,201,1,0.0
44,0,15,100,115,1,0.0
45,0,28,62,90,1,0.0
46,0,17,182,199,1,0.0
47,0,27,128,155,1,0.0
48,0,58,278,336,1,0.0
49,0,11,52,63,1,0.0
50,0,48,130,178,1,0.0
51,0,23,10,33,1,0.0
52,0,47,209,256,1,0.0
53,0,9,39,48,1,0.0
54,0,15,65,80,1,0.0
55,0,3,38,41,1,0.0
56,0,18,78,96,1,0.0
57,0,15,149,164,1,0.0
58,0,37,131,168,1,0.0
59,0,35,144,179,1,0.0
60,0,4,18,22,1,0.0
61,0,16,117,133,1,0.0
62,0,10,42,52,1,0.0
63,0,28,79,107,1,0.0
64,0,1,2,3,1,0.0
65,0,16,79,95,1,0.0
66,0,26,70,96,1,0.0
67,0,13,22,35,1,0.0
68,0,35,175,210,1,0.0
69,0,49,103,152,1,0.0
70,0,16,72,88,1,0.0
71,0,43,126,169,1,0.0
72,0,41,142,183,1,0.0
73,0,50,125,175,1,0.0
74,0,17,43,60,1,0.0
75,0,25,31,56,1,0.0
76,0,21,76,97,1,0.0
77,0,26,128,154,1,0.0
78,0,11,40,51,1,0.0
79,0,13,35,48,1,0.0
80,0,20,52,72,1,0.0
81,0,26,111,137,1,0.0
82,0,40,100,140,1,0.0
83,0,16,29,45,1,0.0
84,0,21,106,127,1,0.0
85,0,17,25,42,1,0.0
86,0,35,179,214,1,0.0
87,0,29,213,242,1,0.0
88,0,6,26,32,1,0.0
89,0,12,76,88,1,0.0
90,0,38,179,217,1,0.0
91,0,27,60,87,1,0.0
92,0,23,59,82,1,0.0
93,0,32,99,131,1,0.0
94,0,14,34,48,1,0.0
95,0,22,59,81,1,0.0
96,0,57,214,271,1,0.0
97,0,16,48,64,1,0.0
98,0,29,114,143,1,0.0
99,0,23,152,175,1,0.0
100,0,51,138,189,1,0.0
101,0,32,123,155,1,0.0
102,0,42,149,191,1,0.0
103,0,8,41,49,1,0.0
104,0,7,10,17,1,0.0
105,0,10,41,51,1,0.0
106,0,6,18,24,1,0.0
107,0,11,53,64,1,0.0
108,0,3,3,6,1,0.0
109,0,4,14,18,1,0.0
110,0,29,67,96,1,0.0
111,0,35,114,149,1,0.0
112,0,79,209,288,1,0.0
113,0,57,132,189,1,0.0
114,0,44,149,193,1,0.0
115,0,48,142,190,1,0.0
116,0,18,66,84,1,0.0
117,0,10,42,52,1,0.0
118,0,7,34,41,1,0.0
119,0,40,200,240,1,0.0
120,0,39,141,180,1,0.0
121,0,30,78,108,1,0.0
122,0,30,66,96,1,0.0
123,0,54,127,181,1,0.0
124,0,5,11,16,1,0.0
125,0,37,105,142,1,0.0
126,0,44,136,180,1,0.0
127,0,13,43,56,1,0.0
128,0,34,163,197,1,0.0
129,0,15,78,93,1,0.0
130,0,33,163,196,1,0.0
131,0,29,42,71,1,0.0
132,0,6,40,46,1,0.0
133,0,21,162,183,1,0.0
134,0,5,47,52,1,0.0
135,0,8,20,28,1,0.0
136,0,8,43,51,1,0.0
137,0,6,46,52,1,0.0
138,0,65,118,183,1,0.0
139,0,19,23,42,1,0.0
140,0,21,85,106,1,0.0
141,0,23,90,113,1,0.0
142,0,50,187,237,1,0.0
143,0,1,14,15,1,0.0
144,0,36,176,212,1,0.0
145,0,7,45,52,1,0.0
146,0,16,103,119,1,0.0
147,0,24,84,108,1,0.0
148,0,15,106,121,1,0.0
149,0,12,34,46,1,0.0
150,0,6,35,41,1,0.0
151,0,21,63,84,1,0.0
152,0,4,4,8,1,0.0
153,0,2,8,10,1,0.0
154,0,0,0,0,1,0.0
155,0,15,16,31,1,0.0
156,0,5,36,41,1,0.0
157,0,20,79,99,1,0.0
158,0,7,36,43,1,0.0
159,0,15,52,67,1,0.0
160,0,16,73,89,1,0.0
161,0,11,85,96,1,0.0
162,0,9,38,47,1,0.0
163,0,17,151,168,1,0.0
164,0,8,74,82,1,0.0
165,0,33,81,114,1,0.0
166,0,11,60,71,1,0.0
167,0,9,34,43,1,0.0
168,0,47,138,185,1,0.0
169,0,48,108,156,1,0.0
170,0,48,111,159,1,0.0
171,0,27,91,118,1,0.0
172,0,4,116,120,1,0.0
173,0,12,59,71,1,0.0
174,0,29,91,120,1,0.0
175,0,41,135,176,1,0.0
176,0,13,29,42,1,0.0
177,0,29,72,101,1,0.0
178,0,15,24,39,1,0.0
179,0,35,85,120,1,0.0
180,0,9,32,41,1,0.0
181,0,0,10,10,1,0.0
182,0,13,24,37,1,0.0
183,0,3,11,14,1,0.0
184,0,30,204,234,1,0.0
185,0,35,49,84,1,0.0
186,0,16,64,80,1,0.0
187,0,48,185,233,1,0.0
188,0,18,147,165,1,0.0
189,0,116,211,327,1,0.0
190,0,55,164,219,1,0.0
191,0,71,191,262,1,0.0
192,0,49,242,291,1,0.0
193,0,87,165,252,1,0.0
194,0,27,101,128,1,0.0
195,0,21,137,158,1,0.0
196,0,24,48,72,1,0.0
197,0,19,33,52,1,0.0
198,0,17,41,58,1,0.0
199,0,9,45,54,1,0.0
200,0,29,131,160,1,0.0
201,0,13,73,86,1,0.0
202,0,38,168,206,1,0.0
203,0,18,159,177,1,0.0
204,0,23,75,98,1,0.0
205,0,54,146,200,1,0.0
206,0,18,49,67,1,0.0
207,0,50,246,296,1,0.0
208,0,9,20,29,1,0.0
209,0,17,60,77,1,0.0
210,0,3,19,22,1,0.0
211,0,63,77,140,1,0.0
212,0,6,67,73,1,0.0
213,0,19,68,87,1,0.0
214,0,26,115,141,1,0.0
215,0,53,197,250,1,0.0
216,0,44,201,245,1,0.0
217,0,42,136,178,1,0.0
218,0,46,235,281,1,0.0
219,0,23,103,126,1,0.0
220,0,27,125,152,1,0.0
221,0,11,87,98,1,0.0
222,0,24,134,158,1,0.0
223,0,25,111,136,1,0.0
224,0,6,28,34,1,0.0
225,0,10,40,50,1,0.0
226,0,18,89,107,1,0.0
227,0,27,62,89,1,0.0
228,0,27,132,159,1,0.0
229,0,39,155,194,1,0.0
230,0,36,93,129,1,0.0
231,0,14,140,154,1,0.0
232,0,33,57,90,1,0.0
233,0,59,159,218,1,0.0
234,0,31,244,275,1,0.0
235,0,32,90,122,1,0.0
236,0,35,148,183,1,0.0
237,0,13,41,54,1,0.0
238,0,5,38,43,1,0.0
239,0,10,19,29,1,0.0
240,0,15,65,80,1,0.0
241,0,5,38,43,1,0.0
242,0,30,159,189,1,0.0
243,0,13,102,115,1,0.0
244,0,26,121,147,1,0.0
245,0,13,62,75,1,0.0
246,0,90,242,332,1,0.0
247,0,55,266,321,1,0.0
248,0,33,139,172,1,0.0
249,0,16,20,36,1,0.0
250,0,9,53,62,1,0.0
251,0,5,15,20,1,0.0
252,0,86,127,213,1,0.0
253,0,67,162,229,1,0.0
254,0,25,45,70,1,0.0
255,0,14,25,39,1,0.0
256,0,63,168,231,1,0.0
257,0,63,290,353,1,0.0
258,0,40,141,181,1,0.0
259,0,18,53,71,1,0.0
260,0,43,150,193,1,0.0
261,0,57,63,120,1,0.0
262,0,19,29,48,1,0.0
263,0,64,219,283,1,0.0
264,0,18,79,97,1,0.0
265,0,71,229,300,1,0.0
266,0,36,162,198,1,0.0
267,0,12,38,50,1,0.0
268,0,34,111,145,1,0.0
269,0,9,30,39,1,0.0
270,0,1,5,6,1,0.0
271,0,13,33,46,1,0.0
272,0,24,57,81,1,0.0
273,0,8,5,13,1,0.0
274,0,7,7,14,1,0.0
275,0,23,108,131,1,0.0
276,0,28,95,123,1,0.0
277,0,79,159,238,1,0.0
278,0,72,236,308,1,0.0
279,0,19,73,92,1,0.0
280,0,32,179,211,1,0.0
281,0,17,62,79,1,0.0
282,0,31,85,116,1,0.0
283,0,20,105,125,1,0.0
284,0,23,86,109,1,0.0
285,0,3,14,17,1,0.0
286,0,4,48,52,1,0.0
287,0,14,68,82,1,0.0
288,0,16,80,96,1,0.0
289,0,30,211,241,1,0.0
290,0,23,118,141,1,0.0
291,0,10,17,27,1,0.0
292,0,28,217,245,1,0.0
293,0,62,266,328,1,0.0
294,0,24,43,67,1,0.0
295,0,26,235,261,1,0.0
296,0,28,181,209,1,0.0
297,0,5,24,29,1,0.0
298,0,10,87,97,1,0.0
299,0,13,84,97,1,0.0
300,0,6,29,35,1,0.0
301,0,20,21,41,1,0.0
302,0,3,35,38,1,0.0
303,0,19,54,73,1,0.0
304,0,55,189,244,1,0.0
305,0,12,107,119,1,0.0
306,0,45,206,251,1,0.0
307,0,35,235,270,1,0.0
308,0,11,60,71,1,0.0
309,0,25,120,145,1,0.0
310,0,16,119,135,1,0.0
311,0,15,67,82,1,0.0
312,0,18,102,120,1,0.0
313,0,9,64,73,1,0.0
314,0,26,67,93,1,0.0
315,0,5,21,26,1,0.0
316,0,4,12,16,1,0.0
317,0,11,60,71,1,0.0
318,0,37,91,128,1,0.0
319,0,51,229,280,1,0.0
320,0,37,153,190,1,0.0
321,0,40,79,119,1,0.0
322,0,33,108,141,1,0.0
323,0,44,104,148,1,0.0
324,0,24,117,141,1,0.0
325,0,18,111,129,1,0.0
326,0,6,25,31,1,0.0
327,0,7,41,48,1,0.0
328,0,31,75,106,1,0.0
329,0,2,5,7,1,0.0
330,0,5,15,20,1,0.0
331,0,17,43,60,1,0.0
332,0,34,177,211,1,0.0
333,0,27,143,170,1,0.0
334,0,28,226,254,1,0.0
335,0,104,298,402,1,0.0
336,0,7,26,33,1,0.0
337,0,36,169,205,1,0.0
338,0,3,27,30,1,0.0
339,0,23,100,123,1,0.0
340,0,17,101,118,1,0.0
341,0,28,107,135,1,0.0
342,0,15,21,36,1,0.0
343,0,24,80,104,1,0.0
344,0,25,38,63,1,0.0
345,0,22,24,46,1,0.0
346,0,39,75,114,1,0.0
347,0,33,57,90,1,0.0
348,0,26,110,136,1,0.0
349,0,36,77,113,1,0.0
350,0,17,81,98,1,0.0
351,0,25,133,158,1,0.0
352,0,9,87,96,1,0.0
353,0,17,85,102,1,0.0
354,0,27,116,143,1,0.0
355,0,22,41,63,1,0.0
356,0,10,28,38,1,0.0
357,0,17,28,45,1,0.0
358,0,20,36,56,1,0.0
359,0,27,45,72,1,0.0
360,0,47,164,211,1,0.0
361,0,28,61,89,1,0.0
362,0,33,177,210,1,0.0
363,0,26,68,94,1,0.0
364,0,23,206,229,1,0.0
365,0,15,150,165,1,0.0
366,0,14,45,59,1,0.0
367,0,3,21,24,1,0.0
368,0,24,74,98,1,0.0
369,0,23,40,63,1,0.0
370,0,13,49,62,1,0.0
371,0,2,8,10,1,0.0
372,0,15,38,53,1,0.0
373,0,2,4,6,1,0.0
374,0,20,70,90,1,0.0
375,0,5,12,17,1,0.0
376,0,22,109,131,1,0.0
377,0,17,114,131,1,0.0
378,0,27,150,177,1,0.0
379,0,15,61,76,1,0.0
380,0,27,80,107,1,0.0
381,0,51,254,305,1,0.0
382,0,14,73,87,1,0.0
383,0,48,104,152,1,0.0
384,0,75,157,232,1,0.0
385,0,22,120,142,1,0.0
386,0,77,297,374,1,0.0
387,0,24,66,90,1,0.0
388,0,2,0,2,1,0.0
389,0,14,47,61,1,0.0
390,0,15,75,90,1,0.0
391,0,71,211,282,1,0.0
392,0,31,109,140,1,0.0
393,0,16,87,103,1,0.0
394,0,55,279,334,1,0.0
395,0,17,52,69,1,0.0
396,0,37,141,178,1,0.0
397,0,42,178,220,1,0.0
398,0,12,102,114,1,0.0
399,0,12,14,26,1,0.0
400,0,60,123,183,1,0.0
401,0,15,62,77,1,0.0
402,0,3,6,9,1,0.0
403,0,29,74,103,1,0.0
404,0,59,121,180,1,0.0
405,0,65,194,259,1,0.0
406,0,33,179,212,1,0.0
407,0,20,58,78,1,0.0
408,0,35,173,208,1,0.0
409,0,40,216,256,1,0.0
410,0,22,139,161,1,0.0
411,0,25,68,93,1,0.0
412,0,46,132,178,1,0.0
413,0,8,55,63,1,0.0
414,0,13,41,54,1,0.0
415,75,42,223,265,1,0.001
416,75,19,107,126,1,0.001
417,75,94,428,522,1,0.001
418,75,8,129,137,1,0.001
419,75,46,158,204,1,0.001
420,75,37,130,167,1,0.001
421,75,29,86,115,1,0.001
422,75,39,259,298,1,0.001
423,75,21,109,130,1,0.001
424,75,3,10,13,1,0.001
425,75,15,81,96,1,0.001
426,75,24,80,104,1,0.001
427,75,7,29,36,1,0.001
428,75,0,14,14,1,0.001
429,75,30,115,145,1,0.001
430,75,6,5,11,1,0.001
431,75,25,136,161,1,0.001
432,75,57,156,213,1,0.001
433,75,21,184,205,1,0.001
434,75,15,102,117,1,0.001
435,75,23,179,202,1,0.001
436,75,37,158,195,1,0.001
437,75,27,22,49,1,0.001
438,75,47,138,185,1,0.001
439,75,8,45,53,1,0.001
440,75,25,37,62,1,0.001
441,75,34,55,89,1,0.001
442,75,4,18,22,1,0.001
443,75,12,107,119,1,0.001
444,75,19,208,227,1,0.001
445,75,43,159,202,1,0.001
446,75,43,275,318,1,0.001
447,75,33,134,167,1,0.001
448,75,18,60,78,1,0.001
449,75,6,53,59,1,0.001
450,75,7,10,17,1,0.001
451,75,20,164,184,1,0.001
452,75,32,235,267,1,0.001
453,75,36,233,269,1,0.001
454,75,14,131,145,1,0.001
455,75,75,327,402,1,0.001
456,75,23,132,155,1,0.001
457,75,8,33,41,1,0.001
458,75,18,39,57,1,0.001
459,75,32,78,110,1,0.001
460,75,22,85,107,1,0.001
461,75,2,10,12,1,0.001
462,75,43,130,173,1,0.001
463,75,14,72,86,1,0.001
464,75,3,12,15,1,0.001
465,75,46,274,320,1,0.001
466,75,24,115,139,1,0.001
467,75,10,53,63,1,0.001
468,75,18,210,228,1,0.001
469,75,53,188,241,1,0.001
470,75,30,8,38,1,0.001
471,75,5,16,21,1,0.001
472,75,26,51,77,1,0.001
473,75,35,54,89,1,0.001
474,75,36,59,95,1,0.001
475,75,7,5,12,1,0.001
476,75,9,11,20,1,0.001
477,75,22,96,118,1,0.001
478,75,18,110,128,1,0.001
479,75,9,61,70,1,0.001
480,75,69,251,320,1,0.001
481,75,46,213,259,1,0.001
482,75,57,233,290,1,0.001
483,75,54,173,227,1,0.001
484,75,19,61,80,1,0.001
485,75,23,30,53,1,0.001
486,75,37,166,203,1,0.001
487,75,29,97,126,1,0.001
488,75,17,61,78,1,0.001
489,75,5,10,15,1,0.001
490,75,10,17,27,1,0.001
491,75,27,71,98,1,0.001
492,75,7,25,32,1,0.001
493,75,14,58,72,1,0.001
494,75,13,118,131,1,0.001
495,75,33,114,147,1,0.001
496,75,54,156,210,1,0.001
497,75,19,100,119,1,0.001
498,75,68,187,255,1,0.001
499,75,37,99,136,1,0.001
500,75,20,67,87,1,0.001
501,75,19,55,74,1,0.001
502,75,18,98,116,1,0.001
503,75,18,44,62,1,0.001
504,75,19,34,53,1,0.001
505,75,3,23,26,1,0.001
506,75,25,58,83,1,0.001
507,75,23,49,72,1,0.001
508,75,10,117,127,1,0.001
509,75,35,85,120,1,0.001
510,75,19,116,135,1,0.001
511,75,34,102,136,1,0.001
512,75,18,147,165,1,0.001
513,75,27,46,73,1,0.001
514,75,32,115,147,1,0.001
515,75,7,17,24,1,0.001
516,75,32,220,252,1,0.001
517,75,27,108,135,1,0.001
518,75,9,70,79,1,0.001
519,75,7,107,114,1,0.001
520,75,8,14,22,1,0.001
521,75,29,104,133,1,0.001
522,75,3,27,30,1,0.001
523,75,5,5,10,1,0.001
524,75,9,76,85,1,0.001
525,75,45,193,238,1,0.001
526,75,42,130,172,1,0.001
527,75,24,129,153,1,0.001
528,75,13,200,213,1,0.001
529,75,5,52,57,1,0.001
530,75,47,154,201,1,0.001
531,75,16,81,97,1,0.001
532,75,39,141,180,1,0.001
533,75,26,72,98,1,0.001
534,75,4,35,39,1,0.001
535,75,28,106,134,1,0.001
536,75,7,34,41,1,0.001
537,75,1,8,9,1,0.001
538,75,6,29,35,1,0.001
539,75,27,76,103,1,0.001
540,75,22,77,99,1,0.001
541,75,25,197,222,1,0.001
542,75,22,135,157,1,0.001
543,75,37,149,186,1,0.001
544,75,7,119,126,1,0.001
545,75,52,160,212,1,0.001
546,75,43,46,89,1,0.001
547,75,64,151,215,1,0.001
548,75,5,10,15,1,0.001
549,75,18,72,90,1,0.001
550,75,13,19,32,1,0.001
551,75,0,3,3,1,0.001
552,75,12,57,69,1,0.001
553,75,5,55,60,1,0.001
554,75,33,118,151,1,0.001
555,75,20,138,158,1,0.001
556,75,11,34,45,1,0.001
557,75,36,142,178,1,0.001
558,75,8,67,75,1,0.001
559,75,25,97,122,1,0.001
560,75,56,184,240,1,0.001
561,75,9,10,19,1,0.001
562,75,16,65,81,1,0.001
563,75,15,107,122,1,0.001
564,75,4,40,44,1,0.001
565,75,24,100,124,1,0.001
566,75,17,24,41,1,0.001
567,75,18,30,48,1,0.001
568,75,11,41,52,1,0.001
569,75,9,60,69,1,0.001
570,75,11,32,43,1,0.001
571,75,7,13,20,1,0.001
572,75,2,3,5,1,0.001
573,75,22,42,64,1,0.001
574,75,13,85,98,1,0.001
575,75,33,314,347,1,0.001
576,75,18,147,165,1,0.001
577,75,32,137,169,1,0.001
578,75,45,118,163,1,0.001
579,75,14,151,165,1,0.001
580,75,13,37,50,1,0.001
581,75,10,47,57,1,0.001
582,75,6,24,30,1,0.001
583,75,24,84,108,1,0.001
584,75,13,162,175,1,0.001
585,75,22,123,145,1,0.001
586,75,7,31,38,1,0.001
587,75,13,82,95,1,0.001
588,75,65,129,194,1,0.001
589,75,26,155,181,1,0.001
590,75,25,159,184,1,0.001
591,75,3,65,68,1,0.001
592,75,37,120,157,1,0.001
593,75,36,121,157,1,0.001
594,75,17,78,95,1,0.001
595,75,4,26,30,1,0.001
596,75,4,18,22,1,0.001
597,75,22,67,89,1,0.001
598,75,13,48,61,1,0.001
599,75,2,5,7,1,0.001
600,75,5,16,21,1,0.001
601,75,2,13,15,1,0.001
602,75,2,7,9,1,0.001
603,75,30,63,93,1,0.001
604,75,1,17,18,1,0.001
605,75,5,18,23,1,0.001
606,75,22,172,194,1,0.001
607,75,9,47,56,1,0.001
608,75,33,130,163,1,0.001
609,75,46,178,224,1,0.001
610,75,19,109,128,1,0.001
611,75,28,215,243,1,0.001
612,75,12,74,86,1,0.001
613,75,12,66,78,1,0.001
614,75,12,10,22,1,0.001
615,75,11,17,28,1,0.001
616,75,18,68,86,1,0.001
617,75,11,52,63,1,0.001
618,75,4,12,16,1,0.001
619,75,26,148,174,1,0.001
620,75,31,159,190,1,0.001
621,75,33,150,183,1,0.001
622,75,42,63,105,1,0.001
623,75,40,251,291,1,0.001
624,75,44,227,271,1,0.001
625,75,9,53,62,1,0.001
626,75,49,186,235,1,0.001
627,75,3,13,16,1,0.001
628,75,4,19,23,1,0.001
629,75,14,65,79,1,0.001
630,75,1,36,37,1,0.001
631,75,24,128,152,1,0.001
632,75,21,149,170,1,0.001
633,75,64,258,322,1,0.001
634,75,30,166,196,1,0.001
635,75,26,133,159,1,0.001
636,75,13,73,86,1,0.001
637,75,27,167,194,1,0.001
638,75,23,97,120,1,0.001
639,75,3,11,14,1,0.001
640,75,3,43,46,1,0.001
641,75,14,82,96,1,0.001
642,75,6,73,79,1,0.001
643,75,6,26,32,1,0.001
644,75,2,7,9,1,0.001
645,75,76,159,235,1,0.001
646,75,16,147,163,1,0.001
647,75,4,29,33,1,0.001
648,75,51,303,354,1,0.001
649,75,39,144,183,1,0.001
650,75,83,360,443,1,0.001
651,75,16,100,116,1,0.001
652,75,32,113,145,1,0.001
653,75,63,174,237,1,0.001
654,75,32,201,233,1,0.001
655,75,4,87,91,1,0.001
656,75,5,12,17,1,0.001
657,75,26,92,118,1,0.001
658,75,15,69,84,1,0.001
659,75,50,88,138,1,0.001
660,75,9,44,53,1,0.001
661,75,39,269,308,1,0.001
662,75,35,227,262,1,0.001
663,75,23,51,74,1,0.001
664,75,5,17,22,1,0.001
665,75,22,265,287,1,0.001
666,75,33,228,261,1,0.001
667,75,20,227,247,1,0.001
668,75,16,113,129,1,0.001
669,75,37,214,251,1,0.001
670,75,19,126,145,1,0.001
671,75,16,27,43,1,0.001
672,75,36,84,120,1,0.001
673,75,10,28,38,1,0.001
674,75,19,23,42,1,0.001
675,75,8,26,34,1,0.001
676,75,13,63,76,1,0.001
677,75,60,190,250,1,0.001
678,75,26,212,238,1,0.001
679,75,26,120,146,1,0.001
680,75,24,124,148,1,0.001
681,75,15,66,81,1,0.001
682,75,34,155,189,1,0.001
683,75,27,234,261,1,0.001
684,75,11,72,83,1,0.001
685,75,45,158,203,1,0.001
686,75,22,154,176,1,0.001
687,75,14,94,108,1,0.001
688,75,16,75,91,1,0.001
689,75,34,110,144,1,0.001
690,75,5,56,61,1,0.001
691,75,25,101,126,1,0.001
692,75,7,19,26,1,0.001
693,75,19,51,70,1,0.001
694,75,17,52,69,1,0.001
695,75,14,132,146,1,0.001
696,75,31,108,139,1,0.001
697,75,25,76,101,1,0.001
698,75,20,95,115,1,0.001
699,75,28,217,245,1,0.001
700,75,60,265,325,1,0.001
701,75,39,169,208,1,0.001
702,75,27,139,166,1,0.001
703,75,23,102,125,1,0.001
704,75,22,184,206,1,0.001
705,75,5,38,43,1,0.001
706,75,25,62,87,1,0.001
707,75,13,108,121,1,0.001
708,75,9,35,44,1,0.001
709,75,32,119,151,1,0.001
710,75,59,216,275,1,0.001
711,75,53,264,317,1,0.001
712,75,17,61,78,1,0.001
713,75,22,46,68,1,0.001
714,75,46,182,228,1,0.001
715,75,13,71,84,1,0.001
716,75,59,230,289,1,0.001
717,75,39,121,160,1,0.001
718,75,7,45,52,1,0.001
719,75,9,23,32,1,0.001
720,75,28,81,109,1,0.001
721,75,17,46,63,1,0.001
722,75,11,8,19,1,0.001
723,75,4,16,20,1,0.001
724,75,28,208,236,1,0.001
725,75,46,141,187,1,0.001
726,75,35,169,204,1,0.001
727,75,56,156,212,1,0.001
728,75,37,165,202,1,0.001
729,75,22,244,266,1,0.001
730,75,41,93,134,1,0.001
731,75,40,208,248,1,0.001
732,75,46,191,237,1,0.001
733,75,47,99,146,1,0.001
734,75,26,82,108,1,0.001
735,75,57,191,248,1,0.001
736,75,4,8,12,1,0.001
737,75,3,13,16,1,0.001
738,75,10,39,49,1,0.001
739,75,3,8,11,1,0.001
740,75,3,5,8,1,0.001
741,75,32,138,170,1,0.001
742,75,31,149,180,1,0.001
743,75,32,231,263,1,0.001
744,75,31,174,205,1,0.001
745,75,20,230,250,1,0.001
746,75,39,222,261,1,0.001
747,75,26,65,91,1,0.001
748,75,19,174,193,1,0.001
749,75,38,151,189,1,0.001
750,75,53,144,197,1,0.001
751,75,53,111,164,1,0.001
752,75,9,32,41,1,0.001
753,75,47,95,142,1,0.001
754,75,7,71,78,1,0.001
755,75,30,59,89,1,0.001
756,75,28,119,147,1,0.001
757,75,17,144,161,1,0.001
758,75,68,282,350,1,0.001
759,75,29,148,177,1,0.001
760,75,15,77,92,1,0.001
761,75,6,65,71,1,0.001
762,75,9,29,38,1,0.001
763,75,6,18,24,1,0.001
764,75,5,56,61,1,0.001
765,75,6,38,44,1,0.001
766,75,48,171,219,1,0.001
767,75,59,244,303,1,0.001
768,75,15,85,100,1,0.001
769,75,42,156,198,1,0.001
770,75,29,67,96,1,0.001
771,75,26,125,151,1,0.001
772,75,16,98,114,1,0.001
773,75,50,205,255,1,0.001
774,75,7,41,48,1,0.001
775,75,25,132,157,1,0.001
776,75,6,31,37,1,0.001
777,75,16,47,63,1,0.001
778,75,3,9,12,1,0.001
779,75,5,33,38,1,0.001
780,75,4,65,69,1,0.001
781,75,19,176,195,1,0.001
782,75,12,110,122,1,0.001
783,75,14,47,61,1,0.001
784,75,25,194,219,1,0.001
785,75,32,124,156,1,0.001
786,75,46,132,178,1,0.001
787,75,20,86,106,1,0.001
788,75,28,93,121,1,0.001
789,75,18,136,154,1,0.001
790,75,11,63,74,1,0.001
791,75,15,109,124,1,0.001
792,75,4,20,24,1,0.001
793,75,8,22,30,1,0.001
794,75,18,31,49,1,0.001
795,75,7,27,34,1,0.001
796,75,8,12,20,1,0.001
797,75,20,139,159,1,0.001
798,75,34,210,244,1,0.001
799,75,94,269,363,1,0.001
800,75,16,45,61,1,0.001
801,75,73,458,531,1,0.001
802,75,37,294,331,1,0.001
803,75,9,97,106,1,0.001
804,75,27,223,250,1,0.001
805,75,28,153,181,1,0.001
806,75,21,52,73,1,0.001
807,75,3,21,24,1,0.001
808,75,15,59,74,1,0.001
809,75,1,27,28,1,0.001
810,75,14,20,34,1,0.001
811,75,4,33,37,1,0.001
812,75,0,0,0,1,0.001
813,75,22,121,143,1,0.001
814,75,30,162,192,1,0.001
815,75,21,105,126,1,0.001
816,75,23,124,147,1,0.001
817,75,34,132,166,1,0.001
818,75,97,171,268,1,0.001
819,75,42,198,240,1,0.001
820,75,5,22,27,1,0.001
821,75,42,197,239,1,0.001
822,75,18,85,103,1,0.001
823,75,38,103,141,1,0.001
824,75,24,53,77,1,0.001
825,75,4,34,38,1,0.001
826,75,5,28,33,1,0.001
827,75,5,23,28,1,0.001
828,75,6,73,79,1,0.001
829,75,91,283,374,1,0.001
830,75,69,227,296,1,0.001
831,75,35,190,225,1,0.001
832,75,90,283,373,1,0.001
833,75,16,77,93,1,0.001
834,75,35,132,167,1,0.001
835,75,4,25,29,1,0.001
836,75,11,60,71,1,0.001
837,75,17,53,70,1,0.001
838,75,33,223,256,1,0.001
839,75,78,231,309,1,0.001
840,75,38,226,264,1,0.001
841,75,31,243,274,1,0.001
842,75,6,48,54,1,0.001
843,75,32,76,108,1,0.001
844,75,6,65,71,1,0.001
845,75,5,86,91,1,0.001
846,75,6,22,28,1,0.001
847,75,15,51,66,1,0.001
848,75,27,106,133,1,0.01
849,75,30,157,187,1,0.01
850,75,72,137,209,1,0.01
851,75,100,449,549,1,0.01
852,75,69,268,337,1,0.01
853,75,35,79,114,1,0.01
854,75,19,122,141,1,0.01
855,75,55,165,220,1,0.01
856,75,17,61,78,1,0.01
857,75,30,132,162,1,0.01
858,75,48,75,123,1,0.01
859,75,44,143,187,1,0.01
860,75,2,17,19,1,0.01
861,75,4,17,21,1,0.01
862,75,6,26,32,1,0.01
863,75,8,26,34,1,0.01
864,75,1,35,36,1,0.01
865,75,36,202,238,1,0.01
866,75,88,153,241,1,0.01
867,75,37,123,160,1,0.01
868,75,55,276,331,1,0.01
869,75,59,118,177,1,0.01
870,75,19,45,64,1,0.01
871,75,45,237,282,1,0.01
872,75,0,21,21,1,0.01
873,75,23,170,193,1,0.01
874,75,12,44,56,1,0.01
875,75,26,73,99,1,0.01
876,75,18,58,76,1,0.01
877,75,10,63,73,1,0.01
878,75,33,45,78,1,0.01
879,75,39,102,141,1,0.01
880,75,5,21,26,1,0.01
881,75,75,246,321,1,0.01
882,75,22,105,127,1,0.01
883,75,27,196,223,1,0.01
884,75,3,45,48,1,0.01
885,75,93,229,322,1,0.01
886,75,37,174,211,1,0.01
887,75,26,115,141,1,0.01
888,75,16,35,51,1,0.01
889,75,41,147,188,1,0.01
890,75,26,99,125,1,0.01
891,75,27,100,127,1,0.01
892,75,2,11,13,1,0.01
893,75,10,44,54,1,0.01
894,75,11,19,30,1,0.01
895,75,22,96,118,1,0.01
896,75,50,248,298,1,0.01
897,75,28,161,189,1,0.01
898,75,43,129,172,1,0.01
899,75,22,226,248,1,0.01
900,75,27,90,117,1,0.01
901,75,17,39,56,1,0.01
902,75,27,169,196,1,0.01
903,75,7,98,105,1,0.01
904,75,13,39,52,1,0.01
905,75,17,69,86,1,0.01
906,75,1,2,3,1,0.01
907,75,11,36,47,1,0.01
908,75,3,5,8,1,0.01
909,75,4,72,76,1,0.01
910,75,29,68,97,1,0.01
911,75,47,112,159,1,0.01
912,75,0,16,16,1,0.01
913,75,36,139,175,1,0.01
914,75,60,154,214,1,0.01
915,75,12,149,161,1,0.01
916,75,72,118,190,1,0.01
917,75,14,198,212,1,0.01
918,75,25,139,164,1,0.01
919,75,13,33,46,1,0.01
920,75,6,54,60,1,0.01
921,75,0,6,6,1,0.01
922,75,6,14,20,1,0.01
923,75,6,13,19,1,0.01
924,75,2,17,19,1,0.01
925,75,44,180,224,1,0.01
926,75,20,98,118,1,0.01
927,75,26,100,126,1,0.01
928,75,26,135,161,1,0.01
929,75,64,200,264,1,0.01
930,75,22,88,110,1,0.01
931,75,20,66,86,1,0.01
932,75,43,188,231,1,0.01
933,75,23,90,113,1,0.01
934,75,21,94,115,1,0.01
935,75,25,64,89,1,0.01
936,75,16,61,77,1,0.01
937,75,10,71,81,1,0.01
938,75,26,113,139,1,0.01
939,75,49,155,204,1,0.01
940,75,18,201,219,1,0.01
941,75,17,90,107,1,0.01
942,75,60,124,184,1,0.01
943,75,50,173,223,1,0.01
944,75,23,77,100,1,0.01
945,75,7,28,35,1,0.01
946,75,18,36,54,1,0.01
947,75,33,109,142,1,0.01
948,75,28,204,232,1,0.01
949,75,39,235,274,1,0.01
950,75,27,65,92,1,0.01
951,75,31,89,120,1,0.01
952,75,49,279,328,1,0.01
953,75,10,175,185,1,0.01
954,75,15,82,97,1,0.01
955,75,28,224,252,1,0.01
956,75,5,33,38,1,0.01
957,75,6,42,48,1,0.01
958,75,29,205,234,1,0.01
959,75,25,262,287,1,0.01
960,75,56,275,331,1,0.01
961,75,33,176,209,1,0.01
962,75,35,191,226,1,0.01
963,75,11,36,47,1,0.01
964,75,35,119,154,1,0.01
965,75,16,47,63,1,0.01
966,75,9,64,73,1,0.01
967,75,3,10,13,1,0.01
968,75,5,15,20,1,0.01
969,75,21,159,180,1,0.01
970,75,68,91,159,1,0.01
971,75,10,73,83,1,0.01
972,75,69,161,230,1,0.01
973,75,68,168,236,1,0.01
974,75,40,190,230,1,0.01
975,75,70,267,337,1,0.01
976,75,142,285,427,1,0.01
977,75,34,41,75,1,0.01
978,75,66,263,329,1,0.01
979,75,10,81,91,1,0.01
980,75,57,166,223,1,0.01
981,75,40,139,179,1,0.01
982,75,74,146,220,1,0.01
983,75,24,89,113,1,0.01
984,75,34,144,178,1,0.01
985,75,23,73,96,1,0.01
986,75,17,39,56,1,0.01
987,75,16,65,81,1,0.01
988,75,23,142,165,1,0.01
989,75,72,176,248,1,0.01
990,75,45,179,224,1,0.01
991,75,4,27,31,1,0.01
992,75,23,147,170,1,0.01
993,75,30,117,147,1,0.01
994,75,49,153,202,1,0.01
995,75,12,46,58,1,0.01
996,75,7,100,107,1,0.01
997,75,35,123,158,1,0.01
998,75,14,103,117,1,0.01
999,75,12,30,42,1,0.01
1000,75,18,74,92,1,0.01
1001,75,11,45,56,1,0.01
1002,75,11,70,81,1,0.01
1003,75,6,37,43,1,0.01
1004,75,3,38,41,1,0.01
1005,75,19,36,55,1,0.01
1006,75,23,136,159,1,0.01
1007,75,18,131,149,1,0.01
1008,75,23,91,114,1,0.01
1009,75,22,93,115,1,0.01
1010,75,6,27,33,1,0.01
1011,75,24,208,232,1,0.01
1012,75,48,216,264,1,0.01
1013,75,25,104,129,1,0.01
1014,75,24,45,69,1,0.01
1015,75,27,129,156,1,0.01
1016,75,5,10,15,1,0.01
1017,75,12,63,75,1,0.01
1018,75,6,21,27,1,0.01
1019,75,1,4,5,1,0.01
1020,75,26,117,143,1,0.01
1021,75,13,76,89,1,0.01
1022,75,11,46,57,1,0.01
1023,75,39,158,197,1,0.01
1024,75,22,140,162,1,0.01
1025,75,14,27,41,1,0.01
1026,75,20,160,180,1,0.01
1027,75,6,48,54,1,0.01
1028,75,6,29,35,1,0.01
1029,75,43,198,241,1,0.01
1030,75,3,35,38,1,0.01
1031,75,10,46,56,1,0.01
1032,75,8,4,12,1,0.01
1033,75,5,28,33,1,0.01
1034,75,24,54,78,1,0.01
1035,75,17,47,64,1,0.01
1036,75,12,54,66,1,0.01
1037,75,20,55,75,1,0.01
1038,75,15,91,106,1,0.01
1039,75,54,93,147,1,0.01
1040,75,9,53,62,1,0.01
1041,75,17,140,157,1,0.01
1042,75,28,124,152,1,0.01
1043,75,26,95,121,1,0.01
1044,75,18,34,52,1,0.01
1045,75,19,76,95,1,0.01
1046,75,2,9,11,1,0.01
1047,75,10,8,18,1,0.01
1048,75,5,23,28,1,0.01
1049,75,50,237,287,1,0.01
1050,75,26,203,229,1,0.01
1051,75,32,119,151,1,0.01
1052,75,69,163,232,1,0.01
1053,75,16,84,100,1,0.01
1054,75,29,100,129,1,0.01
1055,75,35,201,236,1,0.01
1056,75,59,284,343,1,0.01
1057,75,30,156,186,1,0.01
1058,75,5,158,163,1,0.01
1059,75,32,99,131,1,0.01
1060,75,47,219,266,1,0.01
1061,75,32,69,101,1,0.01
1062,75,36,99,135,1,0.01
1063,75,17,128,145,1,0.01
1064,75,52,118,170,1,0.01
1065,75,7,59,66,1,0.01
1066,75,3,13,16,1,0.01
1067,75,4,36,40,1,0.01
1068,75,11,20,31,1,0.01
1069,75,22,111,133,1,0.01
1070,75,31,82,113,1,0.01
1071,75,75,173,248,1,0.01
1072,75,42,121,163,1,0.01
1073,75,12,54,66,1,0.01
1074,75,39,209,248,1,0.01
1075,75,37,138,175,1,0.01
1076,75,33,75,108,1,0.01
1077,75,17,68,85,1,0.01
1078,75,12,67,79,1,0.01
1079,75,78,199,277,1,0.01
1080,75,16,76,92,1,0.01
1081,75,18,160,178,1,0.01
1082,75,28,110,138,1,0.01
1083,75,0,3,3,1,0.01
1084,75,21,49,70,1,0.01
1085,75,3,3,6,1,0.01
1086,75,5,14,19,1,0.01
1087,75,19,20,39,1,0.01
1088,75,5,14,19,1,0.01
1089,75,0,0,0,1,0.01
1090,75,0,7,7,1,0.01
1091,75,28,59,87,1,0.01
1092,75,28,124,152,1,0.01
1093,75,26,193,219,1,0.01
1094,75,57,300,357,1,0.01
1095,75,44,144,188,1,0.01
1096,75,4,48,52,1,0.01
1097,75,20,105,125,1,0.01
1098,75,3,7,10,1,0.01
1099,75,31,97,128,1,0.01
1100,75,13,38,51,1,0.01
1101,75,17,37,54,1,0.01
1102,75,23,80,103,1,0.01
1103,75,44,122,166,1,0.01
1104,75,11,76,87,1,0.01
1105,75,63,219,282,1,0.01
1106,75,75,293,368,1,0.01
1107,75,17,32,49,1,0.01
1108,75,33,89,122,1,0.01
1109,75,64,130,194,1,0.01
1110,75,31,156,187,1,0.01
1111,75,75,148,223,1,0.01
1112,75,29,70,99,1,0.01
1113,75,14,142,156,1,0.01
1114,75,22,145,167,1,0.01
1115,75,67,142,209,1,0.01
1116,75,16,49,65,1,0.01
1117,75,6,46,52,1,0.01
1118,75,58,248,306,1,0.01
1119,75,29,101,130,1,0.01
1120,75,54,207,261,1,0.01
1121,75,5,35,40,1,0.01
1122,75,23,101,124,1,0.01
1123,75,17,184,201,1,0.01
1124,75,49,187,236,1,0.01
1125,75,47,171,218,1,0.01
1126,75,29,115,144,1,0.01
1127,75,64,102,166,1,0.01
1128,75,18,76,94,1,0.01
1129,75,38,153,191,1,0.01
1130,75,56,150,206,1,0.01
1131,75,11,99,110,1,0.01
1132,75,20,147,167,1,0.01
1133,75,24,38,62,1,0.01
1134,75,18,88,106,1,0.01
1135,75,7,9,16,1,0.01
1136,75,1,13,14,1,0.01
1137,75,14,24,38,1,0.01
1138,75,5,21,26,1,0.01
1139,75,13,28,41,1,0.01
1140,75,22,214,236,1,0.01
1141,75,16,139,155,1,0.01
1142,75,27,182,209,1,0.01
1143,75,53,430,483,1,0.01
1144,75,20,133,153,1,0.01
1145,75,51,167,218,1,0.01
1146,75,37,118,155,1,0.01
1147,75,34,254,288,1,0.01
1148,75,17,261,278,1,0.01
1149,75,23,69,92,1,0.01
1150,75,35,205,240,1,0.01
1151,75,29,45,74,1,0.01
1152,75,31,177,208,1,0.01
1153,75,13,53,66,1,0.01
1154,75,0,0,0,1,0.01
1155,75,11,69,80,1,0.01
1156,75,5,30,35,1,0.01
1157,75,1,6,7,1,0.01
1158,75,8,29,37,1,0.01
1159,75,5,17,22,1,0.01
1160,75,5,38,43,1,0.01
1161,75,29,134,163,1,0.01
1162,75,77,256,333,1,0.01
1163,75,44,148,192,1,0.01
1164,75,43,273,316,1,0.01
1165,75,60,251,311,1,0.01
1166,75,47,140,187,1,0.01
1167,75,64,187,251,1,0.01
1168,75,13,106,119,1,0.01
1169,75,28,128,156,1,0.01
1170,75,15,91,106,1,0.01
1171,75,9,82,91,1,0.01
1172,75,9,39,48,1,0.01
1173,75,21,34,55,1,0.01
1174,75,1,2,3,1,0.01
1175,75,19,59,78,1,0.01
1176,75,4,18,22,1,0.01
1177,75,29,270,299,1,0.01
1178,75,51,194,245,1,0.01
1179,75,22,102,124,1,0.01
1180,75,6,36,42,1,0.01
1181,75,41,280,321,1,0.01
1182,75,85,236,321,1,0.01
1183,75,16,116,132,1,0.01
1184,75,84,266,350,1,0.01
1185,75,35,145,180,1,0.01
1186,75,3,7,10,1,0.01
1187,75,10,48,58,1,0.01
1188,75,22,186,208,1,0.01
1189,75,43,65,108,1,0.01
1190,75,1,3,4,1,0.01
1191,75,7,10,17,1,0.01
1192,75,35,38,73,1,0.01
1193,75,21,109,130,1,0.01
1194,75,8,59,67,1,0.01
1195,75,45,269,314,1,0.01
1196,75,20,55,75,1,0.01
1197,75,52,184,236,1,0.01
1198,75,17,191,208,1,0.01
1199,75,18,87,105,1,0.01
1200,75,33,229,262,1,0.01
1201,75,6,49,55,1,0.01
1202,75,37,253,290,1,0.01
1203,75,28,104,132,1,0.01
1204,75,12,31,43,1,0.01
1205,75,13,64,77,1,0.01
1206,75,19,88,107,1,0.01
1207,75,21,219,240,1,0.01
1208,75,7,218,225,1,0.01
1209,75,18,213,231,1,0.01
1210,75,8,78,86,1,0.01
1211,75,36,163,199,1,0.01
1212,75,26,262,288,1,0.01
1213,75,11,48,59,1,0.01
1214,75,19,180,199,1,0.01
1215,75,22,108,130,1,0.01
1216,75,12,50,62,1,0.01
1217,75,2,41,43,1,0.01
1218,75,7,55,62,1,0.01
1219,75,26,184,210,1,0.01
1220,75,49,154,203,1,0.01
1221,75,4,29,33,1,0.01
1222,75,32,121,153,1,0.01
1223,75,13,157,170,1,0.01
1224,75,34,168,202,1,0.01
1225,75,81,300,381,1,0.01
1226,75,42,165,207,1,0.01
1227,75,49,187,236,1,0.01
1228,75,11,80,91,1,0.01
1229,75,12,94,106,1,0.01
1230,75,2,15,17,1,0.01
1231,75,5,51,56,1,0.01
1232,75,3,1,4,1,0.01
1233,75,25,126,151,1,0.01
1234,75,15,36,51,1,0.01
1235,75,89,349,438,1,0.01
1236,75,13,64,77,1,0.01
1237,75,25,106,131,1,0.01
1238,75,34,182,216,1,0.01
1239,75,11,67,78,1,0.01
1240,75,93,209,302,1,0.01
1241,75,2,28,30,1,0.01
1242,75,27,71,98,1,0.01
1243,75,16,135,151,1,0.01
1244,75,50,152,202,1,0.01
1245,75,6,48,54,1,0.01
1246,75,12,68,80,1,0.01
1247,75,11,37,48,1,0.01
1248,75,5,9,14,1,0.01
1249,75,11,55,66,1,0.01
1250,75,4,5,9,1,0.01
1251,75,0,0,0,1,0.01
1252,75,36,183,219,1,0.01
1253,75,39,296,335,1,0.01
1254,75,111,384,495,1,0.01
1255,75,36,222,258,1,0.01
1256,75,15,42,57,1,0.01
1257,75,101,374,475,1,0.01
1258,75,28,235,263,1,0.01
1259,75,4,47,51,1,0.01
1260,75,233,238,471,1,0.01
1261,75,10,108,118,1,0.01
1262,75,53,114,167,1,0.01
1263,75,36,182,218,1,0.01
1264,75,0,6,6,1,0.01
1265,75,1,3,4,1,0.01
1266,75,3,18,21,1,0.01
1267,75,2,9,11,1,0.01
1268,75,36,194,230,1,0.01
1269,75,63,326,389,1,0.01
1270,75,45,283,328,1,0.01
1271,75,81,426,507,1,0.01
1272,75,42,85,127,1,0.01
1273,75,30,179,209,1,0.01
1274,75,81,142,223,1,0.01
1275,75,60,311,371,1,0.01
1276,75,22,163,185,1,0.01
1277,75,25,157,182,1,0.01
1278,75,56,243,299,1,0.01
1279,75,29,81,110,1,0.01
1280,75,34,63,97,1,0.01
1281,75,40,91,131,1,0.01
1282,75,30,151,181,1,0.01
1283,75,27,188,215,1,0.01
1284,75,51,297,348,1,0.01
1285,75,20,115,135,1,0.01
1286,75,62,169,231,1,0.01
1287,75,25,196,221,1,0.01
1288,75,82,480,562,1,0.01
1289,75,80,353,433,1,0.01
1290,75,95,462,557,1,0.01
1291,75,74,436,510,1,0.01
1292,75,41,114,155,1,0.01
1293,75,1,33,34,1,0.01
1294,75,19,150,169,1,0.01
1295,75,22,91,113,1,0.01
1296,75,0,17,17,1,0.01
1297,75,7,49,56,1,0.01
1298,75,16,70,86,1,0.01
1299,75,8,10,18,1,0.01
1300,75,9,17,26,1,0.01
1301,75,57,237,294,1,0.1
1302,75,91,310,401,1,0.1
1303,75,6,29,35,1,0.1
1304,75,37,265,302,1,0.1
1305,75,15,178,193,1,0.1
1306,75,13,25,38,1,0.1
1307,75,31,126,157,1,0.1
1308,75,14,68,82,1,0.1
1309,75,9,44,53,1,0.1
1310,75,6,52,58,1,0.1
1311,75,49,204,253,1,0.1
1312,75,32,149,181,1,0.1
1313,75,59,357,416,1,0.1
1314,75,25,101,126,1,0.1
1315,75,38,66,104,1,0.1
1316,75,103,418,521,1,0.1
1317,75,38,220,258,1,0.1
1318,75,4,29,33,1,0.1
1319,75,36,162,198,1,0.1
1320,75,15,46,61,1,0.1
1321,75,15,99,114,1,0.1
1322,75,2,11,13,1,0.1
1323,75,72,384,456,1,0.1
1324,75,8,32,40,1,0.1
1325,75,58,183,241,1,0.1
1326,75,29,160,189,1,0.1
1327,75,68,287,355,1,0.1
1328,75,75,208,283,1,0.1
1329,75,25,109,134,1,0.1
1330,75,19,95,114,1,0.1
1331,75,48,159,207,1,0.1
1332,75,3,21,24,1,0.1
1333,75,8,85,93,1,0.1
1334,75,35,149,184,1,0.1
1335,75,23,118,141,1,0.1
1336,75,23,238,261,1,0.1
1337,75,64,455,519,1,0.1
1338,75,15,117,132,1,0.1
1339,75,23,275,298,1,0.1
1340,75,29,124,153,1,0.1
1341,75,10,29,39,1,0.1
1342,75,20,182,202,1,0.1
1343,75,8,23,31,1,0.1
1344,75,22,87,109,1,0.1
1345,75,2,0,2,1,0.1
1346,75,17,52,69,1,0.1
1347,75,45,183,228,1,0.1
1348,75,19,189,208,1,0.1
1349,75,31,155,186,1,0.1
1350,75,25,185,210,1,0.1
1351,75,12,103,115,1,0.1
1352,75,20,40,60,1,0.1
1353,75,15,116,131,1,0.1
1354,75,26,119,145,1,0.1
1355,75,3,6,9,1,0.1
1356,75,1,12,13,1,0.1
1357,75,7,48,55,1,0.1
1358,75,3,15,18,1,0.1
1359,75,2,6,8,1,0.1
1360,75,45,101,146,1,0.1
1361,75,9,26,35,1,0.1
1362,75,64,127,191,1,0.1
1363,75,46,91,137,1,0.1
1364,75,45,147,192,1,0.1
1365,75,1,3,4,1,0.1
1366,75,8,17,25,1,0.1
1367,75,19,167,186,1,0.1
1368,75,62,115,177,1,0.1
1369,75,1,4,5,1,0.1
1370,75,66,135,201,1,0.1
1371,75,20,65,85,1,0.1
1372,75,22,198,220,1,0.1
1373,75,37,58,95,1,0.1
1374,75,2,1,3,1,0.1
1375,75,35,62,97,1,0.1
1376,75,11,31,42,1,0.1
1377,75,0,7,7,1,0.1
1378,75,12,39,51,1,0.1
1379,75,9,23,32,1,0.1
1380,75,19,17,36,1,0.1
1381,75,7,48,55,1,0.1
1382,75,43,118,161,1,0.1
1383,75,59,213,272,1,0.1
1384,75,30,115,145,1,0.1
1385,75,14,163,177,1,0.1
1386,75,4,62,66,1,0.1
1387,75,27,263,290,1,0.1
1388,75,5,17,22,1,0.1
1389,75,6,19,25,1,0.1
1390,75,46,175,221,1,0.1
1391,75,17,138,155,1,0.1
1392,75,4,7,11,1,0.1
1393,75,12,51,63,1,0.1
1394,75,36,226,262,1,0.1
1395,75,35,243,278,1,0.1
1396,75,11,56,67,1,0.1
1397,75,32,197,229,1,0.1
1398,75,49,209,258,1,0.1
1399,75,27,200,227,1,0.1
1400,75,17,127,144,1,0.1
1401,75,3,5,8,1,0.1
1402,75,10,23,33,1,0.1
1403,75,13,71,84,1,0.1
1404,75,0,7,7,1,0.1
1405,75,13,42,55,1,0.1
1406,75,52,316,368,1,0.1
1407,75,16,153,169,1,0.1
1408,75,13,76,89,1,0.1
1409,75,27,140,167,1,0.1
1410,75,50,317,367,1,0.1
1411,75,44,142,186,1,0.1
1412,75,29,136,165,1,0.1
1413,75,17,73,90,1,0.1
1414,75,31,127,158,1,0.1
1415,75,17,79,96,1,0.1
1416,75,7,65,72,1,0.1
1417,75,44,71,115,1,0.1
1418,75,63,98,161,1,0.1
1419,75,85,205,290,1,0.1
1420,75,15,76,91,1,0.1
1421,75,39,107,146,1,0.1
1422,75,33,193,226,1,0.1
1423,75,7,5,12,1,0.1
1424,75,14,66,80,1,0.1
1425,75,2,9,11,1,0.1
1426,75,1,24,25,1,0.1
1427,75,0,3,3,1,0.1
1428,75,12,30,42,1,0.1
1429,75,12,71,83,1,0.1
1430,75,37,121,158,1,0.1
1431,75,38,221,259,1,0.1
1432,75,14,57,71,1,0.1
1433,75,23,119,142,1,0.1
1434,75,16,35,51,1,0.1
1435,75,20,78,98,1,0.1
1436,75,24,237,261,1,0.1
1437,75,14,90,104,1,0.1
1438,75,10,47,57,1,0.1
1439,75,26,164,190,1,0.1
1440,75,49,363,412,1,0.1
1441,75,28,163,191,1,0.1
1442,75,12,128,140,1,0.1
1443,75,51,92,143,1,0.1
1444,75,44,206,250,1,0.1
1445,75,17,79,96,1,0.1
1446,75,21,77,98,1,0.1
1447,75,15,113,128,1,0.1
1448,75,8,80,88,1,0.1
1449,75,12,46,58,1,0.1
1450,75,7,50,57,1,0.1
1451,75,98,321,419,1,0.1
1452,75,7,58,65,1,0.1
1453,75,73,443,516,1,0.1
1454,75,18,92,110,1,0.1
1455,75,29,232,261,1,0.1
1456,75,54,233,287,1,0.1
1457,75,6,46,52,1,0.1
1458,75,11,143,154,1,0.1
1459,75,0,2,2,1,0.1
1460,75,6,19,25,1,0.1
1461,75,10,39,49,1,0.1
1462,75,27,103,130,1,0.1
1463,75,46,90,136,1,0.1
1464,75,60,280,340,1,0.1
1465,75,48,251,299,1,0.1
1466,75,59,240,299,1,0.1
1467,75,32,200,232,1,0.1
1468,75,60,203,263,1,0.1
1469,75,7,10,17,1,0.1
1470,75,63,252,315,1,0.1
1471,75,9,9,18,1,0.1
1472,75,15,56,71,1,0.1
1473,75,16,29,45,1,0.1
1474,75,13,22,35,1,0.1
1475,75,25,84,109,1,0.1
1476,75,15,55,70,1,0.1
1477,75,48,173,221,1,0.1
1478,75,29,191,220,1,0.1
1479,75,11,73,84,1,0.1
1480,75,21,59,80,1,0.1
1481,75,37,300,337,1,0.1
1482,75,27,219,246,1,0.1
1483,75,41,217,258,1,0.1
1484,75,25,189,214,1,0.1
1485,75,8,37,45,1,0.1
1486,75,4,30,34,1,0.1
1487,75,10,69,79,1,0.1
1488,75,3,9,12,1,0.1
1489,75,17,154,171,1,0.1
1490,75,62,161,223,1,0.1
1491,75,25,38,63,1,0.1
1492,75,11,79,90,1,0.1
1493,75,62,176,238,1,0.1
1494,75,21,212,233,1,0.1
1495,75,34,104,138,1,0.1
1496,75,68,162,230,1,0.1
1497,75,28,235,263,1,0.1
1498,75,53,263,316,1,0.1
1499,75,42,96,138,1,0.1
1500,75,7,13,20,1,0.1
1501,75,10,24,34,1,0.1
1502,75,25,62,87,1,0.1
1503,75,51,226,277,1,0.1
1504,75,90,328,418,1,0.1
1505,75,45,120,165,1,0.1
1506,75,48,262,310,1,0.1
1507,75,15,84,99,1,0.1
1508,75,51,315,366,1,0.1
1509,75,17,80,97,1,0.1
1510,75,24,68,92,1,0.1
1511,75,83,212,295,1,0.1
1512,75,8,10,18,1,0.1
1513,75,3,9,12,1,0.1
1514,75,34,223,257,1,0.1
1515,75,37,170,207,1,0.1
1516,75,13,188,201,1,0.1
1517,75,30,95,125,1,0.1
1518,75,6,31,37,1,0.1
1519,75,79,244,323,1,0.1
1520,75,24,125,149,1,0.1
1521,75,32,324,356,1,0.1
1522,75,25,93,118,1,0.1
1523,75,8,16,24,1,0.1
1524,75,43,136,179,1,0.1
1525,75,26,41,67,1,0.1
1526,75,4,23,27,1,0.1
1527,75,33,26,59,1,0.1
1528,75,12,66,78,1,0.1
1529,75,7,24,31,1,0.1
1530,75,3,2,5,1,0.1
1531,75,4,6,10,1,0.1
1532,75,50,178,228,1,0.1
1533,75,11,149,160,1,0.1
1534,75,26,177,203,1,0.1
1535,75,10,55,65,1,0.1
1536,75,17,137,154,1,0.1
1537,75,35,143,178,1,0.1
1538,75,31,137,168,1,0.1
1539,75,38,267,305,1,0.1
1540,75,44,262,306,1,0.1
1541,75,22,113,135,1,0.1
1542,75,12,149,161,1,0.1
1543,75,24,38,62,1,0.1
1544,75,14,74,88,1,0.1
1545,75,7,32,39,1,0.1
1546,75,20,33,53,1,0.1
1547,75,20,143,163,1,0.1
1548,75,12,69,81,1,0.1
1549,75,8,117,125,1,0.1
1550,75,43,155,198,1,0.1
1551,75,20,113,133,1,0.1
1552,75,3,38,41,1,0.1
1553,75,36,156,192,1,0.1
1554,75,18,82,100,1,0.1
1555,75,8,39,47,1,0.1
1556,75,7,52,59,1,0.1
1557,75,13,35,48,1,0.1
1558,75,8,27,35,1,0.1
1559,75,40,133,173,1,0.1
1560,75,87,302,389,1,0.1
1561,75,48,278,326,1,0.1
1562,75,2,8,10,1,0.1
1563,75,20,86,106,1,0.1
1564,75,21,56,77,1,0.1
1565,75,24,117,141,1,0.1
1566,75,53,322,375,1,0.1
1567,75,11,61,72,1,0.1
1568,75,15,75,90,1,0.1
1569,75,16,53,69,1,0.1
1570,75,10,45,55,1,0.1
1571,75,19,120,139,1,0.1
1572,75,37,146,183,1,0.1
1573,75,14,60,74,1,0.1
1574,75,34,372,406,1,0.1
1575,75,20,131,151,1,0.1
1576,75,29,192,221,1,0.1
1577,75,22,135,157,1,0.1
1578,75,3,19,22,1,0.1
1579,75,15,188,203,1,0.1
1580,75,25,176,201,1,0.1
1581,75,1,10,11,1,0.1
1582,75,18,66,84,1,0.1
1583,75,20,47,67,1,0.1
1584,75,5,18,23,1,0.1
1585,75,28,154,182,1,0.1
1586,75,24,163,187,1,0.1
1587,75,24,128,152,1,0.1
1588,75,48,199,247,1,0.1
1589,75,30,184,214,1,0.1
1590,75,4,30,34,1,0.1
1591,75,2,16,18,1,0.1
1592,75,37,84,121,1,0.1
1593,75,4,19,23,1,0.1
1594,75,12,85,97,1,0.1
1595,75,16,29,45,1,0.1
1596,75,19,180,199,1,0.1
1597,75,23,106,129,1,0.1
1598,75,29,50,79,1,0.1
1599,75,46,269,315,1,0.1
1600,75,44,317,361,1,0.1
1601,75,39,236,275,1,0.1
1602,75,2,38,40,1,0.1
1603,75,23,99,122,1,0.1
1604,75,38,279,317,1,0.1
1605,75,33,62,95,1,0.1
1606,75,20,95,115,1,0.1
1607,75,4,16,20,1,0.1
1608,75,4,11,15,1,0.1
1609,75,10,48,58,1,0.1
1610,75,8,44,52,1,0.1
1611,75,11,26,37,1,0.1
1612,75,8,41,49,1,0.1
1613,75,20,196,216,1,0.1
1614,75,43,142,185,1,0.1
1615,75,6,64,70,1,0.1
1616,75,33,172,205,1,0.1
1617,75,61,253,314,1,0.1
1618,75,14,118,132,1,0.1
1619,75,20,77,97,1,0.1
1620,75,47,218,265,1,0.1
1621,75,18,105,123,1,0.1
1622,75,10,31,41,1,0.1
1623,75,31,163,194,1,0.1
1624,75,21,142,163,1,0.1
1625,75,19,121,140,1,0.1
1626,75,68,193,261,1,0.1
1627,75,9,95,104,1,0.1
1628,75,12,122,134,1,0.1
1629,75,6,11,17,1,0.1
1630,75,0,26,26,1,0.1
1631,75,9,60,69,1,0.1
1632,75,13,41,54,1,0.1
1633,75,8,36,44,1,0.1
1634,75,22,93,115,1,0.1
1635,75,13,131,144,1,0.1
1636,75,19,85,104,1,0.1
1637,75,30,157,187,1,0.1
1638,75,26,170,196,1,0.1
1639,75,25,128,153,1,0.1
1640,75,87,240,327,1,0.1
1641,75,11,11,22,1,0.1
1642,75,13,95,108,1,0.1
1643,75,2,8,10,1,0.1
1644,75,22,139,161,1,0.1
1645,75,19,86,105,1,0.1
1646,75,47,125,172,1,0.1
1647,75,10,66,76,1,0.1
1648,75,21,195,216,1,0.1
1649,75,39,226,265,1,0.1
1650,75,16,161,177,1,0.1
1651,75,73,271,344,1,0.1
1652,75,13,39,52,1,0.1
1653,75,17,59,76,1,0.1
1654,75,8,49,57,1,0.1
1655,75,4,20,24,1,0.1
1656,75,1,16,17,1,0.1
1657,75,11,58,69,1,0.1
1658,75,3,34,37,1,0.1
1659,75,30,57,87,1,0.1
1660,75,13,73,86,1,0.1
1661,75,24,85,109,1,0.1
1662,75,29,151,180,1,0.1
1663,75,95,148,243,1,0.1
1664,75,12,96,108,1,0.1
1665,75,15,32,47,1,0.1
1666,75,35,146,181,1,0.1
1667,75,35,165,200,1,0.1
1668,75,27,131,158,1,0.1
1669,75,62,314,376,1,0.1
1670,75,32,136,168,1,0.1
1671,75,3,12,15,1,0.1
1672,75,13,50,63,1,0.1
1673,75,19,88,107,1,0.1
1674,75,10,9,19,1,0.1
1675,75,17,89,106,1,0.1
1676,75,30,83,113,1,0.1
1677,75,48,161,209,1,0.1
1678,75,20,149,169,1,0.1
1679,75,44,165,209,1,0.1
1680,75,10,29,39,1,0.1
1681,75,33,100,133,1,0.1
1682,75,35,157,192,1,0.1
1683,75,26,168,194,1,0.1
1684,75,20,83,103,1,0.1
1685,75,37,97,134,1,0.1
1686,75,0,6,6,1,0.1
1687,75,14,47,61,1,0.1
1688,75,3,19,22,1,0.1
1689,75,5,43,48,1,0.1
1690,75,0,2,2,1,0.1
1691,75,0,0,0,1,0.1
1692,75,24,166,190,1,1.0
1693,75,44,94,138,1,1.0
1694,75,6,35,41,1,1.0
1695,75,71,375,446,1,1.0
1696,75,34,100,134,1,1.0
1697,75,39,166,205,1,1.0
1698,75,29,148,177,1,1.0
1699,75,34,237,271,1,1.0
1700,75,1,11,12,1,1.0
1701,75,3,32,35,1,1.0
1702,75,52,215,267,1,1.0
1703,75,35,128,163,1,1.0
1704,75,18,35,53,1,1.0
1705,75,36,213,249,1,1.0
1706,75,32,156,188,1,1.0
1707,75,49,115,164,1,1.0
1708,75,59,223,282,1,1.0
1709,75,50,152,202,1,1.0
1710,75,12,100,112,1,1.0
1711,75,21,121,142,1,1.0
1712,75,9,50,59,1,1.0
1713,75,55,120,175,1,1.0
1714,75,20,69,89,1,1.0
1715,75,9,64,73,1,1.0
1716,75,46,80,126,1,1.0
1717,75,24,85,109,1,1.0
1718,75,48,221,269,1,1.0
1719,75,31,268,299,1,1.0
1720,75,48,181,229,1,1.0
1721,75,32,115,147,1,1.0
1722,75,37,152,189,1,1.0
1723,75,24,96,120,1,1.0
1724,75,40,92,132,1,1.0
1725,75,8,54,62,1,1.0
1726,75,20,53,73,1,1.0
1727,75,47,117,164,1,1.0
1728,75,0,5,5,1,1.0
1729,75,27,104,131,1,1.0
1730,75,25,110,135,1,1.0
1731,75,20,150,170,1,1.0
1732,75,22,235,257,1,1.0
1733,75,13,71,84,1,1.0
1734,75,17,147,164,1,1.0
1735,75,18,84,102,1,1.0
1736,75,11,17,28,1,1.0
1737,75,10,60,70,1,1.0
1738,75,10,51,61,1,1.0
1739,75,11,40,51,1,1.0
1740,75,6,12,18,1,1.0
1741,75,26,61,87,1,1.0
1742,75,37,216,253,1,1.0
1743,75,37,224,261,1,1.0
1744,75,37,121,158,1,1.0
1745,75,51,259,310,1,1.0
1746,75,23,42,65,1,1.0
1747,75,28,115,143,1,1.0
1748,75,34,144,178,1,1.0
1749,75,53,182,235,1,1.0
1750,75,7,23,30,1,1.0
1751,75,28,52,80,1,1.0
1752,75,47,247,294,1,1.0
1753,75,12,64,76,1,1.0
1754,75,22,88,110,1,1.0
1755,75,33,218,251,1,1.0
1756,75,36,187,223,1,1.0
1757,75,0,10,10,1,1.0
1758,75,34,200,234,1,1.0
1759,75,18,58,76,1,1.0
1760,75,36,149,185,1,1.0
1761,75,22,53,75,1,1.0
1762,75,16,28,44,1,1.0
1763,75,9,22,31,1,1.0
1764,75,9,94,103,1,1.0
1765,75,17,128,145,1,1.0
1766,75,21,97,118,1,1.0
1767,75,32,149,181,1,1.0
1768,75,41,240,281,1,1.0
1769,75,25,180,205,1,1.0
1770,75,38,125,163,1,1.0
1771,75,15,69,84,1,1.0
1772,75,37,163,200,1,1.0
1773,75,23,103,126,1,1.0
1774,75,11,46,57,1,1.0
1775,75,29,48,77,1,1.0
1776,75,32,66,98,1,1.0
1777,75,3,5,8,1,1.0
1778,75,13,26,39,1,1.0
1779,75,13,82,95,1,1.0
1780,75,8,44,52,1,1.0
1781,75,35,127,162,1,1.0
1782,75,37,169,206,1,1.0
1783,75,83,318,401,1,1.0
1784,75,46,253,299,1,1.0
1785,75,33,193,226,1,1.0
1786,75,4,69,73,1,1.0
1787,75,27,136,163,1,1.0
1788,75,11,70,81,1,1.0
1789,75,41,106,147,1,1.0
1790,75,2,16,18,1,1.0
1791,75,8,26,34,1,1.0
1792,75,68,176,244,1,1.0
1793,75,63,274,337,1,1.0
1794,75,84,179,263,1,1.0
1795,75,27,166,193,1,1.0
1796,75,27,327,354,1,1.0
1797,75,29,140,169,1,1.0
1798,75,16,28,44,1,1.0
1799,75,47,147,194,1,1.0
1800,75,16,33,49,1,1.0
1801,75,16,61,77,1,1.0
1802,75,40,107,147,1,1.0
1803,75,32,117,149,1,1.0
1804,75,39,149,188,1,1.0
1805,75,82,206,288,1,1.0
1806,75,33,97,130,1,1.0
1807,75,52,162,214,1,1.0
1808,75,54,189,243,1,1.0
1809,75,22,128,150,1,1.0
1810,75,52,142,194,1,1.0
1811,75,92,186,278,1,1.0
1812,75,14,40,54,1,1.0
1813,75,23,43,66,1,1.0
1814,75,32,52,84,1,1.0
1815,75,12,22,34,1,1.0
1816,75,35,125,160,1,1.0
1817,75,36,129,165,1,1.0
1818,75,17,119,136,1,1.0
1819,75,25,180,205,1,1.0
1820,75,23,109,132,1,1.0
1821,75,44,179,223,1,1.0
1822,75,21,118,139,1,1.0
1823,75,3,39,42,1,1.0
1824,75,11,76,87,1,1.0
1825,75,5,33,38,1,1.0
1826,75,18,38,56,1,1.0
1827,75,10,46,56,1,1.0
1828,75,69,293,362,1,1.0
1829,75,9,53,62,1,1.0
1830,75,47,182,229,1,1.0
1831,75,54,272,326,1,1.0
1832,75,29,142,171,1,1.0
1833,75,20,57,77,1,1.0
1834,75,32,122,154,1,1.0
1835,75,47,77,124,1,1.0
1836,75,20,70,90,1,1.0
1837,75,20,91,111,1,1.0
1838,75,27,63,90,1,1.0
1839,75,20,22,42,1,1.0
1840,75,8,37,45,1,1.0
1841,75,3,8,11,1,1.0
1842,75,26,189,215,1,1.0
1843,75,38,307,345,1,1.0
1844,75,57,186,243,1,1.0
1845,75,53,237,290,1,1.0
1846,75,34,102,136,1,1.0
1847,75,77,275,352,1,1.0
1848,75,54,145,199,1,1.0
1849,75,8,31,39,1,1.0
1850,75,10,31,41,1,1.0
1851,75,5,71,76,1,1.0
1852,75,0,4,4,1,1.0
1853,75,66,176,242,1,1.0
1854,75,16,136,152,1,1.0
1855,75,38,179,217,1,1.0
1856,75,2,37,39,1,1.0
1857,75,34,119,153,1,1.0
1858,75,45,165,210,1,1.0
1859,75,11,107,118,1,1.0
1860,75,54,144,198,1,1.0
1861,75,31,107,138,1,1.0
1862,75,40,114,154,1,1.0
1863,75,0,2,2,1,1.0
1864,75,10,30,40,1,1.0
1865,75,1,7,8,1,1.0
1866,75,9,27,36,1,1.0
1867,75,39,220,259,1,1.0
1868,75,39,155,194,1,1.0
1869,75,33,161,194,1,1.0
1870,75,20,86,106,1,1.0
1871,75,44,273,317,1,1.0
1872,75,11,71,82,1,1.0
1873,75,2,24,26,1,1.0
1874,75,24,197,221,1,1.0
1875,75,25,161,186,1,1.0
1876,75,18,82,100,1,1.0
1877,75,18,93,111,1,1.0
1878,75,5,23,28,1,1.0
1879,75,8,36,44,1,1.0
1880,75,69,213,282,1,1.0
1881,75,52,211,263,1,1.0
1882,75,39,166,205,1,1.0
1883,75,66,113,179,1,1.0
1884,75,37,247,284,1,1.0
1885,75,57,121,178,1,1.0
1886,75,20,71,91,1,1.0
1887,75,29,89,118,1,1.0
1888,75,32,99,131,1,1.0
1889,75,19,57,76,1,1.0
1890,75,45,191,236,1,1.0
1891,75,24,144,168,1,1.0
1892,75,5,62,67,1,1.0
1893,75,26,73,99,1,1.0
1894,75,3,11,14,1,1.0
1895,75,18,54,72,1,1.0
1896,75,32,189,221,1,1.0
1897,75,26,44,70,1,1.0
1898,75,43,170,213,1,1.0
1899,75,49,204,253,1,1.0
1900,75,17,116,133,1,1.0
1901,75,22,79,101,1,1.0
1902,75,29,166,195,1,1.0
1903,75,17,59,76,1,1.0
1904,75,6,48,54,1,1.0
1905,75,17,66,83,1,1.0
1906,75,3,3,6,1,1.0
1907,75,3,10,13,1,1.0
1908,75,14,35,49,1,1.0
1909,75,73,183,256,1,1.0
1910,75,21,52,73,1,1.0
1911,75,60,163,223,1,1.0
1912,75,73,253,326,1,1.0
1913,75,90,185,275,1,1.0
1914,75,39,198,237,1,1.0
1915,75,30,128,158,1,1.0
1916,75,21,97,118,1,1.0
1917,75,12,53,65,1,1.0
1918,75,17,35,52,1,1.0
1919,75,5,36,41,1,1.0
1920,75,2,8,10,1,1.0
1921,75,24,28,52,1,1.0
1922,75,3,25,28,1,1.0
1923,75,28,115,143,1,1.0
1924,75,51,100,151,1,1.0
1925,75,36,158,194,1,1.0
1926,75,3,5,8,1,1.0
1927,75,41,121,162,1,1.0
1928,75,78,194,272,1,1.0
1929,75,17,41,58,1,1.0
1930,75,16,34,50,1,1.0
1931,75,18,32,50,1,1.0
1932,75,24,81,105,1,1.0
1933,75,7,48,55,1,1.0
1934,75,3,7,10,1,1.0
1935,75,8,12,20,1,1.0
1936,75,51,154,205,1,1.0
1937,75,24,105,129,1,1.0
1938,75,58,195,253,1,1.0
1939,75,55,202,257,1,1.0
1940,75,35,192,227,1,1.0
1941,75,53,204,257,1,1.0
1942,75,35,128,163,1,1.0
1943,75,12,50,62,1,1.0
1944,75,14,93,107,1,1.0
1945,75,35,93,128,1,1.0
1946,75,21,78,99,1,1.0
1947,75,33,68,101,1,1.0
1948,75,40,223,263,1,1.0
1949,75,15,76,91,1,1.0
1950,75,20,183,203,1,1.0
1951,75,33,129,162,1,1.0
1952,75,14,49,63,1,1.0
1953,75,22,90,112,1,1.0
1954,75,21,130,151,1,1.0
1955,75,13,35,48,1,1.0
1956,75,12,64,76,1,1.0
1957,75,12,85,97,1,1.0
1958,75,86,167,253,1,1.0
1959,75,5,25,30,1,1.0
1960,75,19,59,78,1,1.0
1961,75,14,22,36,1,1.0
1962,75,24,109,133,1,1.0
1963,75,31,152,183,1,1.0
1964,75,27,111,138,1,1.0
1965,75,22,127,149,1,1.0
1966,75,37,77,114,1,1.0
1967,75,24,157,181,1,1.0
1968,75,23,62,85,1,1.0
1969,75,3,15,18,1,1.0
1970,75,13,79,92,1,1.0
1971,75,15,29,44,1,1.0
1972,75,18,76,94,1,1.0
1973,75,10,13,23,1,1.0
1974,75,7,32,39,1,1.0
1975,75,91,174,265,1,1.0
1976,75,44,201,245,1,1.0
1977,75,52,172,224,1,1.0
1978,75,101,155,256,1,1.0
1979,75,19,64,83,1,1.0
1980,75,10,23,33,1,1.0
1981,75,11,38,49,1,1.0
1982,75,15,35,50,1,1.0
1983,75,34,81,115,1,1.0
1984,75,43,54,97,1,1.0
1985,75,1,18,19,1,1.0
1986,75,5,23,28,1,1.0
1987,75,10,37,47,1,1.0
1988,75,11,111,122,1,1.0
1989,75,11,37,48,1,1.0
1990,75,17,114,131,1,1.0
1991,75,66,246,312,1,1.0
1992,75,61,285,346,1,1.0
1993,75,26,62,88,1,1.0
1994,75,24,137,161,1,1.0
1995,75,21,73,94,1,1.0
1996,75,14,87,101,1,1.0
1997,75,13,57,70,1,1.0
1998,75,3,43,46,1,1.0
1999,75,32,131,163,1,1.0
2000,75,10,87,97,1,1.0
2001,75,24,66,90,1,1.0
2002,75,37,177,214,1,1.0
2003,75,24,74,98,1,1.0
2004,75,28,91,119,1,1.0
2005,75,40,134,174,1,1.0
2006,75,31,147,178,1,1.0
2007,75,16,102,118,1,1.0
2008,75,46,133,179,1,1.0
2009,75,4,11,15,1,1.0
2010,75,15,46,61,1,1.0
2011,75,32,87,119,1,1.0
2012,75,0,3,3,1,1.0
2013,75,9,20,29,1,1.0
2014,75,22,60,82,1,1.0
2015,75,3,17,20,1,1.0
2016,75,20,232,252,1,1.0
2017,75,14,24,38,1,1.0
2018,75,13,89,102,1,1.0
2019,75,9,31,40,1,1.0
2020,75,17,55,72,1,1.0
2021,75,48,152,200,1,1.0
2022,75,9,32,41,1,1.0
2023,75,10,19,29,1,1.0
2024,75,6,28,34,1,1.0
2025,75,9,18,27,1,1.0
2026,75,0,22,22,1,1.0
2027,75,13,38,51,1,1.0
2028,75,24,36,60,1,1.0
2029,75,16,4,20,1,1.0
2030,75,39,140,179,1,1.0
2031,75,4,14,18,1,1.0
2032,75,6,23,29,1,1.0
2033,75,21,82,103,1,1.0
2034,75,26,89,115,1,1.0
2035,75,10,58,68,1,1.0
2036,75,56,212,268,1,1.0
2037,75,33,92,125,1,1.0
2038,75,17,142,159,1,1.0
2039,75,61,91,152,1,1.0
2040,75,46,81,127,1,1.0
2041,75,38,108,146,1,1.0
2042,75,19,56,75,1,1.0
2043,75,22,50,72,1,1.0
2044,75,24,19,43,1,1.0
2045,75,66,233,299,1,1.0
2046,75,6,9,15,1,1.0
2047,75,59,217,276,1,1.0
2048,75,73,248,321,1,1.0
2049,75,80,312,392,1,1.0
2050,75,167,584,751,1,1.0
2051,75,58,141,199,1,1.0
2052,75,46,153,199,1,1.0
2053,75,66,138,204,1,1.0
2054,75,58,136,194,1,1.0
2055,75,16,69,85,1,1.0
2056,75,39,108,147,1,1.0
2057,75,12,56,68,1,1.0
2058,75,57,41,98,1,1.0
2059,75,31,160,191,1,1.0
2060,75,24,100,124,1,1.0
2061,75,33,51,84,1,1.0
2062,75,16,72,88,1,1.0
2063,75,11,34,45,1,1.0
2064,75,8,14,22,1,1.0
2065,75,1,5,6,1,1.0
2066,75,15,27,42,1,1.0
2067,75,0,0,0,1,1.0
2068,75,11,76,87,1,1.0
2069,75,51,116,167,1,1.0
2070,75,40,122,162,1,1.0
2071,75,20,153,173,1,1.0
2072,75,25,252,277,1,1.0
2073,75,15,32,47,1,1.0
2074,75,20,18,38,1,1.0
2075,75,102,307,409,1,10.0
2076,75,40,105,145,1,10.0
2077,75,47,199,246,1,10.0
2078,75,22,101,123,1,10.0
2079,75,53,106,159,1,10.0
2080,75,38,179,217,1,10.0
2081,75,102,137,239,1,10.0
2082,75,76,229,305,1,10.0
2083,75,40,57,97,1,10.0
2084,75,57,94,151,1,10.0
2085,75,13,47,60,1,10.0
2086,75,32,94,126,1,10.0
2087,75,39,97,136,1,10.0
2088,75,11,22,33,1,10.0
2089,75,10,64,74,1,10.0
2090,75,26,66,92,1,10.0
2091,75,23,89,112,1,10.0
2092,75,79,253,332,1,10.0
2093,75,19,47,66,1,10.0
2094,75,101,270,371,1,10.0
2095,75,42,109,151,1,10.0
2096,75,22,132,154,1,10.0
2097,75,12,18,30,1,10.0
2098,75,48,127,175,1,10.0
2099,75,37,99,136,1,10.0
2100,75,4,8,12,1,10.0
2101,75,10,23,33,1,10.0
2102,75,44,65,109,1,10.0
2103,75,14,38,52,1,10.0
2104,75,33,60,93,1,10.0
2105,75,55,71,126,1,10.0
2106,75,36,146,182,1,10.0
2107,75,111,101,212,1,10.0
2108,75,84,308,392,1,10.0
2109,75,55,143,198,1,10.0
2110,75,33,232,265,1,10.0
2111,75,44,95,139,1,10.0
2112,75,74,193,267,1,10.0
2113,75,27,89,116,1,10.0
2114,75,57,143,200,1,10.0
2115,75,20,29,49,1,10.0
2116,75,16,35,51,1,10.0
2117,75,23,82,105,1,10.0
2118,75,68,100,168,1,10.0
2119,75,21,64,85,1,10.0
2120,75,16,66,82,1,10.0
2121,75,14,17,31,1,10.0
2122,75,47,109,156,1,10.0
2123,75,70,161,231,1,10.0
2124,75,62,167,229,1,10.0
2125,75,62,205,267,1,10.0
2126,75,36,164,200,1,10.0
2127,75,23,169,192,1,10.0
2128,75,33,46,79,1,10.0
2129,75,14,82,96,1,10.0
2130,75,106,345,451,1,10.0
2131,75,9,29,38,1,10.0
2132,75,26,69,95,1,10.0
2133,75,13,35,48,1,10.0
2134,75,7,18,25,1,10.0
2135,75,30,57,87,1,10.0
2136,75,16,35,51,1,10.0
2137,75,51,103,154,1,10.0
2138,75,40,143,183,1,10.0
2139,75,55,90,145,1,10.0
2140,75,48,89,137,1,10.0
2141,75,108,326,434,1,10.0
2142,75,99,223,322,1,10.0
2143,75,59,159,218,1,10.0
2144,75,42,113,155,1,10.0
2145,75,35,194,229,1,10.0
2146,75,16,157,173,1,10.0
2147,75,67,189,256,1,10.0
2148,75,29,63,92,1,10.0
2149,75,41,124,165,1,10.0
2150,75,49,81,130,1,10.0
2151,75,54,44,98,1,10.0
2152,75,35,113,148,1,10.0
2153,75,22,92,114,1,10.0
2154,75,138,405,543,1,10.0
2155,75,115,204,319,1,10.0
2156,75,103,221,324,1,10.0
2157,75,116,288,404,1,10.0
2158,75,68,179,247,1,10.0
2159,75,72,180,252,1,10.0
2160,75,45,78,123,1,10.0
2161,75,28,112,140,1,10.0
2162,75,55,148,203,1,10.0
2163,75,48,68,116,1,10.0
2164,75,91,119,210,1,10.0
2165,75,35,155,190,1,10.0
2166,75,10,17,27,1,10.0
2167,75,47,107,154,1,10.0
2168,75,50,76,126,1,10.0
2169,75,38,53,91,1,10.0
2170,75,24,21,45,1,10.0
2171,75,19,73,92,1,10.0
2172,75,54,80,134,1,10.0
2173,75,36,54,90,1,10.0
2174,75,61,103,164,1,10.0
2175,75,60,137,197,1,10.0
2176,75,82,321,403,1,10.0
2177,75,50,52,102,1,10.0
2178,75,23,142,165,1,10.0
2179,75,116,247,363,1,10.0
2180,75,33,76,109,1,10.0
2181,75,41,134,175,1,10.0
2182,75,128,270,398,1,10.0
2183,75,36,53,89,1,10.0
2184,75,18,51,69,1,10.0
2185,75,38,60,98,1,10.0
2186,75,151,324,475,1,10.0
2187,75,19,69,88,1,10.0
2188,75,119,272,391,1,10.0
2189,75,35,55,90,1,10.0
2190,75,61,103,164,1,10.0
2191,75,38,76,114,1,10.0
2192,75,66,109,175,1,10.0
2193,75,91,222,313,1,10.0
2194,75,33,103,136,1,10.0
2195,75,55,167,222,1,10.0
2196,75,71,144,215,1,10.0
2197,75,64,99,163,1,10.0
2198,75,7,31,38,1,10.0
2199,75,27,78,105,1,10.0
2200,75,91,165,256,1,10.0
2201,75,171,189,360,1,10.0
2202,75,67,236,303,1,10.0
2203,75,157,385,542,1,10.0
2204,75,65,310,375,1,10.0
2205,75,129,311,440,1,10.0
2206,75,94,283,377,1,10.0
2207,75,111,235,346,1,10.0
2208,75,39,127,166,1,10.0
2209,75,55,155,210,1,10.0
2210,75,15,36,51,1,10.0
2211,75,21,31,52,1,10.0
2212,75,26,52,78,1,10.0
2213,75,19,55,74,1,10.0
2214,75,53,118,171,1,10.0
2215,75,97,234,331,1,10.0
2216,75,48,174,222,1,10.0
2217,75,89,171,260,1,10.0
2218,75,119,134,253,1,10.0
2219,75,64,145,209,1,10.0
2220,75,36,102,138,1,10.0
2221,75,55,118,173,1,10.0
2222,75,28,105,133,1,10.0
2223,75,41,127,168,1,10.0
2224,75,66,185,251,1,10.0
2225,75,77,129,206,1,10.0
2226,75,24,31,55,1,10.0
2227,75,142,251,393,1,10.0
2228,75,14,42,56,1,10.0
2229,75,9,15,24,1,10.0
2230,75,18,66,84,1,10.0
2231,75,41,49,90,1,10.0
2232,75,87,220,307,1,10.0
2233,75,98,136,234,1,10.0
2234,75,23,46,69,1,10.0
2235,75,45,108,153,1,10.0
2236,75,84,291,375,1,10.0
2237,75,137,242,379,1,10.0
2238,75,45,209,254,1,10.0
2239,75,21,104,125,1,10.0
2240,75,73,127,200,1,10.0
2241,75,67,126,193,1,10.0
2242,75,51,152,203,1,10.0
2243,75,61,101,162,1,10.0
2244,75,110,248,358,1,10.0
2245,75,76,126,202,1,10.0
2246,75,23,82,105,1,10.0
2247,75,84,106,190,1,10.0
2248,75,46,126,172,1,10.0
2249,75,69,115,184,1,10.0
2250,75,32,28,60,1,10.0
2251,75,68,182,250,1,10.0
2252,75,77,273,350,1,10.0
2253,75,89,180,269,1,10.0
2254,75,49,145,194,1,10.0
2255,75,66,173,239,1,10.0
2256,75,106,300,406,1,10.0
2257,75,35,76,111,1,10.0
2258,75,55,141,196,1,10.0
2259,75,20,73,93,1,10.0
2260,75,4,17,21,1,10.0
2261,75,18,32,50,1,10.0
2262,75,31,34,65,1,10.0
2263,75,68,116,184,1,10.0
2264,75,19,41,60,1,10.0
2265,75,44,210,254,1,10.0
2266,75,35,105,140,1,10.0
2267,75,35,145,180,1,10.0
2268,75,37,131,168,1,10.0
2269,75,30,98,128,1,10.0
2270,75,97,210,307,1,10.0
2271,75,42,108,150,1,10.0
2272,75,61,107,168,1,10.0
2273,75,142,256,398,1,10.0
2274,75,2,23,25,1,10.0
2275,75,57,118,175,1,10.0
2276,75,154,307,461,1,10.0
2277,75,78,123,201,1,10.0
2278,75,153,323,476,1,10.0
2279,75,18,51,69,1,10.0
2280,75,55,131,186,1,10.0
2281,75,19,83,102,1,10.0
2282,75,25,73,98,1,10.0
2283,75,58,121,179,1,10.0
2284,75,29,100,129,1,10.0
2285,75,14,52,66,1,10.0
2286,75,27,73,100,1,10.0
2287,75,57,94,151,1,10.0
2288,75,54,65,119,1,10.0
2289,75,58,112,170,1,10.0
2290,75,47,220,267,1,10.0
2291,75,19,91,110,1,10.0
2292,75,41,92,133,1,10.0
2293,75,46,80,126,1,10.0
2294,75,168,258,426,1,10.0
2295,75,8,72,80,1,10.0
2296,75,52,166,218,1,10.0
2297,75,55,129,184,1,10.0
2298,75,50,198,248,1,10.0
2299,75,63,59,122,1,10.0
2300,75,52,119,171,1,10.0
2301,75,11,24,35,1,10.0
2302,75,50,120,170,1,10.0
2303,75,28,45,73,1,10.0
2304,75,12,26,38,1,10.0
2305,75,16,27,43,1,10.0
2306,75,3,6,9,1,10.0
2307,75,33,73,106,1,10.0
2308,75,81,131,212,1,10.0
2309,75,62,158,220,1,10.0
2310,75,27,88,115,1,10.0
2311,75,85,283,368,1,10.0
2312,75,47,182,229,1,10.0
2313,75,65,169,234,1,10.0
2314,75,17,67,84,1,10.0
2315,75,55,156,211,1,10.0
2316,75,82,143,225,1,10.0
2317,75,25,149,174,1,10.0
2318,75,24,39,63,1,10.0
2319,75,63,129,192,1,10.0
2320,75,11,11,22,1,10.0
2321,75,21,77,98,1,10.0
2322,75,15,65,80,1,10.0
2323,75,19,44,63,1,10.0
2324,75,5,21,26,1,10.0
2325,75,69,90,159,1,10.0
2326,75,23,73,96,1,10.0
2327,75,44,168,212,1,10.0
2328,75,57,140,197,1,10.0
2329,75,7,29,36,1,10.0
2330,75,45,87,132,1,10.0
2331,75,155,363,518,1,10.0
2332,75,58,155,213,1,10.0
2333,75,73,275,348,1,10.0
2334,75,25,80,105,1,10.0
2335,75,59,254,313,1,10.0
2336,75,56,86,142,1,10.0
2337,75,45,159,204,1,10.0
2338,75,42,94,136,1,10.0
2339,75,14,41,55,1,10.0
2340,75,75,167,242,1,10.0
2341,75,3,32,35,1,10.0
2342,75,29,85,114,1,10.0
2343,75,29,187,216,1,10.0
2344,75,14,137,151,1,10.0
2345,75,42,209,251,1,10.0
2346,75,93,295,388,1,10.0
2347,75,16,12,28,1,10.0
2348,75,27,90,117,1,10.0
2349,75,71,109,180,1,10.0
2350,75,6,21,27,1,10.0
2351,75,78,212,290,1,10.0
2352,75,29,93,122,1,10.0
2353,75,7,20,27,1,10.0
2354,75,27,72,99,1,10.0
2355,75,54,56,110,1,10.0
2356,75,44,69,113,1,10.0
2357,75,32,131,163,1,10.0
2358,75,106,235,341,1,10.0
2359,75,13,187,200,1,10.0
2360,75,104,156,260,1,10.0
2361,75,97,340,437,1,10.0
2362,75,36,75,111,1,10.0
2363,75,69,243,312,1,10.0
2364,75,37,118,155,1,10.0
2365,75,27,54,81,1,10.0
2366,75,23,55,78,1,10.0
2367,75,47,95,142,1,10.0
2368,75,4,15,19,1,10.0
2369,75,65,185,250,1,10.0
2370,75,38,118,156,1,10.0
2371,75,79,200,279,1,10.0
2372,75,66,191,257,1,10.0
2373,75,36,149,185,1,10.0
2374,75,22,147,169,1,10.0
2375,75,62,276,338,1,10.0
2376,75,41,107,148,1,10.0
2377,75,34,82,116,1,10.0
2378,75,64,150,214,1,10.0
2379,75,27,129,156,1,10.0
2380,75,144,256,400,1,10.0
2381,75,120,249,369,1,10.0
2382,75,116,237,353,1,10.0
2383,75,36,63,99,1,10.0
2384,75,43,184,227,1,10.0
2385,75,8,44,52,1,10.0
2386,75,59,224,283,1,10.0
2387,75,35,88,123,1,10.0
2388,75,40,95,135,1,10.0
2389,75,66,161,227,1,10.0
2390,75,3,4,7,1,10.0
2391,75,15,52,67,1,10.0
2392,75,2,2,4,1,10.0
2393,75,61,103,164,1,10.0
2394,75,2,9,11,1,10.0
2395,75,7,39,46,1,10.0
2396,75,26,96,122,1,10.0
2397,75,100,342,442,1,10.0
2398,75,68,188,256,1,10.0
2399,75,57,134,191,1,10.0
2400,75,10,103,113,1,10.0
2401,75,16,35,51,1,10.0
2402,75,10,40,50,1,10.0
2403,75,177,231,408,1,10.0
2404,75,43,125,168,1,10.0
2405,75,13,39,52,1,10.0
2406,75,153,279,432,1,10.0
2407,75,99,257,356,1,10.0
2408,75,51,35,86,1,10.0
2409,75,30,64,94,1,10.0
2410,75,107,186,293,1,10.0
2411,75,66,191,257,1,10.0
2412,75,36,82,118,1,10.0
2413,75,63,216,279,1,10.0
2414,75,43,133,176,1,10.0
2415,75,114,160,274,1,10.0
2416,75,66,73,139,1,10.0
2417,75,31,102,133,1,10.0
2418,75,42,113,155,1,10.0
2419,75,37,50,87,1,10.0
2420,75,59,143,202,1,10.0
2421,75,37,50,87,1,10.0
2422,75,55,119,174,1,10.0
2423,75,41,69,110,1,10.0
2424,75,16,34,50,1,10.0
2425,75,81,197,278,1,10.0
2426,75,65,254,319,1,10.0
2427,75,103,315,418,1,10.0
2428,75,33,150,183,1,10.0
2429,75,72,324,396,1,10.0
2430,75,72,211,283,1,10.0
2431,75,52,178,230,1,10.0
2432,75,71,202,273,1,10.0
2433,75,58,180,238,1,10.0
2434,75,31,67,98,1,10.0
2435,75,55,134,189,1,10.0
2436,75,32,104,136,1,10.0
2437,75,19,48,67,1,10.0
2438,75,5,24,29,1,10.0
2439,75,8,14,22,1,10.0
2440,75,61,147,208,1,10.0
2441,75,62,154,216,1,10.0
2442,75,53,107,160,1,10.0
2443,75,41,119,160,1,10.0
2444,75,51,149,200,1,10.0
2445,75,84,74,158,1,10.0
2446,75,149,345,494,1,10.0
2447,75,45,174,219,1,10.0
2448,75,58,152,210,1,10.0
2449,75,55,83,138,1,10.0
2450,75,27,73,100,1,10.0
2451,75,47,145,192,1,10.0
2452,75,18,48,66,1,10.0
2453,75,5,9,14,1,10.0
2454,75,48,151,199,1,10.0
2455,75,21,71,92,1,10.0
2456,75,37,77,114,1,10.0
2457,75,47,94,141,1,10.0
2458,75,46,220,266,1,10.0
2459,75,35,85,120,1,10.0
2460,75,125,275,400,1,10.0
2461,75,8,66,74,1,10.0
2462,75,87,139,226,1,10.0
2463,75,39,139,178,1,10.0
2464,75,47,141,188,1,10.0
2465,75,30,61,91,1,10.0
2466,75,138,191,329,1,10.0
2467,75,67,212,279,1,10.0
2468,75,33,68,101,1,10.0
2469,75,36,63,99,1,10.0
2470,75,6,16,22,1,10.0
2471,75,33,97,130,1,10.0
2472,75,47,168,215,1,10.0
2473,75,58,195,253,1,10.0
2474,75,35,285,320,1,10.0
2475,75,81,233,314,1,10.0
2476,75,59,322,381,1,10.0
2477,75,30,155,185,1,10.0
2478,75,40,142,182,1,10.0
2479,75,56,192,248,1,10.0
2480,75,20,33,53,1,10.0
2481,75,3,18,21,1,10.0
2482,75,12,18,30,1,10.0
2483,75,53,110,163,1,10.0
2484,75,7,51,58,1,10.0
2485,75,59,184,243,1,10.0
2486,75,62,192,254,1,10.0
2487,75,32,180,212,1,10.0
2488,75,37,195,232,1,10.0
2489,75,85,139,224,1,10.0
2490,75,99,225,324,1,10.0
2491,75,59,235,294,1,10.0
2492,75,66,178,244,1,10.0
2493,75,41,108,149,1,10.0
2494,75,103,187,290,1,10.0
2495,75,65,136,201,1,10.0
2496,75,20,71,91,1,10.0
2497,75,16,67,83,1,10.0
2498,75,12,42,54,1,10.0
2499,75,124,45,169,1,10.0
2500,75,28,133,161,1,10.0
2501,75,80,271,351,1,10.0
2502,75,44,248,292,1,10.0
2503,75,241,476,717,1,10.0
2504,75,89,206,295,1,10.0
2505,75,78,122,200,1,10.0
2506,75,81,74,155,1,10.0
2507,75,28,155,183,1,10.0
2508,75,107,302,409,1,10.0
2509,75,81,116,197,1,10.0
2510,75,26,104,130,1,10.0
2511,75,84,168,252,1,10.0
2512,75,22,108,130,1,10.0
2513,75,70,128,198,1,10.0
2514,75,63,110,173,1,100.0
2515,75,102,189,291,1,100.0
2516,75,79,186,265,1,100.0
2517,75,67,198,265,1,100.0
2518,75,57,163,220,1,100.0
2519,75,76,185,261,1,100.0
2520,75,13,41,54,1,100.0
2521,75,57,302,359,1,100.0
2522,75,49,103,152,1,100.0
2523,75,35,114,149,1,100.0
2524,75,24,47,71,1,100.0
2525,75,28,165,193,1,100.0
2526,75,74,137,211,1,100.0
2527,75,74,179,253,1,100.0
2528,75,32,76,108,1,100.0
2529,75,85,144,229,1,100.0
2530,75,160,508,668,1,100.0
2531,75,56,208,264,1,100.0
2532,75,27,119,146,1,100.0
2533,75,123,371,494,1,100.0
2534,75,43,96,139,1,100.0
2535,75,95,278,373,1,100.0
2536,75,46,73,119,1,100.0
2537,75,25,43,68,1,100.0
2538,75,89,229,318,1,100.0
2539,75,6,28,34,1,100.0
2540,75,35,65,100,1,100.0
2541,75,106,326,432,1,100.0
2542,75,85,189,274,1,100.0
2543,75,91,443,534,1,100.0
2544,75,48,300,348,1,100.0
2545,75,74,228,302,1,100.0
2546,75,29,37,66,1,100.0
2547,75,99,232,331,1,100.0
2548,75,33,134,167,1,100.0
2549,75,10,74,84,1,100.0
2550,75,10,33,43,1,100.0
2551,75,2,28,30,1,100.0
2552,75,47,161,208,1,100.0
2553,75,16,51,67,1,100.0
2554,75,71,160,231,1,100.0
2555,75,95,185,280,1,100.0
2556,75,40,124,164,1,100.0
2557,75,31,179,210,1,100.0
2558,75,93,329,422,1,100.0
2559,75,78,200,278,1,100.0
2560,75,69,281,350,1,100.0
2561,75,107,330,437,1,100.0
2562,75,32,92,124,1,100.0
2563,75,53,106,159,1,100.0
2564,75,72,272,344,1,100.0
2565,75,19,48,67,1,100.0
2566,75,127,319,446,1,100.0
2567,75,138,552,690,1,100.0
2568,75,73,277,350,1,100.0
2569,75,252,700,952,1,100.0
2570,75,186,609,795,1,100.0
2571,75,275,478,753,1,100.0
2572,75,146,260,406,1,100.0
2573,75,122,386,508,1,100.0
2574,75,91,253,344,1,100.0
2575,75,81,184,265,1,100.0
2576,75,94,122,216,1,100.0
2577,75,70,155,225,1,100.0
2578,75,39,131,170,1,100.0
2579,75,13,57,70,1,100.0
2580,75,51,160,211,1,100.0
2581,75,74,259,333,1,100.0
2582,75,51,225,276,1,100.0
2583,75,70,196,266,1,100.0
2584,75,39,58,97,1,100.0
2585,75,98,199,297,1,100.0
2586,75,68,177,245,1,100.0
2587,75,101,332,433,1,100.0
2588,75,107,271,378,1,100.0
2589,75,18,74,92,1,100.0
2590,75,64,173,237,1,100.0
2591,75,127,261,388,1,100.0
2592,75,59,112,171,1,100.0
2593,75,89,145,234,1,100.0
2594,75,24,40,64,1,100.0
2595,75,31,35,66,1,100.0
2596,75,5,33,38,1,100.0
2597,75,91,310,401,1,100.0
2598,75,141,411,552,1,100.0
2599,75,35,121,156,1,100.0
2600,75,37,144,181,1,100.0
2601,75,35,110,145,1,100.0
2602,75,53,228,281,1,100.0
2603,75,118,319,437,1,100.0
2604,75,239,452,691,1,100.0
2605,75,20,112,132,1,100.0
2606,75,83,221,304,1,100.0
2607,75,146,401,547,1,100.0
2608,75,145,419,564,1,100.0
2609,75,42,129,171,1,100.0
2610,75,46,136,182,1,100.0
2611,75,9,63,72,1,100.0
2612,75,46,42,88,1,100.0
2613,75,72,139,211,1,100.0
2614,75,95,237,332,1,100.0
2615,75,50,150,200,1,100.0
2616,75,64,299,363,1,100.0
2617,75,50,274,324,1,100.0
2618,75,30,79,109,1,100.0
2619,75,111,327,438,1,100.0
2620,75,50,149,199,1,100.0
2621,75,84,251,335,1,100.0
2622,75,53,183,236,1,100.0
2623,75,48,111,159,1,100.0
2624,75,61,66,127,1,100.0
2625,75,6,17,23,1,100.0
2626,75,25,86,111,1,100.0
2627,75,59,202,261,1,100.0
2628,75,159,347,506,1,100.0
2629,75,134,451,585,1,100.0
2630,75,230,426,656,1,100.0
2631,75,54,162,216,1,100.0
2632,75,84,237,321,1,100.0
2633,75,87,225,312,1,100.0
2634,75,100,337,437,1,100.0
2635,75,102,178,280,1,100.0
2636,75,102,147,249,1,100.0
2637,75,23,70,93,1,100.0
2638,75,67,129,196,1,100.0
2639,75,93,187,280,1,100.0
2640,75,65,146,211,1,100.0
2641,75,3,7,10,1,100.0
2642,75,25,52,77,1,100.0
2643,75,101,263,364,1,100.0
2644,75,41,75,116,1,100.0
2645,75,88,202,290,1,100.0
2646,75,88,321,409,1,100.0
2647,75,34,97,131,1,100.0
2648,75,69,287,356,1,100.0
2649,75,134,331,465,1,100.0
2650,75,97,155,252,1,100.0
2651,75,104,335,439,1,100.0
2652,75,101,181,282,1,100.0
2653,75,103,283,386,1,100.0
2654,75,62,154,216,1,100.0
2655,75,192,553,745,1,100.0
2656,75,101,117,218,1,100.0
2657,75,71,262,333,1,100.0
2658,75,113,215,328,1,100.0
2659,75,35,63,98,1,100.0
2660,75,34,55,89,1,100.0
2661,75,62,144,206,1,100.0
2662,75,83,256,339,1,100.0
2663,75,52,180,232,1,100.0
2664,75,41,72,113,1,100.0
2665,75,29,39,68,1,100.0
2666,75,48,93,141,1,100.0
2667,75,49,201,250,1,100.0
2668,75,39,105,144,1,100.0
2669,75,83,119,202,1,100.0
2670,75,58,147,205,1,100.0
2671,75,70,71,141,1,100.0
2672,75,90,179,269,1,100.0
2673,75,111,203,314,1,100.0
2674,75,74,102,176,1,100.0
2675,75,100,148,248,1,100.0
2676,75,85,83,168,1,100.0
2677,75,53,92,145,1,100.0
2678,75,61,123,184,1,100.0
2679,75,85,139,224,1,100.0
2680,75,29,66,95,1,100.0
2681,75,40,108,148,1,100.0
2682,75,28,89,117,1,100.0
2683,75,47,76,123,1,100.0
2684,75,29,107,136,1,100.0
2685,75,104,246,350,1,100.0
2686,75,64,183,247,1,100.0
2687,75,21,35,56,1,100.0
2688,75,73,181,254,1,100.0
2689,75,54,179,233,1,100.0
2690,75,67,203,270,1,100.0
2691,75,24,53,77,1,100.0
2692,75,87,269,356,1,100.0
2693,75,137,306,443,1,100.0
2694,75,130,370,500,1,100.0
2695,75,93,394,487,1,100.0
2696,75,215,558,773,1,100.0
2697,75,51,125,176,1,100.0
2698,75,120,248,368,1,100.0
2699,75,30,114,144,1,100.0
2700,75,71,112,183,1,100.0
2701,75,4,20,24,1,100.0
2702,75,127,259,386,1,100.0
2703,75,80,127,207,1,100.0
2704,75,98,303,401,1,100.0
2705,75,122,304,426,1,100.0
2706,75,66,117,183,1,100.0
2707,75,85,277,362,1,100.0
2708,75,193,455,648,1,100.0
2709,75,36,110,146,1,100.0
2710,75,53,213,266,1,100.0
2711,75,33,112,145,1,100.0
2712,75,69,142,211,1,100.0
2713,75,84,160,244,1,100.0
2714,75,4,20,24,1,100.0
2715,75,26,113,139,1,100.0
2716,75,70,167,237,1,100.0
2717,75,67,121,188,1,100.0
2718,75,109,403,512,1,100.0
2719,75,81,224,305,1,100.0
2720,75,146,464,610,1,100.0
2721,75,38,145,183,1,100.0
2722,75,39,125,164,1,100.0
2723,75,57,146,203,1,100.0
2724,75,31,109,140,1,100.0
2725,75,58,166,224,1,100.0
2726,75,28,175,203,1,100.0
2727,75,35,75,110,1,100.0
2728,75,35,65,100,1,100.0
2729,75,26,63,89,1,100.0
2730,75,86,150,236,1,100.0
2731,75,19,49,68,1,100.0
2732,75,50,145,195,1,100.0
2733,75,43,121,164,1,100.0
2734,75,70,187,257,1,100.0
2735,75,63,238,301,1,100.0
2736,75,92,274,366,1,100.0
2737,75,24,113,137,1,100.0
2738,75,65,187,252,1,100.0
2739,75,20,35,55,1,100.0
2740,75,79,184,263,1,100.0
2741,75,24,59,83,1,100.0
2742,75,40,56,96,1,100.0
2743,75,54,115,169,1,100.0
2744,75,15,34,49,1,100.0
2745,75,37,100,137,1,100.0
2746,75,61,103,164,1,100.0
2747,75,86,220,306,1,100.0
2748,75,7,53,60,1,100.0
2749,75,95,320,415,1,100.0
2750,75,37,70,107,1,100.0
2751,75,95,407,502,1,100.0
2752,75,79,140,219,1,100.0
2753,75,88,163,251,1,100.0
2754,75,28,101,129,1,100.0
2755,75,83,314,397,1,100.0
2756,75,33,84,117,1,100.0
2757,75,23,62,85,1,100.0
2758,75,15,49,64,1,100.0
2759,75,89,198,287,1,100.0
2760,75,27,69,96,1,100.0
2761,75,101,266,367,1,100.0
2762,75,37,115,152,1,100.0
2763,75,43,113,156,1,100.0
2764,75,21,67,88,1,100.0
2765,75,96,299,395,1,100.0
2766,75,107,241,348,1,100.0
2767,75,81,314,395,1,100.0
2768,75,108,218,326,1,100.0
2769,75,84,210,294,1,100.0
2770,75,83,130,213,1,100.0
2771,75,30,46,76,1,100.0
2772,75,22,112,134,1,100.0
2773,75,10,9,19,1,100.0
2774,75,57,193,250,1,100.0
2775,75,41,38,79,1,100.0
2776,75,27,168,195,1,100.0
2777,75,56,149,205,1,100.0
2778,75,92,257,349,1,100.0
2779,75,65,90,155,1,100.0
2780,75,116,306,422,1,100.0
2781,75,110,305,415,1,100.0
2782,75,31,52,83,1,100.0
2783,75,105,132,237,1,100.0
2784,75,91,154,245,1,100.0
2785,75,92,169,261,1,100.0
2786,75,91,207,298,1,100.0
2787,75,30,17,47,1,100.0
2788,75,13,39,52,1,100.0
2789,75,7,47,54,1,100.0
2790,75,64,157,221,1,100.0
2791,75,21,36,57,1,100.0
2792,75,13,8,21,1,100.0
2793,75,151,284,435,1,100.0
2794,75,148,385,533,1,100.0
2795,75,12,43,55,1,100.0
2796,75,91,166,257,1,100.0
2797,75,8,27,35,1,100.0
2798,75,28,84,112,1,100.0
2799,75,121,158,279,1,100.0
2800,75,62,139,201,1,100.0
2801,75,25,73,98,1,100.0
2802,75,7,30,37,1,100.0
2803,75,30,81,111,1,100.0
2804,75,10,17,27,1,100.0
2805,75,32,60,92,1,100.0
2806,75,5,24,29,1,100.0
2807,75,0,0,0,1,100.0
2808,75,57,78,135,1,100.0
2809,75,89,243,332,1,100.0
2810,75,53,199,252,1,100.0
2811,75,28,90,118,1,100.0
2812,75,72,230,302,1,100.0
2813,75,45,161,206,1,100.0
2814,75,51,236,287,1,100.0
2815,75,49,204,253,1,100.0
2816,75,39,110,149,1,100.0
2817,75,131,339,470,1,100.0
2818,75,37,75,112,1,100.0
2819,75,45,149,194,1,100.0
2820,75,39,53,92,1,100.0
2821,75,49,144,193,1,100.0
2822,75,13,34,47,1,100.0
2823,75,13,53,66,1,100.0
2824,75,77,75,152,1,100.0
2825,75,127,280,407,1,100.0
2826,75,37,69,106,1,100.0
2827,75,21,67,88,1,100.0
2828,75,49,67,116,1,100.0
2829,75,131,311,442,1,100.0
2830,75,104,189,293,1,100.0
2831,75,92,170,262,1,100.0
2832,75,66,60,126,1,100.0
2833,75,136,296,432,1,100.0
2834,75,19,109,128,1,100.0
2835,75,68,207,275,1,100.0
2836,75,86,208,294,1,100.0
2837,75,89,161,250,1,100.0
2838,75,49,139,188,1,100.0
2839,75,31,61,92,1,100.0
2840,75,98,187,285,1,100.0
2841,75,22,45,67,1,100.0
2842,75,30,81,111,1,100.0
2843,75,69,103,172,1,100.0
2844,75,58,63,121,1,100.0
2845,75,12,66,78,1,100.0
2846,75,140,432,572,1,100.0
2847,75,78,162,240,1,100.0
2848,75,56,122,178,1,100.0
2849,75,93,177,270,1,100.0
2850,75,103,129,232,1,100.0
2851,75,97,235,332,1,100.0
2852,75,67,86,153,1,100.0
2853,75,162,340,502,1,100.0
2854,75,79,130,209,1,100.0
2855,75,48,78,126,1,100.0
2856,75,48,198,246,1,100.0
2857,75,51,125,176,1,100.0
2858,75,32,76,108,1,100.0
2859,75,67,157,224,1,100.0
2860,75,50,121,171,1,100.0
2861,75,42,133,175,1,100.0
2862,75,83,145,228,1,100.0
2863,75,31,145,176,1,100.0
2864,75,38,131,169,1,100.0
2865,75,106,197,303,1,100.0
2866,75,24,81,105,1,100.0
2867,75,97,196,293,1,100.0
2868,75,52,150,202,1,100.0
2869,75,138,347,485,1,100.0
2870,75,85,127,212,1,100.0
2871,75,2,9,11,1,100.0
2872,75,46,139,185,1,100.0
2873,75,31,88,119,1,100.0
2874,75,6,32,38,1,100.0
2875,75,14,36,50,1,100.0
2876,75,142,329,471,1,100.0
2877,75,120,238,358,1,100.0
2878,75,16,64,80,1,100.0
2879,75,48,182,230,1,100.0
2880,75,72,222,294,1,100.0
2881,75,69,141,210,1,100.0
2882,75,97,212,309,1,100.0
2883,75,42,83,125,1,100.0
2884,75,172,395,567,1,100.0
2885,75,17,34,51,1,100.0
2886,75,117,215,332,1,100.0
2887,75,84,227,311,1,100.0
2888,75,128,315,443,1,100.0
2889,75,54,229,283,1,100.0
2890,75,106,216,322,1,100.0
2891,75,116,300,416,1,100.0
2892,75,39,87,126,1,100.0
2893,75,70,181,251,1,100.0
2894,75,54,124,178,1,100.0
2895,75,58,123,181,1,100.0
2896,75,45,76,121,1,100.0
2897,75,24,44,68,1,100.0
2898,75,32,150,182,1,100.0
2899,75,30,208,238,1,100.0
2900,75,58,140,198,1,100.0
2901,75,70,235,305,1,100.0
2902,75,42,253,295,1,100.0
2903,75,32,145,177,1,100.0
2904,75,63,254,317,1,100.0
2905,75,127,272,399,1,100.0
2906,75,31,95,126,1,100.0
2907,75,48,97,145,1,100.0
2908,75,21,59,80,1,100.0
2909,75,54,144,198,1,100.0
2910,75,72,185,257,1,100.0
2911,75,30,87,117,1,100.0
2912,75,27,109,136,1,100.0
2913,75,142,267,409,1,100.0
2914,75,109,190,299,1,100.0
2915,75,18,34,52,1,100.0
2916,75,44,199,243,1,100.0
2917,75,95,179,274,1,100.0
2918,75,7,53,60,1,100.0
2919,75,47,130,177,1,100.0
2920,75,125,264,389,1,100.0
2921,75,77,203,280,1,100.0
2922,75,45,95,140,1,100.0
2923,75,16,45,61,1,100.0
2924,75,92,243,335,1,100.0
2925,75,3,11,14,1,100.0
2926,75,102,228,330,1,100.0
2927,75,21,41,62,1,100.0
2928,75,47,176,223,1,100.0
2929,75,52,202,254,1,100.0
2930,75,24,140,164,1,100.0
2931,75,116,290,406,1,100.0
2932,75,27,59,86,1,100.0
2933,75,43,118,161,1,100.0
2934,75,66,119,185,1,100.0
2935,75,22,83,105,1,100.0
2936,75,89,219,308,1,100.0
2937,75,50,148,198,1,100.0
2938,75,16,88,104,1,100.0
2939,75,82,235,317,1,100.0
2940,75,80,147,227,1,100.0
2941,75,91,191,282,1,100.0
2942,75,25,74,99,1,100.0
2943,75,48,116,164,1,100.0
2944,75,16,39,55,1,100.0
2945,75,18,76,94,1,100.0
2946,75,33,72,105,1,100.0
2947,75,20,54,74,1,100.0
2948,75,25,74,99,1,1000.0
2949,75,161,316,477,1,1000.0
2950,75,176,225,401,1,1000.0
2951,75,133,380,513,1,1000.0
2952,75,140,318,458,1,1000.0
2953,75,155,310,465,1,1000.0
2954,75,70,214,284,1,1000.0
2955,75,104,218,322,1,1000.0
2956,75,71,167,238,1,1000.0
2957,75,99,275,374,1,1000.0
2958,75,246,506,752,1,1000.0
2959,75,50,194,244,1,1000.0
2960,75,41,171,212,1,1000.0
2961,75,44,130,174,1,1000.0
2962,75,43,113,156,1,1000.0
2963,75,7,27,34,1,1000.0
2964,75,66,197,263,1,1000.0
2965,75,101,208,309,1,1000.0
2966,75,139,196,335,1,1000.0
2967,75,82,380,462,1,1000.0
2968,75,103,159,262,1,1000.0
2969,75,63,172,235,1,1000.0
2970,75,93,213,306,1,1000.0
2971,75,302,718,1020,1,1000.0
2972,75,56,290,346,1,1000.0
2973,75,89,222,311,1,1000.0
2974,75,56,60,116,1,1000.0
2975,75,68,112,180,1,1000.0
2976,75,63,205,268,1,1000.0
2977,75,0,3,3,1,1000.0
2978,75,67,77,144,1,1000.0
2979,75,104,244,348,1,1000.0
2980,75,37,121,158,1,1000.0
2981,75,144,274,418,1,1000.0
2982,75,221,321,542,1,1000.0
2983,75,54,163,217,1,1000.0
2984,75,70,189,259,1,1000.0
2985,75,18,42,60,1,1000.0
2986,75,68,151,219,1,1000.0
2987,75,292,482,774,1,1000.0
2988,75,69,155,224,1,1000.0
2989,75,33,96,129,1,1000.0
2990,75,77,206,283,1,1000.0
2991,75,31,92,123,1,1000.0
2992,75,39,114,153,1,1000.0
2993,75,16,43,59,1,1000.0
2994,75,14,44,58,1,1000.0
2995,75,74,254,328,1,1000.0
2996,75,26,70,96,1,1000.0
2997,75,88,315,403,1,1000.0
2998,75,54,147,201,1,1000.0
2999,75,80,84,164,1,1000.0
3000,75,83,269,352,1,1000.0
3001,75,58,185,243,1,1000.0
3002,75,65,360,425,1,1000.0
3003,75,53,155,208,1,1000.0
3004,75,162,460,622,1,1000.0
3005,75,71,77,148,1,1000.0
3006,75,50,218,268,1,1000.0
3007,75,68,222,290,1,1000.0
3008,75,58,182,240,1,1000.0
3009,75,88,149,237,1,1000.0
3010,75,46,145,191,1,1000.0
3011,75,103,255,358,1,1000.0
3012,75,60,145,205,1,1000.0
3013,75,124,308,432,1,1000.0
3014,75,79,298,377,1,1000.0
3015,75,44,158,202,1,1000.0
3016,75,99,344,443,1,1000.0
3017,75,165,355,520,1,1000.0
3018,75,89,206,295,1,1000.0
3019,75,81,251,332,1,1000.0
3020,75,28,118,146,1,1000.0
3021,75,73,163,236,1,1000.0
3022,75,23,73,96,1,1000.0
3023,75,49,110,159,1,1000.0
3024,75,7,36,43,1,1000.0
3025,75,78,114,192,1,1000.0
3026,75,66,153,219,1,1000.0
3027,75,29,67,96,1,1000.0
3028,75,149,506,655,1,1000.0
3029,75,134,536,670,1,1000.0
3030,75,101,204,305,1,1000.0
3031,75,73,167,240,1,1000.0
3032,75,161,188,349,1,1000.0
3033,75,79,190,269,1,1000.0
3034,75,52,114,166,1,1000.0
3035,75,112,177,289,1,1000.0
3036,75,59,110,169,1,1000.0
3037,75,50,84,134,1,1000.0
3038,75,89,176,265,1,1000.0
3039,75,2,26,28,1,1000.0
3040,75,25,144,169,1,1000.0
3041,75,116,184,300,1,1000.0
3042,75,97,348,445,1,1000.0
3043,75,96,277,373,1,1000.0
3044,75,139,464,603,1,1000.0
3045,75,63,253,316,1,1000.0
3046,75,93,236,329,1,1000.0
3047,75,64,220,284,1,1000.0
3048,75,28,160,188,1,1000.0
3049,75,56,183,239,1,1000.0
3050,75,41,155,196,1,1000.0
3051,75,51,110,161,1,1000.0
3052,75,48,127,175,1,1000.0
3053,75,33,82,115,1,1000.0
3054,75,6,104,110,1,1000.0
3055,75,71,234,305,1,1000.0
3056,75,51,143,194,1,1000.0
3057,75,130,211,341,1,1000.0
3058,75,33,91,124,1,1000.0
3059,75,125,332,457,1,1000.0
3060,75,109,407,516,1,1000.0
3061,75,94,299,393,1,1000.0
3062,75,66,136,202,1,1000.0
3063,75,78,213,291,1,1000.0
3064,75,59,123,182,1,1000.0
3065,75,98,241,339,1,1000.0
3066,75,13,17,30,1,1000.0
3067,75,57,113,170,1,1000.0
3068,75,59,189,248,1,1000.0
3069,75,87,272,359,1,1000.0
3070,75,82,184,266,1,1000.0
3071,75,265,552,817,1,1000.0
3072,75,117,181,298,1,1000.0
3073,75,94,207,301,1,1000.0
3074,75,71,135,206,1,1000.0
3075,75,143,284,427,1,1000.0
3076,75,92,206,298,1,1000.0
3077,75,109,222,331,1,1000.0
3078,75,22,69,91,1,1000.0
3079,75,83,190,273,1,1000.0
3080,75,68,73,141,1,1000.0
3081,75,13,68,81,1,1000.0
3082,75,37,81,118,1,1000.0
3083,75,71,117,188,1,1000.0
3084,75,82,226,308,1,1000.0
3085,75,156,404,560,1,1000.0
3086,75,27,154,181,1,1000.0
3087,75,94,272,366,1,1000.0
3088,75,100,253,353,1,1000.0
3089,75,63,153,216,1,1000.0
3090,75,70,157,227,1,1000.0
3091,75,67,268,335,1,1000.0
3092,75,163,500,663,1,1000.0
3093,75,32,56,88,1,1000.0
3094,75,107,355,462,1,1000.0
3095,75,100,156,256,1,1000.0
3096,75,40,84,124,1,1000.0
3097,75,120,210,330,1,1000.0
3098,75,36,61,97,1,1000.0
3099,75,71,215,286,1,1000.0
3100,75,128,212,340,1,1000.0
3101,75,105,199,304,1,1000.0
3102,75,79,173,252,1,1000.0
3103,75,104,241,345,1,1000.0
3104,75,51,73,124,1,1000.0
3105,75,136,258,394,1,1000.0
3106,75,9,33,42,1,1000.0
3107,75,45,109,154,1,1000.0
3108,75,118,119,237,1,1000.0
3109,75,77,225,302,1,1000.0
3110,75,57,152,209,1,1000.0
3111,75,115,317,432,1,1000.0
3112,75,85,133,218,1,1000.0
3113,75,81,351,432,1,1000.0
3114,75,85,289,374,1,1000.0
3115,75,55,174,229,1,1000.0
3116,75,198,465,663,1,1000.0
3117,75,45,157,202,1,1000.0
3118,75,81,287,368,1,1000.0
3119,75,25,67,92,1,1000.0
3120,75,26,124,150,1,1000.0
3121,75,46,126,172,1,1000.0
3122,75,5,32,37,1,1000.0
3123,75,105,78,183,1,1000.0
3124,75,77,190,267,1,1000.0
3125,75,78,205,283,1,1000.0
3126,75,50,221,271,1,1000.0
3127,75,86,244,330,1,1000.0
3128,75,45,89,134,1,1000.0
3129,75,68,58,126,1,1000.0
3130,75,79,99,178,1,1000.0
3131,75,22,167,189,1,1000.0
3132,75,107,192,299,1,1000.0
3133,75,34,119,153,1,1000.0
3134,75,28,78,106,1,1000.0
3135,75,15,10,25,1,1000.0
3136,75,88,151,239,1,1000.0
3137,75,41,77,118,1,1000.0
3138,75,24,48,72,1,1000.0
3139,75,31,85,116,1,1000.0
3140,75,23,102,125,1,1000.0
3141,75,81,275,356,1,1000.0
3142,75,13,44,57,1,1000.0
3143,75,36,116,152,1,1000.0
3144,75,50,101,151,1,1000.0
3145,75,105,266,371,1,1000.0
3146,75,236,470,706,1,1000.0
3147,75,176,456,632,1,1000.0
3148,75,92,237,329,1,1000.0
3149,75,35,67,102,1,1000.0
3150,75,38,131,169,1,1000.0
3151,75,25,111,136,1,1000.0
3152,75,21,68,89,1,1000.0
3153,75,13,41,54,1,1000.0
3154,75,130,130,260,1,1000.0
3155,75,84,126,210,1,1000.0
3156,75,83,125,208,1,1000.0
3157,75,91,133,224,1,1000.0
3158,75,79,147,226,1,1000.0
3159,75,128,274,402,1,1000.0
3160,75,66,224,290,1,1000.0
3161,75,65,121,186,1,1000.0
3162,75,124,451,575,1,1000.0
3163,75,88,232,320,1,1000.0
3164,75,91,202,293,1,1000.0
3165,75,51,129,180,1,1000.0
3166,75,41,101,142,1,1000.0
3167,75,26,50,76,1,1000.0
3168,75,15,69,84,1,1000.0
3169,75,22,112,134,1,1000.0
3170,75,49,94,143,1,1000.0
3171,75,25,42,67,1,1000.0
3172,75,36,243,279,1,1000.0
3173,75,78,244,322,1,1000.0
3174,75,66,169,235,1,1000.0
3175,75,115,221,336,1,1000.0
3176,75,35,68,103,1,1000.0
3177,75,92,315,407,1,1000.0
3178,75,70,256,326,1,1000.0
3179,75,34,170,204,1,1000.0
3180,75,53,100,153,1,1000.0
3181,75,27,156,183,1,1000.0
3182,75,57,154,211,1,1000.0
3183,75,44,183,227,1,1000.0
3184,75,20,63,83,1,1000.0
3185,75,67,264,331,1,1000.0
3186,75,65,149,214,1,1000.0
3187,75,78,160,238,1,1000.0
3188,75,65,334,399,1,1000.0
3189,75,50,216,266,1,1000.0
3190,75,62,151,213,1,1000.0
3191,75,30,128,158,1,1000.0
3192,75,47,229,276,1,1000.0
3193,75,39,109,148,1,1000.0
3194,75,83,164,247,1,1000.0
3195,75,5,18,23,1,1000.0
3196,75,23,128,151,1,1000.0
3197,75,44,81,125,1,1000.0
3198,75,39,87,126,1,1000.0
3199,75,50,98,148,1,1000.0
3200,75,49,93,142,1,1000.0
3201,75,77,171,248,1,1000.0
3202,75,28,123,151,1,1000.0
3203,75,37,212,249,1,1000.0
3204,75,56,147,203,1,1000.0
3205,75,89,290,379,1,1000.0
3206,75,150,294,444,1,1000.0
3207,75,305,526,831,1,1000.0
3208,75,64,143,207,1,1000.0
3209,75,34,163,197,1,1000.0
3210,75,51,193,244,1,1000.0
3211,75,33,54,87,1,1000.0
3212,75,74,148,222,1,1000.0
3213,75,2,10,12,1,1000.0
3214,75,103,204,307,1,1000.0
3215,75,58,79,137,1,1000.0
3216,75,69,118,187,1,1000.0
3217,75,62,266,328,1,1000.0
3218,75,65,150,215,1,1000.0
3219,75,92,243,335,1,1000.0
3220,75,45,100,145,1,1000.0
3221,75,45,225,270,1,1000.0
3222,75,75,171,246,1,1000.0
3223,75,46,114,160,1,1000.0
3224,75,45,261,306,1,1000.0
3225,75,119,302,421,1,1000.0
3226,75,106,104,210,1,1000.0
3227,75,50,141,191,1,1000.0
3228,75,10,52,62,1,1000.0
3229,75,95,149,244,1,1000.0
3230,75,15,31,46,1,1000.0
3231,75,41,69,110,1,1000.0
3232,75,2,20,22,1,1000.0
3233,75,3,27,30,1,1000.0
3234,75,9,33,42,1,1000.0
3235,75,78,131,209,1,1000.0
3236,75,31,59,90,1,1000.0
3237,75,95,156,251,1,1000.0
3238,75,51,69,120,1,1000.0
3239,75,121,285,406,1,1000.0
3240,75,53,141,194,1,1000.0
3241,75,23,35,58,1,1000.0
3242,75,155,350,505,1,1000.0
3243,75,78,267,345,1,1000.0
3244,75,45,126,171,1,1000.0
3245,75,83,205,288,1,1000.0
3246,75,27,91,118,1,1000.0
3247,75,75,234,309,1,1000.0
3248,75,60,129,189,1,1000.0
3249,75,89,92,181,1,1000.0
3250,75,28,112,140,1,1000.0
3251,75,51,53,104,1,1000.0
3252,75,51,147,198,1,1000.0
3253,75,56,168,224,1,1000.0
3254,75,97,229,326,1,1000.0
3255,75,93,240,333,1,1000.0
3256,75,41,139,180,1,1000.0
3257,75,135,301,436,1,1000.0
3258,75,41,119,160,1,1000.0
3259,75,14,58,72,1,1000.0
3260,75,76,155,231,1,1000.0
3261,75,43,96,139,1,1000.0
3262,75,54,111,165,1,1000.0
3263,75,27,64,91,1,1000.0
3264,75,59,145,204,1,1000.0
3265,75,39,55,94,1,1000.0
3266,75,30,92,122,1,1000.0
3267,75,41,100,141,1,1000.0
3268,75,60,109,169,1,1000.0
3269,75,138,412,550,1,1000.0
3270,75,95,185,280,1,1000.0
3271,75,25,110,135,1,1000.0
3272,75,68,170,238,1,1000.0
3273,75,20,20,40,1,1000.0
3274,75,41,97,138,1,1000.0
3275,75,84,68,152,1,1000.0
3276,75,84,159,243,1,1000.0
3277,75,71,125,196,1,1000.0
3278,75,30,127,157,1,1000.0
3279,75,13,40,53,1,1000.0
3280,75,26,74,100,1,1000.0
3281,75,62,151,213,1,1000.0
3282,75,15,14,29,1,1000.0
3283,75,139,321,460,1,1000.0
3284,75,20,30,50,1,1000.0
3285,75,4,18,22,1,1000.0
3286,75,54,152,206,1,1000.0
3287,75,61,138,199,1,1000.0
3288,75,102,188,290,1,1000.0
3289,75,45,121,166,1,1000.0
3290,75,28,70,98,1,1000.0
3291,75,49,123,172,1,1000.0
3292,75,26,92,118,1,1000.0
3293,75,71,144,215,1,1000.0
3294,75,58,119,177,1,1000.0
3295,75,42,111,153,1,1000.0
3296,75,39,142,181,1,1000.0
3297,75,68,40,108,1,1000.0
3298,75,63,84,147,1,1000.0
3299,75,113,156,269,1,1000.0
3300,75,24,52,76,1,1000.0
3301,75,25,22,47,1,1000.0
3302,75,52,96,148,1,1000.0
3303,75,43,158,201,1,1000.0
3304,75,100,229,329,1,1000.0
3305,75,9,19,28,1,1000.0
3306,75,58,212,270,1,1000.0
3307,75,54,101,155,1,1000.0
3308,75,41,126,167,1,1000.0
3309,75,81,261,342,1,1000.0
3310,75,85,106,191,1,1000.0
3311,75,103,241,344,1,1000.0
3312,75,63,118,181,1,1000.0
3313,75,4,19,23,1,1000.0
3314,75,35,88,123,1,1000.0
3315,75,22,64,86,1,1000.0
3316,75,19,17,36,1,1000.0
3317,75,6,8,14,1,1000.0
3318,75,105,275,380,1,1000.0
3319,75,127,244,371,1,1000.0
3320,75,165,195,360,1,1000.0
3321,75,68,206,274,1,1000.0
3322,75,109,248,357,1,1000.0
3323,75,117,329,446,1,1000.0
3324,75,21,45,66,1,1000.0
3325,75,17,72,89,1,1000.0
3326,75,48,222,270,1,1000.0
3327,75,134,255,389,1,1000.0
3328,75,58,150,208,1,1000.0
3329,75,32,57,89,1,1000.0
3330,75,25,47,72,1,1000.0
3331,75,13,24,37,1,1000.0
3332,75,270,222,492,1,1000.0
3333,75,23,39,62,1,1000.0
3334,75,175,446,621,1,1000.0
3335,75,228,442,670,1,1000.0
3336,75,95,338,433,1,1000.0
3337,75,95,283,378,1,1000.0
3338,75,94,214,308,1,1000.0
3339,75,36,70,106,1,1000.0
3340,75,46,66,112,1,1000.0
3341,75,19,79,98,1,1000.0
3342,75,61,158,219,1,1000.0
3343,75,44,178,222,1,1000.0
3344,75,38,63,101,1,1000.0
3345,75,60,211,271,1,1000.0
3346,75,40,130,170,1,1000.0
3347,75,64,290,354,1,1000.0
3348,75,49,181,230,1,1000.0
3349,75,66,283,349,1,1000.0
3350,75,205,455,660,1,1000.0
3351,75,131,201,332,1,1000.0
3352,75,154,356,510,1,1000.0
3353,75,100,156,256,1,1000.0
3354,75,27,111,138,1,1000.0
3355,75,60,94,154,1,1000.0
3356,75,35,64,99,1,1000.0
3357,75,95,268,363,1,1000.0
3358,75,105,252,357,1,1000.0
3359,75,34,84,118,1,1000.0
3360,75,73,252,325,1,1000.0
3361,75,79,235,314,1,1000.0
3362,75,46,95,141,1,1000.0
3363,75,56,134,190,1,1000.0
3364,75,70,259,329,1,1000.0
3365,75,65,161,226,1,1000.0
3366,75,63,60,123,1,1000.0
3367,75,49,61,110,1,1000.0
3368,75,22,37,59,1,1000.0
3369,75,22,23,45,1,1000.0
3370,75,70,108,178,1,1000.0
3371,75,65,93,158,1,1000.0
3372,75,86,291,377,1,1000.0
3373,75,119,163,282,1,1000.0
3374,75,99,268,367,1,1000.0
3375,75,238,511,749,1,1000.0
3376,75,197,342,539,1,1000.0
3377,75,58,127,185,1,1000.0
3378,75,186,537,723,1,1000.0
3379,75,96,211,307,1,1000.0
3380,75,128,131,259,1,1000.0
3381,75,69,73,142,1,1000.0
3382,75,126,320,446,1,1000.0
3383,75,15,58,73,1,1000.0
3384,75,84,204,288,1,1000.0
3385,75,57,198,255,1,1000.0
3386,75,30,21,51,1,1000.0
3387,75,62,136,198,1,1000.0
3388,75,150,225,375,1,1000.0
3389,75,103,336,439,1,1000.0
3390,75,75,260,335,1,1000.0
3391,75,92,263,355,1,1000.0
3392,75,79,275,354,1,1000.0
3393,75,220,350,570,1,1000.0
3394,75,24,93,117,1,1000.0
3395,75,57,134,191,1,1000.0
3396,75,117,222,339,1,1000.0
3397,75,95,215,310,1,1000.0
3398,75,27,54,81,1,1000.0
3399,75,11,47,58,1,1000.0
3400,75,53,21,74,1,1000.0
3401,75,22,37,59,1,1000.0
3402,75,131,216,347,1,10000.0
3403,75,22,143,165,1,10000.0
3404,75,40,163,203,1,10000.0
3405,75,41,173,214,1,10000.0
3406,75,73,215,288,1,10000.0
3407,75,180,577,757,1,10000.0
3408,75,138,367,505,1,10000.0
3409,75,170,370,540,1,10000.0
3410,75,115,132,247,1,10000.0
3411,75,112,194,306,1,10000.0
3412,75,147,407,554,1,10000.0
3413,75,92,139,231,1,10000.0
3414,75,62,116,178,1,10000.0
3415,75,39,94,133,1,10000.0
3416,75,16,35,51,1,10000.0
3417,75,25,84,109,1,10000.0
3418,75,64,204,268,1,10000.0
3419,75,63,140,203,1,10000.0
3420,75,76,210,286,1,10000.0
3421,75,108,445,553,1,10000.0
3422,75,61,117,178,1,10000.0
3423,75,105,99,204,1,10000.0
3424,75,89,323,412,1,10000.0
3425,75,160,160,320,1,10000.0
3426,75,220,470,690,1,10000.0
3427,75,135,250,385,1,10000.0
3428,75,100,234,334,1,10000.0
3429,75,52,168,220,1,10000.0
3430,75,143,350,493,1,10000.0
3431,75,98,227,325,1,10000.0
3432,75,91,157,248,1,10000.0
3433,75,149,272,421,1,10000.0
3434,75,27,46,73,1,10000.0
3435,75,42,169,211,1,10000.0
3436,75,213,423,636,1,10000.0
3437,75,82,222,304,1,10000.0
3438,75,121,290,411,1,10000.0
3439,75,51,169,220,1,10000.0
3440,75,102,238,340,1,10000.0
3441,75,42,168,210,1,10000.0
3442,75,23,79,102,1,10000.0
3443,75,44,147,191,1,10000.0
3444,75,157,313,470,1,10000.0
3445,75,83,211,294,1,10000.0
3446,75,86,175,261,1,10000.0
3447,75,13,63,76,1,10000.0
3448,75,38,44,82,1,10000.0
3449,75,79,192,271,1,10000.0
3450,75,91,257,348,1,10000.0
3451,75,69,238,307,1,10000.0
3452,75,102,237,339,1,10000.0
3453,75,54,122,176,1,10000.0
3454,75,71,152,223,1,10000.0
3455,75,73,211,284,1,10000.0
3456,75,56,131,187,1,10000.0
3457,75,11,14,25,1,10000.0
3458,75,12,38,50,1,10000.0
3459,75,44,215,259,1,10000.0
3460,75,54,179,233,1,10000.0
3461,75,96,277,373,1,10000.0
3462,75,48,175,223,1,10000.0
3463,75,108,268,376,1,10000.0
3464,75,15,108,123,1,10000.0
3465,75,47,127,174,1,10000.0
3466,75,68,216,284,1,10000.0
3467,75,29,41,70,1,10000.0
3468,75,53,231,284,1,10000.0
3469,75,41,78,119,1,10000.0
3470,75,56,215,271,1,10000.0
3471,75,13,43,56,1,10000.0
3472,75,40,126,166,1,10000.0
3473,75,135,339,474,1,10000.0
3474,75,49,214,263,1,10000.0
3475,75,66,186,252,1,10000.0
3476,75,99,185,284,1,10000.0
3477,75,204,296,500,1,10000.0
3478,75,104,263,367,1,10000.0
3479,75,59,184,243,1,10000.0
3480,75,56,165,221,1,10000.0
3481,75,53,60,113,1,10000.0
3482,75,84,300,384,1,10000.0
3483,75,30,72,102,1,10000.0
3484,75,164,226,390,1,10000.0
3485,75,173,254,427,1,10000.0
3486,75,77,173,250,1,10000.0
3487,75,95,155,250,1,10000.0
3488,75,104,223,327,1,10000.0
3489,75,114,300,414,1,10000.0
3490,75,149,307,456,1,10000.0
3491,75,136,318,454,1,10000.0
3492,75,54,85,139,1,10000.0
3493,75,123,274,397,1,10000.0
3494,75,168,460,628,1,10000.0
3495,75,42,78,120,1,10000.0
3496,75,63,148,211,1,10000.0
3497,75,94,251,345,1,10000.0
3498,75,51,142,193,1,10000.0
3499,75,90,245,335,1,10000.0
3500,75,90,202,292,1,10000.0
3501,75,44,125,169,1,10000.0
3502,75,32,100,132,1,10000.0
3503,75,69,172,241,1,10000.0
3504,75,92,208,300,1,10000.0
3505,75,97,218,315,1,10000.0
3506,75,64,152,216,1,10000.0
3507,75,54,148,202,1,10000.0
3508,75,93,380,473,1,10000.0
3509,75,19,73,92,1,10000.0
3510,75,122,281,403,1,10000.0
3511,75,18,121,139,1,10000.0
3512,75,113,336,449,1,10000.0
3513,75,105,186,291,1,10000.0
3514,75,81,208,289,1,10000.0
3515,75,46,106,152,1,10000.0
3516,75,69,310,379,1,10000.0
3517,75,20,36,56,1,10000.0
3518,75,60,83,143,1,10000.0
3519,75,56,49,105,1,10000.0
3520,75,57,141,198,1,10000.0
3521,75,134,323,457,1,10000.0
3522,75,113,254,367,1,10000.0
3523,75,97,216,313,1,10000.0
3524,75,81,238,319,1,10000.0
3525,75,194,506,700,1,10000.0
3526,75,203,429,632,1,10000.0
3527,75,101,106,207,1,10000.0
3528,75,117,249,366,1,10000.0
3529,75,93,216,309,1,10000.0
3530,75,151,160,311,1,10000.0
3531,75,116,243,359,1,10000.0
3532,75,51,141,192,1,10000.0
3533,75,62,168,230,1,10000.0
3534,75,99,87,186,1,10000.0
3535,75,44,75,119,1,10000.0
3536,75,111,233,344,1,10000.0
3537,75,99,198,297,1,10000.0
3538,75,65,250,315,1,10000.0
3539,75,57,218,275,1,10000.0
3540,75,41,114,155,1,10000.0
3541,75,94,250,344,1,10000.0
3542,75,32,61,93,1,10000.0
3543,75,82,188,270,1,10000.0
3544,75,44,105,149,1,10000.0
3545,75,73,107,180,1,10000.0
3546,75,60,181,241,1,10000.0
3547,75,76,118,194,1,10000.0
3548,75,15,64,79,1,10000.0
3549,75,77,126,203,1,10000.0
3550,75,39,61,100,1,10000.0
3551,75,14,36,50,1,10000.0
3552,75,48,92,140,1,10000.0
3553,75,99,184,283,1,10000.0
3554,75,44,151,195,1,10000.0
3555,75,49,111,160,1,10000.0
3556,75,62,138,200,1,10000.0
3557,75,66,153,219,1,10000.0
3558,75,51,190,241,1,10000.0
3559,75,17,81,98,1,10000.0
3560,75,110,192,302,1,10000.0
3561,75,31,124,155,1,10000.0
3562,75,65,187,252,1,10000.0
3563,75,9,32,41,1,10000.0
3564,75,30,88,118,1,10000.0
3565,75,29,58,87,1,10000.0
3566,75,15,39,54,1,10000.0
3567,75,10,15,25,1,10000.0
3568,75,13,84,97,1,10000.0
3569,75,31,77,108,1,10000.0
3570,75,77,213,290,1,10000.0
3571,75,81,241,322,1,10000.0
3572,75,24,75,99,1,10000.0
3573,75,74,156,230,1,10000.0
3574,75,78,175,253,1,10000.0
3575,75,74,188,262,1,10000.0
3576,75,50,179,229,1,10000.0
3577,75,76,159,235,1,10000.0
3578,75,67,123,190,1,10000.0
3579,75,151,223,374,1,10000.0
3580,75,63,132,195,1,10000.0
3581,75,86,170,256,1,10000.0
3582,75,21,33,54,1,10000.0
3583,75,8,30,38,1,10000.0
3584,75,38,152,190,1,10000.0
3585,75,102,241,343,1,10000.0
3586,75,49,155,204,1,10000.0
3587,75,47,195,242,1,10000.0
3588,75,88,234,322,1,10000.0
3589,75,67,200,267,1,10000.0
3590,75,77,177,254,1,10000.0
3591,75,113,152,265,1,10000.0
3592,75,44,32,76,1,10000.0
3593,75,89,219,308,1,10000.0
3594,75,8,32,40,1,10000.0
3595,75,55,75,130,1,10000.0
3596,75,50,92,142,1,10000.0
3597,75,42,71,113,1,10000.0
3598,75,109,388,497,1,10000.0
3599,75,37,75,112,1,10000.0
3600,75,45,149,194,1,10000.0
3601,75,43,199,242,1,10000.0
3602,75,43,67,110,1,10000.0
3603,75,99,280,379,1,10000.0
3604,75,69,261,330,1,10000.0
3605,75,61,181,242,1,10000.0
3606,75,52,139,191,1,10000.0
3607,75,84,88,172,1,10000.0
3608,75,62,159,221,1,10000.0
3609,75,49,107,156,1,10000.0
3610,75,39,93,132,1,10000.0
3611,75,145,157,302,1,10000.0
3612,75,41,89,130,1,10000.0
3613,75,131,288,419,1,10000.0
3614,75,70,133,203,1,10000.0
3615,75,15,49,64,1,10000.0
3616,75,164,337,501,1,10000.0
3617,75,103,136,239,1,10000.0
3618,75,97,243,340,1,10000.0
3619,75,68,212,280,1,10000.0
3620,75,96,220,316,1,10000.0
3621,75,51,154,205,1,10000.0
3622,75,66,84,150,1,10000.0
3623,75,29,82,111,1,10000.0
3624,75,33,106,139,1,10000.0
3625,75,167,497,664,1,10000.0
3626,75,147,190,337,1,10000.0
3627,75,212,402,614,1,10000.0
3628,75,95,173,268,1,10000.0
3629,75,71,205,276,1,10000.0
3630,75,167,402,569,1,10000.0
3631,75,91,235,326,1,10000.0
3632,75,87,178,265,1,10000.0
3633,75,69,199,268,1,10000.0
3634,75,141,297,438,1,10000.0
3635,75,59,61,120,1,10000.0
3636,75,42,114,156,1,10000.0
3637,75,21,24,45,1,10000.0
3638,75,96,151,247,1,10000.0
3639,75,77,157,234,1,10000.0
3640,75,87,158,245,1,10000.0
3641,75,77,253,330,1,10000.0
3642,75,91,227,318,1,10000.0
3643,75,78,178,256,1,10000.0
3644,75,67,224,291,1,10000.0
3645,75,67,152,219,1,10000.0
3646,75,83,218,301,1,10000.0
3647,75,31,128,159,1,10000.0
3648,75,9,84,93,1,10000.0
3649,75,53,96,149,1,10000.0
3650,75,16,41,57,1,10000.0
3651,75,4,16,20,1,10000.0
3652,75,21,21,42,1,10000.0
3653,75,24,152,176,1,10000.0
3654,75,75,209,284,1,10000.0
3655,75,38,281,319,1,10000.0
3656,75,114,142,256,1,10000.0
3657,75,120,262,382,1,10000.0
3658,75,88,203,291,1,10000.0
3659,75,149,343,492,1,10000.0
3660,75,29,108,137,1,10000.0
3661,75,70,261,331,1,10000.0
3662,75,64,119,183,1,10000.0
3663,75,20,100,120,1,10000.0
3664,75,29,85,114,1,10000.0
3665,75,58,164,222,1,10000.0
3666,75,50,86,136,1,10000.0
3667,75,48,99,147,1,10000.0
3668,75,32,96,128,1,10000.0
3669,75,12,23,35,1,10000.0
3670,75,4,20,24,1,10000.0
3671,75,88,186,274,1,10000.0
3672,75,60,190,250,1,10000.0
3673,75,89,291,380,1,10000.0
3674,75,98,265,363,1,10000.0
3675,75,80,175,255,1,10000.0
3676,75,75,144,219,1,10000.0
3677,75,90,149,239,1,10000.0
3678,75,19,41,60,1,10000.0
3679,75,57,83,140,1,10000.0
3680,75,119,234,353,1,10000.0
3681,75,52,115,167,1,10000.0
3682,75,81,142,223,1,10000.0
3683,75,28,94,122,1,10000.0
3684,75,72,174,246,1,10000.0
3685,75,39,84,123,1,10000.0
3686,75,55,136,191,1,10000.0
3687,75,81,148,229,1,10000.0
3688,75,96,177,273,1,10000.0
3689,75,166,460,626,1,10000.0
3690,75,98,172,270,1,10000.0
3691,75,56,168,224,1,10000.0
3692,75,35,141,176,1,10000.0
3693,75,81,235,316,1,10000.0
3694,75,72,213,285,1,10000.0
3695,75,29,96,125,1,10000.0
3696,75,125,133,258,1,10000.0
3697,75,82,197,279,1,10000.0
3698,75,37,142,179,1,10000.0
3699,75,30,82,112,1,10000.0
3700,75,21,63,84,1,10000.0
3701,75,62,181,243,1,10000.0
3702,75,36,180,216,1,10000.0
3703,75,19,52,71,1,10000.0
3704,75,187,534,721,1,10000.0
3705,75,55,245,300,1,10000.0
3706,75,47,247,294,1,10000.0
3707,75,188,533,721,1,10000.0
3708,75,141,210,351,1,10000.0
3709,75,22,88,110,1,10000.0
3710,75,49,116,165,1,10000.0
3711,75,86,230,316,1,10000.0
3712,75,17,84,101,1,10000.0
3713,75,53,159,212,1,10000.0
3714,75,61,179,240,1,10000.0
3715,75,44,150,194,1,10000.0
3716,75,59,191,250,1,10000.0
3717,75,54,252,306,1,10000.0
3718,75,61,92,153,1,10000.0
3719,75,134,295,429,1,10000.0
3720,75,36,80,116,1,10000.0
3721,75,145,355,500,1,10000.0
3722,75,21,67,88,1,10000.0
3723,75,99,195,294,1,10000.0
3724,75,80,187,267,1,10000.0
3725,75,59,168,227,1,10000.0
3726,75,18,29,47,1,10000.0
3727,75,29,253,282,1,10000.0
3728,75,140,327,467,1,10000.0
3729,75,101,250,351,1,10000.0
3730,75,83,122,205,1,10000.0
3731,75,76,222,298,1,10000.0
3732,75,52,140,192,1,10000.0
3733,75,123,222,345,1,10000.0
3734,75,86,216,302,1,10000.0
3735,75,65,158,223,1,10000.0
3736,75,51,82,133,1,10000.0
3737,75,78,155,233,1,10000.0
3738,75,94,310,404,1,10000.0
3739,75,37,139,176,1,10000.0
3740,75,90,159,249,1,10000.0
3741,75,92,246,338,1,10000.0
3742,75,48,165,213,1,10000.0
3743,75,113,385,498,1,10000.0
3744,75,57,280,337,1,10000.0
3745,75,90,139,229,1,10000.0
3746,75,69,153,222,1,10000.0
3747,75,19,216,235,1,10000.0
3748,75,58,144,202,1,10000.0
3749,75,44,109,153,1,10000.0
3750,75,62,154,216,1,10000.0
3751,75,32,131,163,1,10000.0
3752,75,19,13,32,1,10000.0
3753,75,23,57,80,1,10000.0
3754,75,116,248,364,1,10000.0
3755,75,30,67,97,1,10000.0
3756,75,79,145,224,1,10000.0
3757,75,53,235,288,1,10000.0
3758,75,56,249,305,1,10000.0
3759,75,58,169,227,1,10000.0
3760,75,86,159,245,1,10000.0
3761,75,79,213,292,1,10000.0
3762,75,61,84,145,1,10000.0
3763,75,88,199,287,1,10000.0
3764,75,23,49,72,1,10000.0
3765,75,2,22,24,1,10000.0
3766,75,56,173,229,1,10000.0
3767,75,40,177,217,1,10000.0
3768,75,42,102,144,1,10000.0
3769,75,49,187,236,1,10000.0
3770,75,34,196,230,1,10000.0
3771,75,52,208,260,1,10000.0
3772,75,51,108,159,1,10000.0
3773,75,140,200,340,1,10000.0
3774,75,142,87,229,1,10000.0
3775,75,51,104,155,1,10000.0
3776,75,21,33,54,1,10000.0
3777,75,6,82,88,1,10000.0
3778,75,52,145,197,1,10000.0
3779,75,34,101,135,1,10000.0
3780,75,106,317,423,1,10000.0
3781,75,35,91,126,1,10000.0
3782,75,83,211,294,1,10000.0
3783,75,85,159,244,1,10000.0
3784,75,48,194,242,1,10000.0
3785,75,50,139,189,1,10000.0
3786,75,120,256,376,1,10000.0
3787,75,57,135,192,1,10000.0
3788,75,8,24,32,1,10000.0
3789,75,97,234,331,1,10000.0
3790,75,140,310,450,1,10000.0
3791,75,17,47,64,1,10000.0
3792,75,73,186,259,1,10000.0
3793,75,122,218,340,1,10000.0
3794,75,55,176,231,1,10000.0
3795,75,91,123,214,1,10000.0
3796,75,90,252,342,1,10000.0
3797,75,267,395,662,1,10000.0
3798,75,49,131,180,1,10000.0
3799,75,60,219,279,1,10000.0
3800,75,194,438,632,1,10000.0
3801,75,40,84,124,1,10000.0
3802,75,61,163,224,1,10000.0
3803,75,65,89,154,1,10000.0
3804,75,24,43,67,1,10000.0
3805,75,41,162,203,1,10000.0
3806,75,22,63,85,1,10000.0
3807,75,91,105,196,1,10000.0
3808,75,90,206,296,1,10000.0
3809,75,80,214,294,1,10000.0
3810,75,141,332,473,1,10000.0
3811,75,115,184,299,1,10000.0
3812,75,174,185,359,1,10000.0
3813,75,156,329,485,1,10000.0
3814,75,41,80,121,1,10000.0
3815,75,54,100,154,1,10000.0
3816,75,52,103,155,1,10000.0
3817,75,45,118,163,1,10000.0
3818,75,141,288,429,1,10000.0
3819,75,98,159,257,1,10000.0
3820,75,20,88,108,1,10000.0
3821,75,82,186,268,1,10000.0
3822,75,40,133,173,1,10000.0
3823,75,76,213,289,1,10000.0
3824,75,31,162,193,1,10000.0
3825,75,116,215,331,1,10000.0
3826,75,63,240,303,1,10000.0
3827,75,54,82,136,1,10000.0
3828,75,117,299,416,1,10000.0
3829,75,46,162,208,1,10000.0
3830,75,44,89,133,1,10000.0
3831,75,59,138,197,1,10000.0
3832,75,6,13,19,1,10000.0
0,0,30,103,133,2,0.0
1,0,29,153,182,2,0.0
2,0,15,115,130,2,0.0
3,0,14,89,103,2,0.0
4,0,32,76,108,2,0.0
5,0,7,6,13,2,0.0
6,0,20,119,139,2,0.0
7,0,14,29,43,2,0.0
8,0,6,20,26,2,0.0
9,0,27,44,71,2,0.0
10,0,37,49,86,2,0.0
11,0,10,33,43,2,0.0
12,0,37,78,115,2,0.0
13,0,57,123,180,2,0.0
14,0,30,94,124,2,0.0
15,0,16,30,46,2,0.0
16,0,17,95,112,2,0.0
17,0,39,161,200,2,0.0
18,0,15,28,43,2,0.0
19,0,6,49,55,2,0.0
20,0,23,44,67,2,0.0
21,0,12,23,35,2,0.0
22,0,24,49,73,2,0.0
23,0,33,127,160,2,0.0
24,0,6,12,18,2,0.0
25,0,1,4,5,2,0.0
26,0,12,10,22,2,0.0
27,0,9,12,21,2,0.0
28,0,0,0,0,2,0.0
29,0,9,16,25,2,0.0
30,0,31,99,130,2,0.0
31,0,24,70,94,2,0.0
32,0,35,87,122,2,0.0
33,0,15,95,110,2,0.0
34,0,13,12,25,2,0.0
35,0,21,64,85,2,0.0
36,0,25,53,78,2,0.0
37,0,24,154,178,2,0.0
38,0,16,29,45,2,0.0
39,0,5,25,30,2,0.0
40,0,10,30,40,2,0.0
41,0,2,11,13,2,0.0
42,0,1,4,5,2,0.0
43,0,8,25,33,2,0.0
44,0,18,61,79,2,0.0
45,0,30,77,107,2,0.0
46,0,24,115,139,2,0.0
47,0,19,31,50,2,0.0
48,0,40,110,150,2,0.0
49,0,37,168,205,2,0.0
50,0,44,94,138,2,0.0
51,0,4,5,9,2,0.0
52,0,16,65,81,2,0.0
53,0,10,47,57,2,0.0
54,0,16,52,68,2,0.0
55,0,5,9,14,2,0.0
56,0,12,36,48,2,0.0
57,0,22,35,57,2,0.0
58,0,17,57,74,2,0.0
59,0,17,79,96,2,0.0
60,0,19,92,111,2,0.0
61,0,19,71,90,2,0.0
62,0,34,148,182,2,0.0
63,0,22,111,133,2,0.0
64,0,11,26,37,2,0.0
65,0,9,80,89,2,0.0
66,0,7,31,38,2,0.0
67,0,20,75,95,2,0.0
68,0,11,26,37,2,0.0
69,0,26,55,81,2,0.0
70,0,17,64,81,2,0.0
71,0,6,34,40,2,0.0
72,0,6,11,17,2,0.0
73,0,5,39,44,2,0.0
74,0,16,46,62,2,0.0
75,0,18,46,64,2,0.0
76,0,12,31,43,2,0.0
77,0,10,65,75,2,0.0
78,0,11,42,53,2,0.0
79,0,5,32,37,2,0.0
80,0,2,8,10,2,0.0
81,0,8,26,34,2,0.0
82,0,2,8,10,2,0.0
83,0,4,24,28,2,0.0
84,0,6,33,39,2,0.0
85,0,17,82,99,2,0.0
86,0,4,27,31,2,0.0
87,0,12,68,80,2,0.0
88,0,4,8,12,2,0.0
89,0,21,92,113,2,0.0
90,0,11,36,47,2,0.0
91,0,16,38,54,2,0.0
92,0,25,91,116,2,0.0
93,0,6,16,22,2,0.0
94,0,7,10,17,2,0.0
95,0,19,40,59,2,0.0
96,0,5,12,17,2,0.0
97,0,3,10,13,2,0.0
98,0,2,7,9,2,0.0
99,0,1,1,2,2,0.0
100,0,10,3,13,2,0.0
101,0,36,72,108,2,0.0
102,0,17,38,55,2,0.0
103,0,18,59,77,2,0.0
104,0,42,145,187,2,0.0
105,0,26,77,103,2,0.0
106,0,27,79,106,2,0.0
107,0,63,134,197,2,0.0
108,0,24,78,102,2,0.0
109,0,14,66,80,2,0.0
110,0,9,23,32,2,0.0
111,0,31,98,129,2,0.0
112,0,0,6,6,2,0.0
113,0,17,72,89,2,0.0
114,0,11,25,36,2,0.0
115,0,11,44,55,2,0.0
116,0,17,75,92,2,0.0
117,0,26,83,109,2,0.0
118,0,11,53,64,2,0.0
119,0,5,11,16,2,0.0
120,0,23,54,77,2,0.0
121,0,21,60,81,2,0.0
122,0,19,47,66,2,0.0
123,0,4,2,6,2,0.0
124,0,9,22,31,2,0.0
125,0,13,26,39,2,0.0
126,0,4,41,45,2,0.0
127,0,10,38,48,2,0.0
128,0,2,6,8,2,0.0
129,0,11,58,69,2,0.0
130,0,35,76,111,2,0.0
131,0,3,12,15,2,0.0
132,0,44,115,159,2,0.0
133,0,10,37,47,2,0.0
134,0,19,32,51,2,0.0
135,0,16,65,81,2,0.0
136,0,8,10,18,2,0.0
137,0,28,92,120,2,0.0
138,0,29,56,85,2,0.0
139,0,9,22,31,2,0.0
140,0,5,20,25,2,0.0
141,0,4,23,27,2,0.0
142,0,1,4,5,2,0.0
143,0,8,43,51,2,0.0
144,0,22,80,102,2,0.0
145,0,25,74,99,2,0.0
146,0,15,55,70,2,0.0
147,0,23,55,78,2,0.0
148,0,17,100,117,2,0.0
149,0,11,43,54,2,0.0
150,0,2,9,11,2,0.0
151,0,15,82,97,2,0.0
152,0,18,65,83,2,0.0
153,0,7,17,24,2,0.0
154,0,4,39,43,2,0.0
155,0,8,41,49,2,0.0
156,0,12,40,52,2,0.0
157,0,7,24,31,2,0.0
158,0,3,4,7,2,0.0
159,0,14,20,34,2,0.0
160,0,5,23,28,2,0.0
161,0,4,21,25,2,0.0
162,0,81,190,271,2,0.0
163,0,20,61,81,2,0.0
164,0,96,278,374,2,0.0
165,0,20,43,63,2,0.0
166,0,60,100,160,2,0.0
167,0,27,95,122,2,0.0
168,0,75,231,306,2,0.0
169,0,14,36,50,2,0.0
170,0,20,149,169,2,0.0
171,0,10,105,115,2,0.0
172,0,22,108,130,2,0.0
173,0,7,15,22,2,0.0
174,0,106,293,399,2,0.0
175,0,113,250,363,2,0.0
176,0,38,96,134,2,0.0
177,0,199,529,728,2,0.0
178,0,129,355,484,2,0.0
179,0,115,240,355,2,0.0
180,0,8,75,83,2,0.0
181,0,152,341,493,2,0.0
182,0,107,329,436,2,0.0
183,0,76,218,294,2,0.0
184,0,12,42,54,2,0.0
185,0,27,104,131,2,0.0
186,0,22,122,144,2,0.0
187,0,19,46,65,2,0.0
188,0,158,324,482,2,0.0
189,0,35,110,145,2,0.0
190,0,115,222,337,2,0.0
191,0,110,183,293,2,0.0
192,0,162,213,375,2,0.0
193,0,247,452,699,2,0.0
194,0,40,125,165,2,0.0
195,0,199,267,466,2,0.0
196,0,176,364,540,2,0.0
197,0,183,292,475,2,0.0
198,0,115,216,331,2,0.0
199,0,63,157,220,2,0.0
200,0,5,17,22,2,0.0
201,0,96,209,305,2,0.0
202,0,9,25,34,2,0.0
203,0,17,83,100,2,0.0
204,0,2,21,23,2,0.0
205,0,33,131,164,2,0.0
206,0,46,116,162,2,0.0
207,0,59,214,273,2,0.0
208,0,41,89,130,2,0.0
209,0,51,137,188,2,0.0
210,0,54,109,163,2,0.0
211,0,41,153,194,2,0.0
212,0,24,50,74,2,0.0
213,0,26,50,76,2,0.0
214,0,17,45,62,2,0.0
215,0,15,49,64,2,0.0
216,0,33,63,96,2,0.0
217,0,40,138,178,2,0.0
218,0,9,26,35,2,0.0
219,0,6,20,26,2,0.0
220,0,4,6,10,2,0.0
221,0,2,6,8,2,0.0
222,0,9,26,35,2,0.0
223,0,9,41,50,2,0.0
224,0,35,57,92,2,0.0
225,0,21,126,147,2,0.0
226,0,26,79,105,2,0.0
227,0,26,96,122,2,0.0
228,0,8,28,36,2,0.0
229,0,9,28,37,2,0.0
230,0,3,16,19,2,0.0
231,0,16,51,67,2,0.0
232,0,23,12,35,2,0.0
233,0,3,13,16,2,0.0
234,0,6,18,24,2,0.0
235,0,4,8,12,2,0.0
236,0,3,10,13,2,0.0
237,0,13,14,27,2,0.0
238,0,22,41,63,2,0.0
239,0,10,39,49,2,0.0
240,0,14,63,77,2,0.0
241,0,5,21,26,2,0.0
242,0,13,35,48,2,0.0
243,0,6,16,22,2,0.0
244,0,21,40,61,2,0.0
245,0,11,46,57,2,0.0
246,0,30,49,79,2,0.0
247,0,11,19,30,2,0.0
248,0,13,28,41,2,0.0
249,0,13,25,38,2,0.0
250,0,2,4,6,2,0.0
251,0,22,43,65,2,0.0
252,0,17,47,64,2,0.0
253,0,32,60,92,2,0.0
254,0,13,57,70,2,0.0
255,0,68,100,168,2,0.0
256,0,14,71,85,2,0.0
257,0,18,30,48,2,0.0
258,0,7,11,18,2,0.0
259,0,11,66,77,2,0.0
260,0,35,82,117,2,0.0
261,0,23,68,91,2,0.0
262,0,15,28,43,2,0.0
263,0,22,54,76,2,0.0
264,0,4,17,21,2,0.0
265,0,18,40,58,2,0.0
266,0,12,8,20,2,0.0
267,0,5,15,20,2,0.0
268,0,2,5,7,2,0.0
269,0,13,51,64,2,0.0
270,0,34,90,124,2,0.0
271,0,10,15,25,2,0.0
272,0,15,65,80,2,0.0
273,0,20,47,67,2,0.0
274,0,15,54,69,2,0.0
275,0,24,58,82,2,0.0
276,0,15,47,62,2,0.0
277,0,19,91,110,2,0.0
278,0,16,30,46,2,0.0
279,0,24,70,94,2,0.0
280,0,15,43,58,2,0.0
281,0,10,18,28,2,0.0
282,0,9,19,28,2,0.0
283,0,24,53,77,2,0.0
284,0,5,6,11,2,0.0
285,0,0,7,7,2,0.0
286,0,20,85,105,2,0.0
287,0,10,43,53,2,0.0
288,0,19,46,65,2,0.0
289,0,37,111,148,2,0.0
290,0,1,11,12,2,0.0
291,0,12,49,61,2,0.0
292,0,46,83,129,2,0.0
293,0,9,32,41,2,0.0
294,0,4,7,11,2,0.0
295,0,6,20,26,2,0.0
296,0,0,18,18,2,0.0
297,0,38,99,137,2,0.0
298,0,15,13,28,2,0.0
299,0,15,17,32,2,0.0
300,0,12,32,44,2,0.0
301,0,1,16,17,2,0.0
302,0,104,198,302,2,0.0
303,0,14,34,48,2,0.0
304,0,9,26,35,2,0.0
305,0,6,32,38,2,0.0
306,0,26,39,65,2,0.0
307,0,14,22,36,2,0.0
308,0,15,21,36,2,0.0
309,0,6,7,13,2,0.0
310,0,34,69,103,2,0.0
311,0,23,35,58,2,0.0
312,0,11,44,55,2,0.0
313,0,11,21,32,2,0.0
314,0,11,19,30,2,0.0
315,0,20,61,81,2,0.0
316,0,11,30,41,2,0.0
317,0,24,87,111,2,0.0
318,0,18,53,71,2,0.0
319,0,22,46,68,2,0.0
320,0,18,47,65,2,0.0
321,0,4,13,17,2,0.0
322,0,16,71,87,2,0.0
323,0,30,46,76,2,0.0
324,0,8,33,41,2,0.0
325,0,11,24,35,2,0.0
326,0,24,40,64,2,0.0
327,0,14,33,47,2,0.0
328,0,18,64,82,2,0.0
329,0,9,16,25,2,0.0
330,0,10,27,37,2,0.0
331,0,1,8,9,2,0.0
332,0,34,90,124,2,0.0
333,0,16,37,53,2,0.0
334,0,20,42,62,2,0.0
335,0,12,24,36,2,0.0
336,0,52,163,215,2,0.0
337,0,21,140,161,2,0.0
338,0,31,51,82,2,0.0
339,0,30,109,139,2,0.0
340,0,2,36,38,2,0.0
341,0,9,59,68,2,0.0
342,0,3,62,65,2,0.0
343,0,15,16,31,2,0.0
344,0,6,21,27,2,0.0
345,0,13,15,28,2,0.0
346,0,7,19,26,2,0.0
347,0,3,17,20,2,0.0
348,0,35,47,82,2,0.0
349,0,21,37,58,2,0.0
350,0,6,3,9,2,0.0
351,0,19,39,58,2,0.0
352,0,20,42,62,2,0.0
353,0,34,62,96,2,0.0
354,0,10,23,33,2,0.0
355,0,20,17,37,2,0.0
356,0,42,77,119,2,0.0
357,0,93,236,329,2,0.0
358,0,26,76,102,2,0.0
359,0,10,24,34,2,0.0
360,0,8,20,28,2,0.0
361,0,3,17,20,2,0.0
362,0,18,10,28,2,0.0
363,0,23,40,63,2,0.0
364,0,4,9,13,2,0.0
365,0,8,12,20,2,0.0
366,0,5,14,19,2,0.0
367,0,10,27,37,2,0.0
368,0,13,21,34,2,0.0
369,0,20,27,47,2,0.0
370,0,45,133,178,2,0.0
371,0,0,2,2,2,0.0
372,0,23,52,75,2,0.0
373,0,11,35,46,2,0.0
374,0,15,35,50,2,0.0
375,0,16,66,82,2,0.0
376,0,11,31,42,2,0.0
377,0,8,17,25,2,0.0
378,0,17,25,42,2,0.0
379,0,15,27,42,2,0.0
380,0,8,31,39,2,0.0
381,0,3,15,18,2,0.0
382,0,48,43,91,2,0.0
383,0,18,45,63,2,0.0
384,0,30,60,90,2,0.0
385,0,35,78,113,2,0.0
386,0,50,92,142,2,0.0
387,0,47,119,166,2,0.0
388,0,8,17,25,2,0.0
389,0,1,19,20,2,0.0
390,0,19,68,87,2,0.0
391,0,23,51,74,2,0.0
392,0,22,89,111,2,0.0
393,0,12,42,54,2,0.0
394,0,9,13,22,2,0.0
395,0,3,7,10,2,0.0
396,0,8,9,17,2,0.0
397,0,11,34,45,2,0.0
398,0,19,42,61,2,0.0
399,0,13,66,79,2,0.0
400,0,34,152,186,2,0.0
401,0,15,31,46,2,0.0
402,0,68,105,173,2,0.0
403,0,13,30,43,2,0.0
404,0,8,13,21,2,0.0
405,0,4,10,14,2,0.0
406,0,23,8,31,2,0.0
407,0,60,141,201,2,0.0
408,0,9,30,39,2,0.0
409,0,69,116,185,2,0.0
410,0,21,107,128,2,0.0
411,0,24,44,68,2,0.0
412,0,12,18,30,2,0.0
413,0,46,55,101,2,0.0
414,0,31,138,169,2,0.0
415,0,2,10,12,2,0.0
416,0,12,18,30,2,0.0
417,0,19,59,78,2,0.0
418,0,23,72,95,2,0.0
419,0,8,20,28,2,0.0
420,0,6,33,39,2,0.0
421,0,52,78,130,2,0.0
422,0,18,1,19,2,0.0
423,0,3,14,17,2,0.0
424,0,16,44,60,2,0.0
425,0,16,21,37,2,0.0
426,0,15,8,23,2,0.0
427,0,19,49,68,2,0.0
428,0,37,80,117,2,0.0
429,0,43,77,120,2,0.0
430,0,13,29,42,2,0.0
431,0,16,44,60,2,0.0
432,0,20,61,81,2,0.0
433,0,27,45,72,2,0.0
434,0,12,34,46,2,0.0
435,0,6,19,25,2,0.0
436,0,19,40,59,2,0.0
437,0,4,43,47,2,0.0
438,0,5,23,28,2,0.0
439,0,5,29,34,2,0.0
440,0,15,64,79,2,0.0
441,0,14,32,46,2,0.0
442,0,43,65,108,2,0.0
443,0,32,90,122,2,0.0
444,0,7,56,63,2,0.0
445,0,23,68,91,2,0.0
446,0,116,375,491,2,0.0
447,0,3,21,24,2,0.0
448,0,6,7,13,2,0.0
449,0,12,30,42,2,0.0
450,75,13,30,43,2,0.001
451,75,3,10,13,2,0.001
452,75,10,29,39,2,0.001
453,75,12,49,61,2,0.001
454,75,32,74,106,2,0.001
455,75,5,14,19,2,0.001
456,75,17,90,107,2,0.001
457,75,36,81,117,2,0.001
458,75,30,82,112,2,0.001
459,75,22,62,84,2,0.001
460,75,9,14,23,2,0.001
461,75,12,25,37,2,0.001
462,75,22,17,39,2,0.001
463,75,11,17,28,2,0.001
464,75,15,20,35,2,0.001
465,75,6,11,17,2,0.001
466,75,21,36,57,2,0.001
467,75,16,57,73,2,0.001
468,75,11,29,40,2,0.001
469,75,14,50,64,2,0.001
470,75,23,50,73,2,0.001
471,75,31,65,96,2,0.001
472,75,25,48,73,2,0.001
473,75,26,49,75,2,0.001
474,75,28,26,54,2,0.001
475,75,11,28,39,2,0.001
476,75,13,24,37,2,0.001
477,75,7,20,27,2,0.001
478,75,9,22,31,2,0.001
479,75,23,54,77,2,0.001
480,75,26,43,69,2,0.001
481,75,28,42,70,2,0.001
482,75,27,48,75,2,0.001
483,75,31,70,101,2,0.001
484,75,15,28,43,2,0.001
485,75,25,52,77,2,0.001
486,75,22,39,61,2,0.001
487,75,30,68,98,2,0.001
488,75,58,83,141,2,0.001
489,75,30,98,128,2,0.001
490,75,22,35,57,2,0.001
491,75,7,4,11,2,0.001
492,75,14,23,37,2,0.001
493,75,2,13,15,2,0.001
494,75,9,4,13,2,0.001
495,75,6,9,15,2,0.001
496,75,3,19,22,2,0.001
497,75,12,26,38,2,0.001
498,75,26,47,73,2,0.001
499,75,26,52,78,2,0.001
500,75,6,11,17,2,0.001
501,75,30,41,71,2,0.001
502,75,21,39,60,2,0.001
503,75,26,35,61,2,0.001
504,75,29,96,125,2,0.001
505,75,9,13,22,2,0.001
506,75,20,41,61,2,0.001
507,75,42,65,107,2,0.001
508,75,16,24,40,2,0.001
509,75,45,84,129,2,0.001
510,75,19,31,50,2,0.001
511,75,27,50,77,2,0.001
512,75,9,9,18,2,0.001
513,75,11,14,25,2,0.001
514,75,19,23,42,2,0.001
515,75,12,15,27,2,0.001
516,75,19,29,48,2,0.001
517,75,22,35,57,2,0.001
518,75,19,49,68,2,0.001
519,75,46,165,211,2,0.001
520,75,85,192,277,2,0.001
521,75,8,22,30,2,0.001
522,75,92,208,300,2,0.001
523,75,41,84,125,2,0.001
524,75,22,45,67,2,0.001
525,75,35,104,139,2,0.001
526,75,6,11,17,2,0.001
527,75,38,79,117,2,0.001
528,75,21,34,55,2,0.001
529,75,38,103,141,2,0.001
530,75,152,382,534,2,0.001
531,75,33,52,85,2,0.001
532,75,57,142,199,2,0.001
533,75,7,35,42,2,0.001
534,75,4,34,38,2,0.001
535,75,29,43,72,2,0.001
536,75,50,150,200,2,0.001
537,75,34,72,106,2,0.001
538,75,34,82,116,2,0.001
539,75,17,48,65,2,0.001
540,75,3,8,11,2,0.001
541,75,15,29,44,2,0.001
542,75,39,108,147,2,0.001
543,75,34,46,80,2,0.001
544,75,28,40,68,2,0.001
545,75,18,37,55,2,0.001
546,75,25,82,107,2,0.001
547,75,33,40,73,2,0.001
548,75,21,39,60,2,0.001
549,75,54,58,112,2,0.001
550,75,33,93,126,2,0.001
551,75,43,63,106,2,0.001
552,75,29,35,64,2,0.001
553,75,37,95,132,2,0.001
554,75,23,30,53,2,0.001
555,75,18,17,35,2,0.001
556,75,8,42,50,2,0.001
557,75,12,6,18,2,0.001
558,75,12,31,43,2,0.001
559,75,39,88,127,2,0.001
560,75,19,59,78,2,0.001
561,75,15,46,61,2,0.001
562,75,8,20,28,2,0.001
563,75,16,34,50,2,0.001
564,75,24,2,26,2,0.001
565,75,38,49,87,2,0.001
566,75,10,34,44,2,0.001
567,75,6,4,10,2,0.001
568,75,4,30,34,2,0.001
569,75,8,10,18,2,0.001
570,75,34,54,88,2,0.001
571,75,3,6,9,2,0.001
572,75,31,47,78,2,0.001
573,75,5,1,6,2,0.001
574,75,17,22,39,2,0.001
575,75,6,8,14,2,0.001
576,75,3,6,9,2,0.001
577,75,15,34,49,2,0.001
578,75,15,28,43,2,0.001
579,75,13,25,38,2,0.001
580,75,19,71,90,2,0.001
581,75,37,76,113,2,0.001
582,75,33,53,86,2,0.001
583,75,22,41,63,2,0.001
584,75,8,31,39,2,0.001
585,75,18,49,67,2,0.001
586,75,2,7,9,2,0.001
587,75,2,1,3,2,0.001
588,75,56,113,169,2,0.001
589,75,16,10,26,2,0.001
590,75,0,16,16,2,0.001
591,75,93,198,291,2,0.001
592,75,17,38,55,2,0.001
593,75,66,147,213,2,0.001
594,75,81,292,373,2,0.001
595,75,36,55,91,2,0.001
596,75,13,50,63,2,0.001
597,75,11,11,22,2,0.001
598,75,21,83,104,2,0.001
599,75,17,27,44,2,0.001
600,75,6,14,20,2,0.001
601,75,11,23,34,2,0.001
602,75,8,8,16,2,0.001
603,75,2,11,13,2,0.001
604,75,12,32,44,2,0.001
605,75,24,51,75,2,0.001
606,75,21,68,89,2,0.001
607,75,9,30,39,2,0.001
608,75,20,43,63,2,0.001
609,75,32,66,98,2,0.001
610,75,17,29,46,2,0.001
611,75,12,33,45,2,0.001
612,75,12,24,36,2,0.001
613,75,13,4,17,2,0.001
614,75,42,46,88,2,0.001
615,75,1,7,8,2,0.001
616,75,5,9,14,2,0.001
617,75,8,25,33,2,0.001
618,75,12,40,52,2,0.001
619,75,1,1,2,2,0.001
620,75,28,74,102,2,0.001
621,75,7,18,25,2,0.001
622,75,40,84,124,2,0.001
623,75,13,41,54,2,0.001
624,75,6,13,19,2,0.001
625,75,2,7,9,2,0.001
626,75,2,12,14,2,0.001
627,75,17,40,57,2,0.001
628,75,5,21,26,2,0.001
629,75,11,21,32,2,0.001
630,75,4,9,13,2,0.001
631,75,11,20,31,2,0.001
632,75,15,25,40,2,0.001
633,75,5,11,16,2,0.001
634,75,5,9,14,2,0.001
635,75,3,7,10,2,0.001
636,75,8,22,30,2,0.001
637,75,4,10,14,2,0.001
638,75,13,14,27,2,0.001
639,75,12,34,46,2,0.001
640,75,15,58,73,2,0.001
641,75,13,16,29,2,0.001
642,75,6,24,30,2,0.001
643,75,22,67,89,2,0.001
644,75,23,54,77,2,0.001
645,75,5,32,37,2,0.001
646,75,2,19,21,2,0.001
647,75,5,13,18,2,0.001
648,75,15,52,67,2,0.001
649,75,2,10,12,2,0.001
650,75,5,9,14,2,0.001
651,75,22,65,87,2,0.001
652,75,6,20,26,2,0.001
653,75,13,21,34,2,0.001
654,75,26,122,148,2,0.001
655,75,26,41,67,2,0.001
656,75,7,17,24,2,0.001
657,75,13,21,34,2,0.001
658,75,20,32,52,2,0.001
659,75,39,82,121,2,0.001
660,75,4,10,14,2,0.001
661,75,22,37,59,2,0.001
662,75,7,28,35,2,0.001
663,75,5,7,12,2,0.001
664,75,24,69,93,2,0.001
665,75,24,17,41,2,0.001
666,75,45,123,168,2,0.001
667,75,12,27,39,2,0.001
668,75,12,44,56,2,0.001
669,75,4,16,20,2,0.001
670,75,27,61,88,2,0.001
671,75,25,56,81,2,0.001
672,75,33,29,62,2,0.001
673,75,11,15,26,2,0.001
674,75,0,5,5,2,0.001
675,75,10,11,21,2,0.001
676,75,18,41,59,2,0.001
677,75,5,13,18,2,0.001
678,75,12,31,43,2,0.001
679,75,6,36,42,2,0.001
680,75,14,34,48,2,0.001
681,75,45,44,89,2,0.001
682,75,29,64,93,2,0.001
683,75,7,24,31,2,0.001
684,75,61,157,218,2,0.001
685,75,35,78,113,2,0.001
686,75,6,8,14,2,0.001
687,75,19,31,50,2,0.001
688,75,4,1,5,2,0.001
689,75,12,24,36,2,0.001
690,75,11,20,31,2,0.001
691,75,0,0,0,2,0.001
692,75,1,6,7,2,0.001
693,75,8,5,13,2,0.001
694,75,13,15,28,2,0.001
695,75,14,47,61,2,0.001
696,75,18,37,55,2,0.001
697,75,11,27,38,2,0.001
698,75,30,70,100,2,0.001
699,75,14,50,64,2,0.001
700,75,35,93,128,2,0.001
701,75,48,131,179,2,0.001
702,75,13,18,31,2,0.001
703,75,23,44,67,2,0.001
704,75,19,30,49,2,0.001
705,75,13,23,36,2,0.001
706,75,14,22,36,2,0.001
707,75,20,38,58,2,0.001
708,75,5,22,27,2,0.001
709,75,10,20,30,2,0.001
710,75,24,74,98,2,0.001
711,75,19,35,54,2,0.001
712,75,31,52,83,2,0.001
713,75,16,47,63,2,0.001
714,75,66,116,182,2,0.001
715,75,29,84,113,2,0.001
716,75,17,34,51,2,0.001
717,75,34,92,126,2,0.001
718,75,16,49,65,2,0.001
719,75,13,16,29,2,0.001
720,75,14,37,51,2,0.001
721,75,4,20,24,2,0.001
722,75,17,12,29,2,0.001
723,75,5,20,25,2,0.001
724,75,18,39,57,2,0.001
725,75,21,48,69,2,0.001
726,75,5,21,26,2,0.001
727,75,20,65,85,2,0.001
728,75,24,76,100,2,0.001
729,75,25,54,79,2,0.001
730,75,0,6,6,2,0.001
731,75,13,46,59,2,0.001
732,75,9,17,26,2,0.001
733,75,7,16,23,2,0.001
734,75,25,33,58,2,0.001
735,75,17,27,44,2,0.001
736,75,28,37,65,2,0.001
737,75,13,87,100,2,0.001
738,75,25,42,67,2,0.001
739,75,10,14,24,2,0.001
740,75,12,39,51,2,0.001
741,75,5,10,15,2,0.001
742,75,23,42,65,2,0.001
743,75,3,19,22,2,0.001
744,75,37,53,90,2,0.001
745,75,32,38,70,2,0.001
746,75,6,13,19,2,0.001
747,75,2,7,9,2,0.001
748,75,8,36,44,2,0.001
749,75,23,66,89,2,0.001
750,75,29,55,84,2,0.001
751,75,46,87,133,2,0.001
752,75,9,34,43,2,0.001
753,75,10,11,21,2,0.001
754,75,15,29,44,2,0.001
755,75,63,74,137,2,0.001
756,75,17,18,35,2,0.001
757,75,20,34,54,2,0.001
758,75,18,50,68,2,0.001
759,75,2,30,32,2,0.001
760,75,5,25,30,2,0.001
761,75,5,14,19,2,0.001
762,75,2,6,8,2,0.001
763,75,14,57,71,2,0.001
764,75,38,85,123,2,0.001
765,75,8,34,42,2,0.001
766,75,17,50,67,2,0.001
767,75,9,19,28,2,0.001
768,75,22,52,74,2,0.001
769,75,14,17,31,2,0.001
770,75,4,31,35,2,0.001
771,75,0,17,17,2,0.001
772,75,36,59,95,2,0.001
773,75,13,15,28,2,0.001
774,75,11,37,48,2,0.001
775,75,44,85,129,2,0.001
776,75,18,80,98,2,0.001
777,75,26,57,83,2,0.001
778,75,14,41,55,2,0.001
779,75,18,62,80,2,0.001
780,75,23,21,44,2,0.001
781,75,14,35,49,2,0.001
782,75,15,43,58,2,0.001
783,75,5,31,36,2,0.001
784,75,13,26,39,2,0.001
785,75,13,36,49,2,0.001
786,75,29,66,95,2,0.001
787,75,10,52,62,2,0.001
788,75,10,27,37,2,0.001
789,75,15,48,63,2,0.001
790,75,7,23,30,2,0.001
791,75,8,41,49,2,0.001
792,75,12,35,47,2,0.001
793,75,10,23,33,2,0.001
794,75,14,18,32,2,0.001
795,75,10,14,24,2,0.001
796,75,4,7,11,2,0.001
797,75,9,31,40,2,0.001
798,75,16,36,52,2,0.001
799,75,14,59,73,2,0.001
800,75,18,60,78,2,0.001
801,75,42,136,178,2,0.001
802,75,8,25,33,2,0.001
803,75,31,77,108,2,0.001
804,75,34,103,137,2,0.001
805,75,13,19,32,2,0.001
806,75,30,80,110,2,0.001
807,75,3,30,33,2,0.001
808,75,8,19,27,2,0.001
809,75,12,14,26,2,0.001
810,75,49,63,112,2,0.001
811,75,2,5,7,2,0.001
812,75,9,30,39,2,0.001
813,75,6,23,29,2,0.001
814,75,29,83,112,2,0.001
815,75,48,128,176,2,0.001
816,75,19,62,81,2,0.001
817,75,10,22,32,2,0.001
818,75,14,22,36,2,0.001
819,75,2,11,13,2,0.001
820,75,12,16,28,2,0.001
821,75,2,11,13,2,0.001
822,75,13,16,29,2,0.001
823,75,7,12,19,2,0.001
824,75,8,6,14,2,0.001
825,75,12,36,48,2,0.001
826,75,12,46,58,2,0.001
827,75,25,63,88,2,0.001
828,75,37,63,100,2,0.001
829,75,7,26,33,2,0.001
830,75,34,38,72,2,0.001
831,75,35,50,85,2,0.001
832,75,19,52,71,2,0.001
833,75,12,36,48,2,0.001
834,75,7,20,27,2,0.001
835,75,16,43,59,2,0.001
836,75,7,11,18,2,0.001
837,75,13,23,36,2,0.001
838,75,4,2,6,2,0.001
839,75,3,16,19,2,0.001
840,75,9,39,48,2,0.001
841,75,14,49,63,2,0.001
842,75,5,19,24,2,0.001
843,75,22,37,59,2,0.001
844,75,8,25,33,2,0.001
845,75,9,41,50,2,0.001
846,75,5,28,33,2,0.001
847,75,10,45,55,2,0.001
848,75,7,31,38,2,0.001
849,75,14,26,40,2,0.001
850,75,13,20,33,2,0.001
851,75,8,32,40,2,0.001
852,75,2,11,13,2,0.001
853,75,11,29,40,2,0.001
854,75,11,39,50,2,0.001
855,75,49,52,101,2,0.001
856,75,17,82,99,2,0.001
857,75,13,52,65,2,0.001
858,75,22,58,80,2,0.001
859,75,21,63,84,2,0.001
860,75,12,49,61,2,0.001
861,75,12,29,41,2,0.001
862,75,13,46,59,2,0.001
863,75,5,32,37,2,0.001
864,75,10,24,34,2,0.001
865,75,9,33,42,2,0.001
866,75,21,70,91,2,0.001
867,75,28,54,82,2,0.001
868,75,52,76,128,2,0.001
869,75,10,19,29,2,0.001
870,75,7,20,27,2,0.001
871,75,22,43,65,2,0.001
872,75,16,28,44,2,0.001
873,75,72,81,153,2,0.001
874,75,12,23,35,2,0.001
875,75,18,45,63,2,0.001
876,75,3,30,33,2,0.001
877,75,3,6,9,2,0.001
878,75,9,8,17,2,0.001
879,75,8,8,16,2,0.001
880,75,5,13,18,2,0.01
881,75,17,38,55,2,0.01
882,75,15,35,50,2,0.01
883,75,2,9,11,2,0.01
884,75,24,66,90,2,0.01
885,75,16,58,74,2,0.01
886,75,13,40,53,2,0.01
887,75,27,99,126,2,0.01
888,75,26,51,77,2,0.01
889,75,12,29,41,2,0.01
890,75,48,103,151,2,0.01
891,75,13,22,35,2,0.01
892,75,8,46,54,2,0.01
893,75,17,20,37,2,0.01
894,75,4,10,14,2,0.01
895,75,51,74,125,2,0.01
896,75,6,46,52,2,0.01
897,75,29,63,92,2,0.01
898,75,19,59,78,2,0.01
899,75,43,144,187,2,0.01
900,75,6,14,20,2,0.01
901,75,27,41,68,2,0.01
902,75,12,49,61,2,0.01
903,75,28,28,56,2,0.01
904,75,13,50,63,2,0.01
905,75,11,33,44,2,0.01
906,75,22,55,77,2,0.01
907,75,11,62,73,2,0.01
908,75,26,42,68,2,0.01
909,75,5,28,33,2,0.01
910,75,7,11,18,2,0.01
911,75,1,2,3,2,0.01
912,75,6,27,33,2,0.01
913,75,1,4,5,2,0.01
914,75,38,151,189,2,0.01
915,75,14,36,50,2,0.01
916,75,2,26,28,2,0.01
917,75,26,34,60,2,0.01
918,75,7,42,49,2,0.01
919,75,14,18,32,2,0.01
920,75,24,82,106,2,0.01
921,75,15,47,62,2,0.01
922,75,19,43,62,2,0.01
923,75,8,25,33,2,0.01
924,75,8,28,36,2,0.01
925,75,16,22,38,2,0.01
926,75,12,35,47,2,0.01
927,75,17,19,36,2,0.01
928,75,9,23,32,2,0.01
929,75,12,29,41,2,0.01
930,75,7,24,31,2,0.01
931,75,17,45,62,2,0.01
932,75,19,38,57,2,0.01
933,75,12,13,25,2,0.01
934,75,22,57,79,2,0.01
935,75,12,22,34,2,0.01
936,75,11,14,25,2,0.01
937,75,13,31,44,2,0.01
938,75,21,23,44,2,0.01
939,75,13,29,42,2,0.01
940,75,37,61,98,2,0.01
941,75,13,34,47,2,0.01
942,75,17,41,58,2,0.01
943,75,7,29,36,2,0.01
944,75,12,75,87,2,0.01
945,75,24,37,61,2,0.01
946,75,14,42,56,2,0.01
947,75,7,12,19,2,0.01
948,75,7,14,21,2,0.01
949,75,14,24,38,2,0.01
950,75,21,51,72,2,0.01
951,75,11,18,29,2,0.01
952,75,14,65,79,2,0.01
953,75,16,58,74,2,0.01
954,75,16,53,69,2,0.01
955,75,23,90,113,2,0.01
956,75,28,90,118,2,0.01
957,75,13,50,63,2,0.01
958,75,21,37,58,2,0.01
959,75,11,41,52,2,0.01
960,75,13,38,51,2,0.01
961,75,10,13,23,2,0.01
962,75,7,20,27,2,0.01
963,75,2,11,13,2,0.01
964,75,17,47,64,2,0.01
965,75,10,48,58,2,0.01
966,75,5,11,16,2,0.01
967,75,12,24,36,2,0.01
968,75,8,34,42,2,0.01
969,75,27,50,77,2,0.01
970,75,18,36,54,2,0.01
971,75,8,74,82,2,0.01
972,75,18,41,59,2,0.01
973,75,41,113,154,2,0.01
974,75,4,14,18,2,0.01
975,75,21,27,48,2,0.01
976,75,8,17,25,2,0.01
977,75,5,7,12,2,0.01
978,75,12,18,30,2,0.01
979,75,7,37,44,2,0.01
980,75,30,78,108,2,0.01
981,75,4,7,11,2,0.01
982,75,46,84,130,2,0.01
983,75,26,81,107,2,0.01
984,75,3,14,17,2,0.01
985,75,10,37,47,2,0.01
986,75,12,39,51,2,0.01
987,75,9,15,24,2,0.01
988,75,35,53,88,2,0.01
989,75,16,34,50,2,0.01
990,75,36,31,67,2,0.01
991,75,21,18,39,2,0.01
992,75,10,43,53,2,0.01
993,75,11,36,47,2,0.01
994,75,22,20,42,2,0.01
995,75,3,8,11,2,0.01
996,75,6,20,26,2,0.01
997,75,1,38,39,2,0.01
998,75,4,8,12,2,0.01
999,75,7,3,10,2,0.01
1000,75,15,19,34,2,0.01
1001,75,14,20,34,2,0.01
1002,75,5,12,17,2,0.01
1003,75,11,40,51,2,0.01
1004,75,7,23,30,2,0.01
1005,75,42,79,121,2,0.01
1006,75,10,37,47,2,0.01
1007,75,6,16,22,2,0.01
1008,75,22,58,80,2,0.01
1009,75,11,39,50,2,0.01
1010,75,30,72,102,2,0.01
1011,75,6,8,14,2,0.01
1012,75,3,3,6,2,0.01
1013,75,16,27,43,2,0.01
1014,75,17,12,29,2,0.01
1015,75,11,52,63,2,0.01
1016,75,20,67,87,2,0.01
1017,75,24,21,45,2,0.01
1018,75,11,38,49,2,0.01
1019,75,10,27,37,2,0.01
1020,75,21,69,90,2,0.01
1021,75,20,33,53,2,0.01
1022,75,15,42,57,2,0.01
1023,75,5,20,25,2,0.01
1024,75,13,26,39,2,0.01
1025,75,3,3,6,2,0.01
1026,75,16,22,38,2,0.01
1027,75,8,31,39,2,0.01
1028,75,4,6,10,2,0.01
1029,75,1,21,22,2,0.01
1030,75,12,37,49,2,0.01
1031,75,18,19,37,2,0.01
1032,75,10,17,27,2,0.01
1033,75,8,17,25,2,0.01
1034,75,43,61,104,2,0.01
1035,75,10,42,52,2,0.01
1036,75,35,30,65,2,0.01
1037,75,13,47,60,2,0.01
1038,75,20,56,76,2,0.01
1039,75,4,14,18,2,0.01
1040,75,15,19,34,2,0.01
1041,75,4,20,24,2,0.01
1042,75,34,53,87,2,0.01
1043,75,8,25,33,2,0.01
1044,75,17,61,78,2,0.01
1045,75,8,18,26,2,0.01
1046,75,5,15,20,2,0.01
1047,75,16,42,58,2,0.01
1048,75,11,32,43,2,0.01
1049,75,29,80,109,2,0.01
1050,75,18,29,47,2,0.01
1051,75,25,18,43,2,0.01
1052,75,19,55,74,2,0.01
1053,75,17,29,46,2,0.01
1054,75,18,49,67,2,0.01
1055,75,32,58,90,2,0.01
1056,75,28,32,60,2,0.01
1057,75,17,39,56,2,0.01
1058,75,15,18,33,2,0.01
1059,75,8,25,33,2,0.01
1060,75,15,9,24,2,0.01
1061,75,5,9,14,2,0.01
1062,75,19,28,47,2,0.01
1063,75,23,45,68,2,0.01
1064,75,7,9,16,2,0.01
1065,75,14,42,56,2,0.01
1066,75,15,25,40,2,0.01
1067,75,12,29,41,2,0.01
1068,75,13,17,30,2,0.01
1069,75,11,67,78,2,0.01
1070,75,22,47,69,2,0.01
1071,75,14,29,43,2,0.01
1072,75,3,13,16,2,0.01
1073,75,40,64,104,2,0.01
1074,75,11,30,41,2,0.01
1075,75,10,27,37,2,0.01
1076,75,7,21,28,2,0.01
1077,75,10,28,38,2,0.01
1078,75,4,13,17,2,0.01
1079,75,1,6,7,2,0.01
1080,75,26,32,58,2,0.01
1081,75,2,6,8,2,0.01
1082,75,39,81,120,2,0.01
1083,75,57,152,209,2,0.01
1084,75,11,22,33,2,0.01
1085,75,25,68,93,2,0.01
1086,75,15,73,88,2,0.01
1087,75,43,135,178,2,0.01
1088,75,11,26,37,2,0.01
1089,75,21,73,94,2,0.01
1090,75,50,79,129,2,0.01
1091,75,9,11,20,2,0.01
1092,75,35,95,130,2,0.01
1093,75,42,92,134,2,0.01
1094,75,28,114,142,2,0.01
1095,75,118,257,375,2,0.01
1096,75,56,104,160,2,0.01
1097,75,12,27,39,2,0.01
1098,75,27,86,113,2,0.01
1099,75,1,18,19,2,0.01
1100,75,34,94,128,2,0.01
1101,75,7,49,56,2,0.01
1102,75,23,65,88,2,0.01
1103,75,10,44,54,2,0.01
1104,75,7,24,31,2,0.01
1105,75,21,43,64,2,0.01
1106,75,51,123,174,2,0.01
1107,75,15,43,58,2,0.01
1108,75,35,62,97,2,0.01
1109,75,6,13,19,2,0.01
1110,75,27,44,71,2,0.01
1111,75,32,31,63,2,0.01
1112,75,8,10,18,2,0.01
1113,75,19,24,43,2,0.01
1114,75,69,164,233,2,0.01
1115,75,26,33,59,2,0.01
1116,75,12,23,35,2,0.01
1117,75,34,38,72,2,0.01
1118,75,2,2,4,2,0.01
1119,75,6,23,29,2,0.01
1120,75,22,46,68,2,0.01
1121,75,22,43,65,2,0.01
1122,75,9,37,46,2,0.01
1123,75,6,12,18,2,0.01
1124,75,2,15,17,2,0.01
1125,75,9,36,45,2,0.01
1126,75,20,37,57,2,0.01
1127,75,10,25,35,2,0.01
1128,75,33,70,103,2,0.01
1129,75,23,34,57,2,0.01
1130,75,25,47,72,2,0.01
1131,75,40,56,96,2,0.01
1132,75,11,12,23,2,0.01
1133,75,4,7,11,2,0.01
1134,75,17,21,38,2,0.01
1135,75,11,22,33,2,0.01
1136,75,32,41,73,2,0.01
1137,75,25,31,56,2,0.01
1138,75,20,55,75,2,0.01
1139,75,65,136,201,2,0.01
1140,75,26,37,63,2,0.01
1141,75,22,25,47,2,0.01
1142,75,20,47,67,2,0.01
1143,75,13,15,28,2,0.01
1144,75,21,30,51,2,0.01
1145,75,25,22,47,2,0.01
1146,75,3,8,11,2,0.01
1147,75,16,15,31,2,0.01
1148,75,23,28,51,2,0.01
1149,75,2,13,15,2,0.01
1150,75,16,20,36,2,0.01
1151,75,31,67,98,2,0.01
1152,75,8,5,13,2,0.01
1153,75,16,28,44,2,0.01
1154,75,35,61,96,2,0.01
1155,75,18,52,70,2,0.01
1156,75,5,17,22,2,0.01
1157,75,15,69,84,2,0.01
1158,75,13,17,30,2,0.01
1159,75,14,34,48,2,0.01
1160,75,5,18,23,2,0.01
1161,75,1,6,7,2,0.01
1162,75,11,36,47,2,0.01
1163,75,2,4,6,2,0.01
1164,75,20,23,43,2,0.01
1165,75,25,22,47,2,0.01
1166,75,5,14,19,2,0.01
1167,75,20,23,43,2,0.01
1168,75,25,82,107,2,0.01
1169,75,27,31,58,2,0.01
1170,75,14,47,61,2,0.01
1171,75,11,66,77,2,0.01
1172,75,33,70,103,2,0.01
1173,75,11,27,38,2,0.01
1174,75,18,36,54,2,0.01
1175,75,8,23,31,2,0.01
1176,75,15,51,66,2,0.01
1177,75,8,14,22,2,0.01
1178,75,12,34,46,2,0.01
1179,75,7,14,21,2,0.01
1180,75,23,34,57,2,0.01
1181,75,17,58,75,2,0.01
1182,75,4,52,56,2,0.01
1183,75,29,63,92,2,0.01
1184,75,32,32,64,2,0.01
1185,75,7,13,20,2,0.01
1186,75,18,31,49,2,0.01
1187,75,13,27,40,2,0.01
1188,75,13,29,42,2,0.01
1189,75,13,16,29,2,0.01
1190,75,5,16,21,2,0.01
1191,75,5,9,14,2,0.01
1192,75,7,12,19,2,0.01
1193,75,7,43,50,2,0.01
1194,75,5,42,47,2,0.01
1195,75,32,70,102,2,0.01
1196,75,15,41,56,2,0.01
1197,75,12,51,63,2,0.01
1198,75,27,48,75,2,0.01
1199,75,19,33,52,2,0.01
1200,75,7,16,23,2,0.01
1201,75,5,27,32,2,0.01
1202,75,4,34,38,2,0.01
1203,75,22,24,46,2,0.01
1204,75,23,37,60,2,0.01
1205,75,5,39,44,2,0.01
1206,75,52,46,98,2,0.01
1207,75,22,32,54,2,0.01
1208,75,14,33,47,2,0.01
1209,75,42,102,144,2,0.01
1210,75,25,65,90,2,0.01
1211,75,40,74,114,2,0.01
1212,75,40,51,91,2,0.01
1213,75,2,10,12,2,0.01
1214,75,9,17,26,2,0.01
1215,75,17,55,72,2,0.01
1216,75,28,71,99,2,0.01
1217,75,17,76,93,2,0.01
1218,75,26,74,100,2,0.01
1219,75,18,42,60,2,0.01
1220,75,43,57,100,2,0.01
1221,75,32,90,122,2,0.01
1222,75,21,47,68,2,0.01
1223,75,11,85,96,2,0.01
1224,75,31,41,72,2,0.01
1225,75,5,18,23,2,0.01
1226,75,11,10,21,2,0.01
1227,75,13,53,66,2,0.01
1228,75,34,59,93,2,0.01
1229,75,8,14,22,2,0.01
1230,75,21,92,113,2,0.01
1231,75,20,79,99,2,0.01
1232,75,22,77,99,2,0.01
1233,75,6,23,29,2,0.01
1234,75,5,43,48,2,0.01
1235,75,17,19,36,2,0.01
1236,75,6,28,34,2,0.01
1237,75,5,24,29,2,0.01
1238,75,18,59,77,2,0.01
1239,75,11,17,28,2,0.01
1240,75,8,16,24,2,0.01
1241,75,14,53,67,2,0.01
1242,75,30,68,98,2,0.01
1243,75,8,8,16,2,0.01
1244,75,18,65,83,2,0.01
1245,75,42,112,154,2,0.01
1246,75,9,29,38,2,0.01
1247,75,27,43,70,2,0.01
1248,75,17,56,73,2,0.01
1249,75,4,6,10,2,0.01
1250,75,15,29,44,2,0.01
1251,75,3,2,5,2,0.01
1252,75,24,34,58,2,0.01
1253,75,1,5,6,2,0.01
1254,75,1,23,24,2,0.01
1255,75,2,22,24,2,0.01
1256,75,5,18,23,2,0.01
1257,75,27,96,123,2,0.01
1258,75,25,46,71,2,0.01
1259,75,4,6,10,2,0.01
1260,75,7,51,58,2,0.01
1261,75,28,51,79,2,0.01
1262,75,14,65,79,2,0.01
1263,75,15,11,26,2,0.01
1264,75,3,18,21,2,0.01
1265,75,19,39,58,2,0.01
1266,75,9,20,29,2,0.01
1267,75,3,16,19,2,0.01
1268,75,26,52,78,2,0.01
1269,75,7,25,32,2,0.01
1270,75,23,39,62,2,0.01
1271,75,31,58,89,2,0.01
1272,75,24,53,77,2,0.01
1273,75,6,23,29,2,0.01
1274,75,42,45,87,2,0.01
1275,75,13,51,64,2,0.01
1276,75,16,23,39,2,0.01
1277,75,52,45,97,2,0.01
1278,75,54,85,139,2,0.01
1279,75,31,57,88,2,0.01
1280,75,36,41,77,2,0.01
1281,75,9,29,38,2,0.01
1282,75,67,78,145,2,0.01
1283,75,19,29,48,2,0.01
1284,75,44,66,110,2,0.01
1285,75,50,77,127,2,0.01
1286,75,4,7,11,2,0.01
1287,75,0,8,8,2,0.01
1288,75,7,22,29,2,0.1
1289,75,8,27,35,2,0.1
1290,75,21,82,103,2,0.1
1291,75,32,64,96,2,0.1
1292,75,24,55,79,2,0.1
1293,75,17,55,72,2,0.1
1294,75,8,24,32,2,0.1
1295,75,59,101,160,2,0.1
1296,75,8,15,23,2,0.1
1297,75,29,49,78,2,0.1
1298,75,12,28,40,2,0.1
1299,75,60,110,170,2,0.1
1300,75,15,66,81,2,0.1
1301,75,56,231,287,2,0.1
1302,75,13,27,40,2,0.1
1303,75,52,150,202,2,0.1
1304,75,16,31,47,2,0.1
1305,75,93,98,191,2,0.1
1306,75,49,93,142,2,0.1
1307,75,28,84,112,2,0.1
1308,75,14,40,54,2,0.1
1309,75,13,55,68,2,0.1
1310,75,36,59,95,2,0.1
1311,75,15,21,36,2,0.1
1312,75,13,12,25,2,0.1
1313,75,13,7,20,2,0.1
1314,75,13,29,42,2,0.1
1315,75,29,67,96,2,0.1
1316,75,29,65,94,2,0.1
1317,75,10,38,48,2,0.1
1318,75,19,54,73,2,0.1
1319,75,43,135,178,2,0.1
1320,75,37,63,100,2,0.1
1321,75,6,17,23,2,0.1
1322,75,63,119,182,2,0.1
1323,75,28,67,95,2,0.1
1324,75,10,27,37,2,0.1
1325,75,0,3,3,2,0.1
1326,75,1,6,7,2,0.1
1327,75,17,49,66,2,0.1
1328,75,28,82,110,2,0.1
1329,75,34,114,148,2,0.1
1330,75,23,68,91,2,0.1
1331,75,23,46,69,2,0.1
1332,75,21,59,80,2,0.1
1333,75,36,125,161,2,0.1
1334,75,22,185,207,2,0.1
1335,75,25,51,76,2,0.1
1336,75,3,21,24,2,0.1
1337,75,19,57,76,2,0.1
1338,75,18,33,51,2,0.1
1339,75,3,0,3,2,0.1
1340,75,45,99,144,2,0.1
1341,75,4,14,18,2,0.1
1342,75,37,102,139,2,0.1
1343,75,22,41,63,2,0.1
1344,75,29,117,146,2,0.1
1345,75,26,58,84,2,0.1
1346,75,33,55,88,2,0.1
1347,75,12,72,84,2,0.1
1348,75,29,39,68,2,0.1
1349,75,23,41,64,2,0.1
1350,75,27,34,61,2,0.1
1351,75,15,22,37,2,0.1
1352,75,20,68,88,2,0.1
1353,75,6,32,38,2,0.1
1354,75,25,104,129,2,0.1
1355,75,33,82,115,2,0.1
1356,75,11,52,63,2,0.1
1357,75,89,220,309,2,0.1
1358,75,29,57,86,2,0.1
1359,75,26,52,78,2,0.1
1360,75,119,224,343,2,0.1
1361,75,248,878,1126,2,0.1
1362,75,62,160,222,2,0.1
1363,75,8,44,52,2,0.1
1364,75,15,46,61,2,0.1
1365,75,2,36,38,2,0.1
1366,75,25,70,95,2,0.1
1367,75,17,51,68,2,0.1
1368,75,13,40,53,2,0.1
1369,75,21,64,85,2,0.1
1370,75,17,41,58,2,0.1
1371,75,23,95,118,2,0.1
1372,75,17,54,71,2,0.1
1373,75,5,25,30,2,0.1
1374,75,22,66,88,2,0.1
1375,75,116,298,414,2,0.1
1376,75,6,18,24,2,0.1
1377,75,41,62,103,2,0.1
1378,75,8,41,49,2,0.1
1379,75,61,215,276,2,0.1
1380,75,10,21,31,2,0.1
1381,75,16,30,46,2,0.1
1382,75,25,81,106,2,0.1
1383,75,24,72,96,2,0.1
1384,75,26,60,86,2,0.1
1385,75,19,30,49,2,0.1
1386,75,28,52,80,2,0.1
1387,75,16,59,75,2,0.1
1388,75,18,53,71,2,0.1
1389,75,18,38,56,2,0.1
1390,75,4,15,19,2,0.1
1391,75,3,21,24,2,0.1
1392,75,1,8,9,2,0.1
1393,75,3,17,20,2,0.1
1394,75,13,30,43,2,0.1
1395,75,10,77,87,2,0.1
1396,75,52,81,133,2,0.1
1397,75,30,36,66,2,0.1
1398,75,9,48,57,2,0.1
1399,75,15,18,33,2,0.1
1400,75,24,24,48,2,0.1
1401,75,34,92,126,2,0.1
1402,75,9,43,52,2,0.1
1403,75,15,26,41,2,0.1
1404,75,5,4,9,2,0.1
1405,75,60,193,253,2,0.1
1406,75,31,78,109,2,0.1
1407,75,27,53,80,2,0.1
1408,75,16,54,70,2,0.1
1409,75,35,97,132,2,0.1
1410,75,38,115,153,2,0.1
1411,75,38,53,91,2,0.1
1412,75,21,32,53,2,0.1
1413,75,5,29,34,2,0.1
1414,75,27,68,95,2,0.1
1415,75,75,183,258,2,0.1
1416,75,12,27,39,2,0.1
1417,75,9,15,24,2,0.1
1418,75,19,68,87,2,0.1
1419,75,6,20,26,2,0.1
1420,75,21,32,53,2,0.1
1421,75,11,31,42,2,0.1
1422,75,11,44,55,2,0.1
1423,75,14,29,43,2,0.1
1424,75,25,68,93,2,0.1
1425,75,10,33,43,2,0.1
1426,75,16,55,71,2,0.1
1427,75,33,57,90,2,0.1
1428,75,12,46,58,2,0.1
1429,75,51,151,202,2,0.1
1430,75,40,102,142,2,0.1
1431,75,11,46,57,2,0.1
1432,75,37,71,108,2,0.1
1433,75,27,64,91,2,0.1
1434,75,5,20,25,2,0.1
1435,75,10,39,49,2,0.1
1436,75,40,54,94,2,0.1
1437,75,17,36,53,2,0.1
1438,75,10,12,22,2,0.1
1439,75,23,60,83,2,0.1
1440,75,8,38,46,2,0.1
1441,75,8,14,22,2,0.1
1442,75,19,47,66,2,0.1
1443,75,20,44,64,2,0.1
1444,75,20,62,82,2,0.1
1445,75,7,12,19,2,0.1
1446,75,18,22,40,2,0.1
1447,75,4,14,18,2,0.1
1448,75,13,19,32,2,0.1
1449,75,11,19,30,2,0.1
1450,75,12,54,66,2,0.1
1451,75,4,9,13,2,0.1
1452,75,23,33,56,2,0.1
1453,75,11,68,79,2,0.1
1454,75,7,9,16,2,0.1
1455,75,55,76,131,2,0.1
1456,75,23,40,63,2,0.1
1457,75,9,14,23,2,0.1
1458,75,21,51,72,2,0.1
1459,75,28,61,89,2,0.1
1460,75,0,3,3,2,0.1
1461,75,4,18,22,2,0.1
1462,75,10,12,22,2,0.1
1463,75,1,5,6,2,0.1
1464,75,1,2,3,2,0.1
1465,75,3,7,10,2,0.1
1466,75,4,12,16,2,0.1
1467,75,16,38,54,2,0.1
1468,75,32,44,76,2,0.1
1469,75,16,33,49,2,0.1
1470,75,12,36,48,2,0.1
1471,75,11,40,51,2,0.1
1472,75,9,20,29,2,0.1
1473,75,12,23,35,2,0.1
1474,75,7,28,35,2,0.1
1475,75,9,33,42,2,0.1
1476,75,16,34,50,2,0.1
1477,75,11,21,32,2,0.1
1478,75,5,18,23,2,0.1
1479,75,4,14,18,2,0.1
1480,75,29,81,110,2,0.1
1481,75,15,57,72,2,0.1
1482,75,14,38,52,2,0.1
1483,75,15,32,47,2,0.1
1484,75,27,83,110,2,0.1
1485,75,10,48,58,2,0.1
1486,75,29,177,206,2,0.1
1487,75,25,52,77,2,0.1
1488,75,19,47,66,2,0.1
1489,75,23,49,72,2,0.1
1490,75,30,45,75,2,0.1
1491,75,21,66,87,2,0.1
1492,75,7,13,20,2,0.1
1493,75,3,17,20,2,0.1
1494,75,72,123,195,2,0.1
1495,75,58,89,147,2,0.1
1496,75,90,218,308,2,0.1
1497,75,65,183,248,2,0.1
1498,75,34,79,113,2,0.1
1499,75,24,60,84,2,0.1
1500,75,43,35,78,2,0.1
1501,75,17,32,49,2,0.1
1502,75,21,77,98,2,0.1
1503,75,27,58,85,2,0.1
1504,75,5,33,38,2,0.1
1505,75,27,62,89,2,0.1
1506,75,26,34,60,2,0.1
1507,75,22,25,47,2,0.1
1508,75,28,70,98,2,0.1
1509,75,76,65,141,2,0.1
1510,75,36,100,136,2,0.1
1511,75,21,107,128,2,0.1
1512,75,28,83,111,2,0.1
1513,75,18,34,52,2,0.1
1514,75,22,49,71,2,0.1
1515,75,28,58,86,2,0.1
1516,75,37,135,172,2,0.1
1517,75,37,55,92,2,0.1
1518,75,14,30,44,2,0.1
1519,75,8,24,32,2,0.1
1520,75,6,14,20,2,0.1
1521,75,16,30,46,2,0.1
1522,75,3,20,23,2,0.1
1523,75,8,23,31,2,0.1
1524,75,11,32,43,2,0.1
1525,75,17,31,48,2,0.1
1526,75,6,27,33,2,0.1
1527,75,20,62,82,2,0.1
1528,75,10,27,37,2,0.1
1529,75,29,65,94,2,0.1
1530,75,10,23,33,2,0.1
1531,75,20,88,108,2,0.1
1532,75,67,141,208,2,0.1
1533,75,15,35,50,2,0.1
1534,75,59,75,134,2,0.1
1535,75,32,89,121,2,0.1
1536,75,6,22,28,2,0.1
1537,75,39,69,108,2,0.1
1538,75,37,44,81,2,0.1
1539,75,10,52,62,2,0.1
1540,75,1,6,7,2,0.1
1541,75,19,38,57,2,0.1
1542,75,26,70,96,2,0.1
1543,75,9,20,29,2,0.1
1544,75,6,34,40,2,0.1
1545,75,62,111,173,2,0.1
1546,75,18,74,92,2,0.1
1547,75,13,27,40,2,0.1
1548,75,4,1,5,2,0.1
1549,75,14,49,63,2,0.1
1550,75,2,13,15,2,0.1
1551,75,31,66,97,2,0.1
1552,75,9,8,17,2,0.1
1553,75,13,23,36,2,0.1
1554,75,13,14,27,2,0.1
1555,75,17,44,61,2,0.1
1556,75,4,16,20,2,0.1
1557,75,6,9,15,2,0.1
1558,75,16,39,55,2,0.1
1559,75,28,52,80,2,0.1
1560,75,21,82,103,2,0.1
1561,75,6,23,29,2,0.1
1562,75,22,66,88,2,0.1
1563,75,23,74,97,2,0.1
1564,75,26,110,136,2,0.1
1565,75,11,27,38,2,0.1
1566,75,19,48,67,2,0.1
1567,75,64,99,163,2,0.1
1568,75,11,34,45,2,0.1
1569,75,29,67,96,2,0.1
1570,75,8,38,46,2,0.1
1571,75,1,19,20,2,0.1
1572,75,37,36,73,2,0.1
1573,75,5,5,10,2,0.1
1574,75,13,23,36,2,0.1
1575,75,13,10,23,2,0.1
1576,75,3,9,12,2,0.1
1577,75,0,0,0,2,0.1
1578,75,9,9,18,2,0.1
1579,75,1,17,18,2,0.1
1580,75,21,79,100,2,0.1
1581,75,19,39,58,2,0.1
1582,75,20,56,76,2,0.1
1583,75,29,76,105,2,0.1
1584,75,55,124,179,2,0.1
1585,75,17,59,76,2,0.1
1586,75,27,45,72,2,0.1
1587,75,11,27,38,2,0.1
1588,75,10,45,55,2,0.1
1589,75,19,102,121,2,0.1
1590,75,28,138,166,2,0.1
1591,75,5,19,24,2,0.1
1592,75,53,212,265,2,0.1
1593,75,10,21,31,2,0.1
1594,75,110,143,253,2,0.1
1595,75,15,32,47,2,0.1
1596,75,72,212,284,2,0.1
1597,75,30,114,144,2,0.1
1598,75,8,14,22,2,0.1
1599,75,6,16,22,2,0.1
1600,75,15,57,72,2,0.1
1601,75,1,16,17,2,0.1
1602,75,9,20,29,2,0.1
1603,75,36,67,103,2,0.1
1604,75,1,6,7,2,0.1
1605,75,2,24,26,2,0.1
1606,75,53,124,177,2,0.1
1607,75,13,41,54,2,0.1
1608,75,27,101,128,2,0.1
1609,75,22,70,92,2,0.1
1610,75,9,22,31,2,0.1
1611,75,32,118,150,2,0.1
1612,75,22,53,75,2,0.1
1613,75,22,54,76,2,0.1
1614,75,16,43,59,2,0.1
1615,75,7,34,41,2,0.1
1616,75,27,64,91,2,0.1
1617,75,14,29,43,2,0.1
1618,75,19,28,47,2,0.1
1619,75,9,22,31,2,0.1
1620,75,33,114,147,2,0.1
1621,75,13,12,25,2,0.1
1622,75,48,107,155,2,0.1
1623,75,23,77,100,2,0.1
1624,75,12,28,40,2,0.1
1625,75,53,116,169,2,0.1
1626,75,21,40,61,2,0.1
1627,75,18,60,78,2,0.1
1628,75,25,46,71,2,0.1
1629,75,4,22,26,2,0.1
1630,75,9,6,15,2,0.1
1631,75,6,26,32,2,0.1
1632,75,11,24,35,2,0.1
1633,75,15,50,65,2,0.1
1634,75,28,48,76,2,0.1
1635,75,17,52,69,2,0.1
1636,75,16,28,44,2,0.1
1637,75,38,78,116,2,0.1
1638,75,27,72,99,2,0.1
1639,75,9,19,28,2,0.1
1640,75,24,40,64,2,0.1
1641,75,12,27,39,2,0.1
1642,75,42,93,135,2,0.1
1643,75,9,19,28,2,0.1
1644,75,3,6,9,2,0.1
1645,75,31,64,95,2,0.1
1646,75,14,93,107,2,0.1
1647,75,11,44,55,2,0.1
1648,75,14,38,52,2,0.1
1649,75,37,94,131,2,0.1
1650,75,19,41,60,2,0.1
1651,75,20,86,106,2,0.1
1652,75,14,70,84,2,0.1
1653,75,9,4,13,2,0.1
1654,75,27,86,113,2,0.1
1655,75,6,22,28,2,0.1
1656,75,21,57,78,2,0.1
1657,75,8,23,31,2,0.1
1658,75,21,43,64,2,0.1
1659,75,9,15,24,2,0.1
1660,75,4,16,20,2,0.1
1661,75,19,32,51,2,0.1
1662,75,13,36,49,2,0.1
1663,75,6,26,32,2,0.1
1664,75,18,74,92,2,0.1
1665,75,34,70,104,2,0.1
1666,75,9,32,41,2,0.1
1667,75,33,48,81,2,0.1
1668,75,11,11,22,2,0.1
1669,75,52,111,163,2,0.1
1670,75,13,28,41,2,0.1
1671,75,74,126,200,2,0.1
1672,75,71,124,195,2,0.1
1673,75,42,77,119,2,0.1
1674,75,127,267,394,2,0.1
1675,75,103,130,233,2,0.1
1676,75,30,78,108,2,0.1
1677,75,61,106,167,2,0.1
1678,75,5,28,33,2,0.1
1679,75,21,52,73,2,0.1
1680,75,19,15,34,2,0.1
1681,75,20,45,65,2,0.1
1682,75,20,90,110,2,0.1
1683,75,62,71,133,2,0.1
1684,75,25,67,92,2,0.1
1685,75,20,55,75,2,0.1
1686,75,7,33,40,2,0.1
1687,75,7,24,31,2,0.1
1688,75,34,100,134,2,0.1
1689,75,9,31,40,2,0.1
1690,75,11,31,42,2,0.1
1691,75,28,67,95,2,0.1
1692,75,17,57,74,2,0.1
1693,75,58,103,161,2,0.1
1694,75,22,51,73,2,0.1
1695,75,36,73,109,2,0.1
1696,75,16,43,59,2,0.1
1697,75,36,82,118,2,0.1
1698,75,10,44,54,2,0.1
1699,75,9,23,32,2,0.1
1700,75,5,14,19,2,0.1
1701,75,18,25,43,2,0.1
1702,75,22,40,62,2,0.1
1703,75,27,40,67,2,0.1
1704,75,9,29,38,2,0.1
1705,75,11,9,20,2,0.1
1706,75,11,17,28,2,1.0
1707,75,76,176,252,2,1.0
1708,75,20,66,86,2,1.0
1709,75,27,97,124,2,1.0
1710,75,26,64,90,2,1.0
1711,75,102,252,354,2,1.0
1712,75,26,101,127,2,1.0
1713,75,8,26,34,2,1.0
1714,75,12,19,31,2,1.0
1715,75,35,147,182,2,1.0
1716,75,8,16,24,2,1.0
1717,75,1,6,7,2,1.0
1718,75,14,25,39,2,1.0
1719,75,25,22,47,2,1.0
1720,75,11,4,15,2,1.0
1721,75,68,203,271,2,1.0
1722,75,32,68,100,2,1.0
1723,75,16,45,61,2,1.0
1724,75,90,135,225,2,1.0
1725,75,41,56,97,2,1.0
1726,75,60,81,141,2,1.0
1727,75,41,129,170,2,1.0
1728,75,73,127,200,2,1.0
1729,75,29,81,110,2,1.0
1730,75,111,253,364,2,1.0
1731,75,158,209,367,2,1.0
1732,75,25,177,202,2,1.0
1733,75,163,418,581,2,1.0
1734,75,81,155,236,2,1.0
1735,75,15,20,35,2,1.0
1736,75,31,144,175,2,1.0
1737,75,95,188,283,2,1.0
1738,75,14,51,65,2,1.0
1739,75,15,30,45,2,1.0
1740,75,23,113,136,2,1.0
1741,75,20,23,43,2,1.0
1742,75,45,110,155,2,1.0
1743,75,31,93,124,2,1.0
1744,75,24,70,94,2,1.0
1745,75,31,43,74,2,1.0
1746,75,66,83,149,2,1.0
1747,75,9,41,50,2,1.0
1748,75,12,30,42,2,1.0
1749,75,6,21,27,2,1.0
1750,75,7,21,28,2,1.0
1751,75,0,9,9,2,1.0
1752,75,18,19,37,2,1.0
1753,75,26,56,82,2,1.0
1754,75,9,16,25,2,1.0
1755,75,37,91,128,2,1.0
1756,75,21,29,50,2,1.0
1757,75,20,116,136,2,1.0
1758,75,2,14,16,2,1.0
1759,75,25,63,88,2,1.0
1760,75,17,49,66,2,1.0
1761,75,9,33,42,2,1.0
1762,75,16,41,57,2,1.0
1763,75,37,69,106,2,1.0
1764,75,6,12,18,2,1.0
1765,75,5,25,30,2,1.0
1766,75,4,13,17,2,1.0
1767,75,21,27,48,2,1.0
1768,75,18,44,62,2,1.0
1769,75,68,129,197,2,1.0
1770,75,24,94,118,2,1.0
1771,75,26,82,108,2,1.0
1772,75,41,40,81,2,1.0
1773,75,40,97,137,2,1.0
1774,75,27,66,93,2,1.0
1775,75,8,26,34,2,1.0
1776,75,40,98,138,2,1.0
1777,75,15,33,48,2,1.0
1778,75,69,97,166,2,1.0
1779,75,33,90,123,2,1.0
1780,75,25,42,67,2,1.0
1781,75,36,75,111,2,1.0
1782,75,61,125,186,2,1.0
1783,75,68,210,278,2,1.0
1784,75,50,97,147,2,1.0
1785,75,61,147,208,2,1.0
1786,75,90,164,254,2,1.0
1787,75,63,266,329,2,1.0
1788,75,39,71,110,2,1.0
1789,75,5,22,27,2,1.0
1790,75,26,50,76,2,1.0
1791,75,40,78,118,2,1.0
1792,75,23,86,109,2,1.0
1793,75,9,39,48,2,1.0
1794,75,23,77,100,2,1.0
1795,75,5,21,26,2,1.0
1796,75,2,12,14,2,1.0
1797,75,19,48,67,2,1.0
1798,75,23,19,42,2,1.0
1799,75,7,27,34,2,1.0
1800,75,29,84,113,2,1.0
1801,75,25,41,66,2,1.0
1802,75,29,57,86,2,1.0
1803,75,42,98,140,2,1.0
1804,75,12,37,49,2,1.0
1805,75,48,132,180,2,1.0
1806,75,22,55,77,2,1.0
1807,75,23,62,85,2,1.0
1808,75,26,26,52,2,1.0
1809,75,4,17,21,2,1.0
1810,75,32,16,48,2,1.0
1811,75,25,42,67,2,1.0
1812,75,27,45,72,2,1.0
1813,75,21,46,67,2,1.0
1814,75,14,33,47,2,1.0
1815,75,17,72,89,2,1.0
1816,75,19,75,94,2,1.0
1817,75,33,116,149,2,1.0
1818,75,52,135,187,2,1.0
1819,75,18,64,82,2,1.0
1820,75,25,79,104,2,1.0
1821,75,36,60,96,2,1.0
1822,75,6,9,15,2,1.0
1823,75,32,49,81,2,1.0
1824,75,6,16,22,2,1.0
1825,75,30,64,94,2,1.0
1826,75,8,22,30,2,1.0
1827,75,79,203,282,2,1.0
1828,75,36,65,101,2,1.0
1829,75,15,43,58,2,1.0
1830,75,48,103,151,2,1.0
1831,75,41,96,137,2,1.0
1832,75,31,46,77,2,1.0
1833,75,26,119,145,2,1.0
1834,75,15,26,41,2,1.0
1835,75,32,104,136,2,1.0
1836,75,15,68,83,2,1.0
1837,75,7,20,27,2,1.0
1838,75,40,118,158,2,1.0
1839,75,55,146,201,2,1.0
1840,75,26,78,104,2,1.0
1841,75,71,139,210,2,1.0
1842,75,62,80,142,2,1.0
1843,75,49,221,270,2,1.0
1844,75,38,86,124,2,1.0
1845,75,27,52,79,2,1.0
1846,75,60,85,145,2,1.0
1847,75,127,428,555,2,1.0
1848,75,22,80,102,2,1.0
1849,75,68,220,288,2,1.0
1850,75,158,413,571,2,1.0
1851,75,61,217,278,2,1.0
1852,75,36,96,132,2,1.0
1853,75,138,182,320,2,1.0
1854,75,24,38,62,2,1.0
1855,75,58,135,193,2,1.0
1856,75,65,149,214,2,1.0
1857,75,15,49,64,2,1.0
1858,75,16,97,113,2,1.0
1859,75,112,190,302,2,1.0
1860,75,9,65,74,2,1.0
1861,75,22,70,92,2,1.0
1862,75,14,40,54,2,1.0
1863,75,32,98,130,2,1.0
1864,75,19,73,92,2,1.0
1865,75,12,28,40,2,1.0
1866,75,6,22,28,2,1.0
1867,75,13,41,54,2,1.0
1868,75,6,9,15,2,1.0
1869,75,23,29,52,2,1.0
1870,75,26,62,88,2,1.0
1871,75,51,113,164,2,1.0
1872,75,40,107,147,2,1.0
1873,75,23,79,102,2,1.0
1874,75,60,114,174,2,1.0
1875,75,35,69,104,2,1.0
1876,75,12,22,34,2,1.0
1877,75,44,115,159,2,1.0
1878,75,59,227,286,2,1.0
1879,75,10,30,40,2,1.0
1880,75,6,16,22,2,1.0
1881,75,10,17,27,2,1.0
1882,75,27,44,71,2,1.0
1883,75,30,52,82,2,1.0
1884,75,15,52,67,2,1.0
1885,75,31,76,107,2,1.0
1886,75,44,98,142,2,1.0
1887,75,43,65,108,2,1.0
1888,75,39,91,130,2,1.0
1889,75,27,60,87,2,1.0
1890,75,22,88,110,2,1.0
1891,75,27,73,100,2,1.0
1892,75,19,29,48,2,1.0
1893,75,3,10,13,2,1.0
1894,75,11,153,164,2,1.0
1895,75,134,154,288,2,1.0
1896,75,95,115,210,2,1.0
1897,75,44,76,120,2,1.0
1898,75,28,129,157,2,1.0
1899,75,53,114,167,2,1.0
1900,75,22,60,82,2,1.0
1901,75,48,126,174,2,1.0
1902,75,17,88,105,2,1.0
1903,75,31,104,135,2,1.0
1904,75,27,98,125,2,1.0
1905,75,13,40,53,2,1.0
1906,75,5,7,12,2,1.0
1907,75,14,27,41,2,1.0
1908,75,38,64,102,2,1.0
1909,75,8,15,23,2,1.0
1910,75,51,101,152,2,1.0
1911,75,31,24,55,2,1.0
1912,75,33,62,95,2,1.0
1913,75,36,68,104,2,1.0
1914,75,24,40,64,2,1.0
1915,75,46,108,154,2,1.0
1916,75,67,111,178,2,1.0
1917,75,20,50,70,2,1.0
1918,75,24,39,63,2,1.0
1919,75,18,63,81,2,1.0
1920,75,59,124,183,2,1.0
1921,75,18,34,52,2,1.0
1922,75,61,57,118,2,1.0
1923,75,34,73,107,2,1.0
1924,75,10,21,31,2,1.0
1925,75,15,29,44,2,1.0
1926,75,1,2,3,2,1.0
1927,75,59,56,115,2,1.0
1928,75,23,37,60,2,1.0
1929,75,30,66,96,2,1.0
1930,75,34,116,150,2,1.0
1931,75,40,78,118,2,1.0
1932,75,30,39,69,2,1.0
1933,75,11,34,45,2,1.0
1934,75,52,94,146,2,1.0
1935,75,106,192,298,2,1.0
1936,75,18,91,109,2,1.0
1937,75,28,98,126,2,1.0
1938,75,18,32,50,2,1.0
1939,75,218,351,569,2,1.0
1940,75,113,217,330,2,1.0
1941,75,28,55,83,2,1.0
1942,75,26,41,67,2,1.0
1943,75,37,68,105,2,1.0
1944,75,3,27,30,2,1.0
1945,75,51,90,141,2,1.0
1946,75,27,41,68,2,1.0
1947,75,14,30,44,2,1.0
1948,75,8,32,40,2,1.0
1949,75,4,10,14,2,1.0
1950,75,26,58,84,2,1.0
1951,75,39,54,93,2,1.0
1952,75,110,110,220,2,1.0
1953,75,5,13,18,2,1.0
1954,75,58,65,123,2,1.0
1955,75,69,207,276,2,1.0
1956,75,38,92,130,2,1.0
1957,75,41,100,141,2,1.0
1958,75,14,23,37,2,1.0
1959,75,10,26,36,2,1.0
1960,75,19,40,59,2,1.0
1961,75,31,52,83,2,1.0
1962,75,12,29,41,2,1.0
1963,75,11,31,42,2,1.0
1964,75,14,18,32,2,1.0
1965,75,19,81,100,2,1.0
1966,75,36,103,139,2,1.0
1967,75,10,59,69,2,1.0
1968,75,19,16,35,2,1.0
1969,75,8,48,56,2,1.0
1970,75,10,43,53,2,1.0
1971,75,45,101,146,2,1.0
1972,75,9,16,25,2,1.0
1973,75,17,34,51,2,1.0
1974,75,26,53,79,2,1.0
1975,75,69,109,178,2,1.0
1976,75,14,23,37,2,1.0
1977,75,20,53,73,2,1.0
1978,75,21,47,68,2,1.0
1979,75,12,8,20,2,1.0
1980,75,15,29,44,2,1.0
1981,75,30,44,74,2,1.0
1982,75,15,46,61,2,1.0
1983,75,36,51,87,2,1.0
1984,75,8,14,22,2,1.0
1985,75,91,154,245,2,1.0
1986,75,56,157,213,2,1.0
1987,75,11,25,36,2,1.0
1988,75,35,53,88,2,1.0
1989,75,47,89,136,2,1.0
1990,75,29,47,76,2,1.0
1991,75,11,30,41,2,1.0
1992,75,44,85,129,2,1.0
1993,75,15,43,58,2,1.0
1994,75,1,12,13,2,1.0
1995,75,12,31,43,2,1.0
1996,75,34,38,72,2,1.0
1997,75,24,58,82,2,1.0
1998,75,20,49,69,2,1.0
1999,75,43,80,123,2,1.0
2000,75,33,58,91,2,1.0
2001,75,16,45,61,2,1.0
2002,75,18,35,53,2,1.0
2003,75,3,70,73,2,1.0
2004,75,24,55,79,2,1.0
2005,75,77,140,217,2,1.0
2006,75,25,78,103,2,1.0
2007,75,58,120,178,2,1.0
2008,75,14,97,111,2,1.0
2009,75,25,45,70,2,1.0
2010,75,39,129,168,2,1.0
2011,75,38,64,102,2,1.0
2012,75,30,17,47,2,1.0
2013,75,39,66,105,2,1.0
2014,75,6,19,25,2,1.0
2015,75,34,86,120,2,1.0
2016,75,23,46,69,2,1.0
2017,75,46,119,165,2,1.0
2018,75,24,51,75,2,1.0
2019,75,23,84,107,2,1.0
2020,75,16,48,64,2,1.0
2021,75,16,49,65,2,1.0
2022,75,11,17,28,2,1.0
2023,75,71,186,257,2,1.0
2024,75,66,142,208,2,1.0
2025,75,30,69,99,2,1.0
2026,75,43,98,141,2,1.0
2027,75,49,137,186,2,1.0
2028,75,64,192,256,2,1.0
2029,75,11,19,30,2,1.0
2030,75,29,63,92,2,1.0
2031,75,106,221,327,2,1.0
2032,75,22,75,97,2,1.0
2033,75,94,186,280,2,1.0
2034,75,4,22,26,2,1.0
2035,75,35,52,87,2,1.0
2036,75,60,130,190,2,1.0
2037,75,75,77,152,2,1.0
2038,75,51,216,267,2,1.0
2039,75,34,83,117,2,1.0
2040,75,39,116,155,2,1.0
2041,75,3,15,18,2,1.0
2042,75,16,35,51,2,1.0
2043,75,10,15,25,2,1.0
2044,75,16,26,42,2,1.0
2045,75,8,9,17,2,1.0
2046,75,8,16,24,2,1.0
2047,75,69,106,175,2,1.0
2048,75,82,159,241,2,1.0
2049,75,25,62,87,2,1.0
2050,75,12,22,34,2,1.0
2051,75,32,139,171,2,1.0
2052,75,12,10,22,2,1.0
2053,75,58,98,156,2,1.0
2054,75,87,241,328,2,1.0
2055,75,69,158,227,2,1.0
2056,75,124,140,264,2,1.0
2057,75,30,106,136,2,1.0
2058,75,15,53,68,2,1.0
2059,75,11,5,16,2,1.0
2060,75,12,36,48,2,1.0
2061,75,11,47,58,2,1.0
2062,75,7,29,36,2,1.0
2063,75,41,74,115,2,1.0
2064,75,17,34,51,2,1.0
2065,75,26,98,124,2,1.0
2066,75,18,65,83,2,1.0
2067,75,38,103,141,2,1.0
2068,75,23,46,69,2,1.0
2069,75,6,10,16,2,1.0
2070,75,18,57,75,2,1.0
2071,75,7,19,26,2,1.0
2072,75,18,43,61,2,1.0
2073,75,10,10,20,2,1.0
2074,75,4,6,10,2,1.0
2075,75,13,30,43,2,1.0
2076,75,96,172,268,2,1.0
2077,75,31,51,82,2,1.0
2078,75,24,45,69,2,1.0
2079,75,13,44,57,2,1.0
2080,75,17,35,52,2,1.0
2081,75,10,78,88,2,1.0
2082,75,17,80,97,2,1.0
2083,75,27,88,115,2,1.0
2084,75,12,29,41,2,1.0
2085,75,13,36,49,2,1.0
2086,75,30,32,62,2,1.0
2087,75,1,4,5,2,1.0
2088,75,8,2,10,2,1.0
2089,75,17,45,62,2,1.0
2090,75,20,66,86,2,1.0
2091,75,16,39,55,2,1.0
2092,75,9,33,42,2,1.0
2093,75,21,43,64,2,1.0
2094,75,18,13,31,2,1.0
2095,75,13,53,66,2,1.0
2096,75,77,126,203,2,1.0
2097,75,18,45,63,2,1.0
2098,75,14,48,62,2,1.0
2099,75,52,101,153,2,1.0
2100,75,57,99,156,2,1.0
2101,75,18,27,45,2,1.0
2102,75,27,34,61,2,1.0
2103,75,28,112,140,2,1.0
2104,75,0,12,12,2,1.0
2105,75,46,90,136,2,1.0
2106,75,16,52,68,2,1.0
2107,75,22,68,90,2,1.0
2108,75,51,146,197,2,1.0
2109,75,9,24,33,2,1.0
2110,75,30,77,107,2,1.0
2111,75,20,40,60,2,1.0
2112,75,13,19,32,2,1.0
2113,75,17,66,83,2,1.0
2114,75,27,126,153,2,1.0
2115,75,12,72,84,2,10.0
2116,75,19,42,61,2,10.0
2117,75,105,112,217,2,10.0
2118,75,25,78,103,2,10.0
2119,75,146,135,281,2,10.0
2120,75,114,103,217,2,10.0
2121,75,63,114,177,2,10.0
2122,75,33,68,101,2,10.0
2123,75,73,106,179,2,10.0
2124,75,77,158,235,2,10.0
2125,75,41,100,141,2,10.0
2126,75,44,63,107,2,10.0
2127,75,42,94,136,2,10.0
2128,75,53,229,282,2,10.0
2129,75,41,124,165,2,10.0
2130,75,53,200,253,2,10.0
2131,75,54,173,227,2,10.0
2132,75,287,746,1033,2,10.0
2133,75,77,111,188,2,10.0
2134,75,92,177,269,2,10.0
2135,75,65,169,234,2,10.0
2136,75,29,95,124,2,10.0
2137,75,102,177,279,2,10.0
2138,75,51,96,147,2,10.0
2139,75,15,28,43,2,10.0
2140,75,39,75,114,2,10.0
2141,75,36,145,181,2,10.0
2142,75,45,84,129,2,10.0
2143,75,58,154,212,2,10.0
2144,75,118,201,319,2,10.0
2145,75,86,244,330,2,10.0
2146,75,131,254,385,2,10.0
2147,75,83,129,212,2,10.0
2148,75,65,93,158,2,10.0
2149,75,10,6,16,2,10.0
2150,75,175,340,515,2,10.0
2151,75,62,88,150,2,10.0
2152,75,96,198,294,2,10.0
2153,75,251,596,847,2,10.0
2154,75,185,340,525,2,10.0
2155,75,52,114,166,2,10.0
2156,75,157,265,422,2,10.0
2157,75,75,146,221,2,10.0
2158,75,64,159,223,2,10.0
2159,75,100,236,336,2,10.0
2160,75,80,159,239,2,10.0
2161,75,159,305,464,2,10.0
2162,75,71,192,263,2,10.0
2163,75,28,120,148,2,10.0
2164,75,60,203,263,2,10.0
2165,75,58,95,153,2,10.0
2166,75,81,152,233,2,10.0
2167,75,61,185,246,2,10.0
2168,75,65,160,225,2,10.0
2169,75,32,184,216,2,10.0
2170,75,39,112,151,2,10.0
2171,75,80,203,283,2,10.0
2172,75,48,139,187,2,10.0
2173,75,85,163,248,2,10.0
2174,75,70,165,235,2,10.0
2175,75,40,105,145,2,10.0
2176,75,22,81,103,2,10.0
2177,75,46,161,207,2,10.0
2178,75,146,268,414,2,10.0
2179,75,29,53,82,2,10.0
2180,75,54,75,129,2,10.0
2181,75,149,238,387,2,10.0
2182,75,88,122,210,2,10.0
2183,75,84,200,284,2,10.0
2184,75,10,29,39,2,10.0
2185,75,67,227,294,2,10.0
2186,75,71,164,235,2,10.0
2187,75,52,138,190,2,10.0
2188,75,87,237,324,2,10.0
2189,75,53,146,199,2,10.0
2190,75,42,132,174,2,10.0
2191,75,4,10,14,2,10.0
2192,75,61,75,136,2,10.0
2193,75,42,114,156,2,10.0
2194,75,151,234,385,2,10.0
2195,75,31,110,141,2,10.0
2196,75,33,64,97,2,10.0
2197,75,25,58,83,2,10.0
2198,75,43,158,201,2,10.0
2199,75,92,162,254,2,10.0
2200,75,41,72,113,2,10.0
2201,75,65,167,232,2,10.0
2202,75,54,61,115,2,10.0
2203,75,74,173,247,2,10.0
2204,75,23,100,123,2,10.0
2205,75,55,139,194,2,10.0
2206,75,21,55,76,2,10.0
2207,75,14,18,32,2,10.0
2208,75,69,120,189,2,10.0
2209,75,23,58,81,2,10.0
2210,75,17,38,55,2,10.0
2211,75,27,35,62,2,10.0
2212,75,58,181,239,2,10.0
2213,75,75,162,237,2,10.0
2214,75,49,122,171,2,10.0
2215,75,50,129,179,2,10.0
2216,75,56,89,145,2,10.0
2217,75,73,136,209,2,10.0
2218,75,20,32,52,2,10.0
2219,75,44,62,106,2,10.0
2220,75,44,87,131,2,10.0
2221,75,39,72,111,2,10.0
2222,75,11,31,42,2,10.0
2223,75,33,56,89,2,10.0
2224,75,77,159,236,2,10.0
2225,75,33,102,135,2,10.0
2226,75,14,38,52,2,10.0
2227,75,21,34,55,2,10.0
2228,75,29,61,90,2,10.0
2229,75,70,159,229,2,10.0
2230,75,27,83,110,2,10.0
2231,75,34,78,112,2,10.0
2232,75,53,192,245,2,10.0
2233,75,8,18,26,2,10.0
2234,75,28,66,94,2,10.0
2235,75,63,165,228,2,10.0
2236,75,21,51,72,2,10.0
2237,75,74,125,199,2,10.0
2238,75,24,66,90,2,10.0
2239,75,150,283,433,2,10.0
2240,75,48,126,174,2,10.0
2241,75,123,234,357,2,10.0
2242,75,52,89,141,2,10.0
2243,75,58,155,213,2,10.0
2244,75,63,123,186,2,10.0
2245,75,24,53,77,2,10.0
2246,75,71,72,143,2,10.0
2247,75,53,73,126,2,10.0
2248,75,39,103,142,2,10.0
2249,75,154,240,394,2,10.0
2250,75,41,102,143,2,10.0
2251,75,40,49,89,2,10.0
2252,75,51,172,223,2,10.0
2253,75,99,174,273,2,10.0
2254,75,20,55,75,2,10.0
2255,75,46,87,133,2,10.0
2256,75,54,80,134,2,10.0
2257,75,68,164,232,2,10.0
2258,75,81,121,202,2,10.0
2259,75,54,184,238,2,10.0
2260,75,29,85,114,2,10.0
2261,75,28,60,88,2,10.0
2262,75,12,21,33,2,10.0
2263,75,69,148,217,2,10.0
2264,75,25,41,66,2,10.0
2265,75,87,151,238,2,10.0
2266,75,56,203,259,2,10.0
2267,75,48,129,177,2,10.0
2268,75,75,190,265,2,10.0
2269,75,93,193,286,2,10.0
2270,75,105,234,339,2,10.0
2271,75,163,292,455,2,10.0
2272,75,105,112,217,2,10.0
2273,75,58,89,147,2,10.0
2274,75,70,147,217,2,10.0
2275,75,37,87,124,2,10.0
2276,75,43,66,109,2,10.0
2277,75,44,114,158,2,10.0
2278,75,53,123,176,2,10.0
2279,75,4,24,28,2,10.0
2280,75,20,36,56,2,10.0
2281,75,11,30,41,2,10.0
2282,75,168,301,469,2,10.0
2283,75,42,112,154,2,10.0
2284,75,76,139,215,2,10.0
2285,75,38,73,111,2,10.0
2286,75,124,396,520,2,10.0
2287,75,58,154,212,2,10.0
2288,75,39,79,118,2,10.0
2289,75,41,130,171,2,10.0
2290,75,138,224,362,2,10.0
2291,75,43,118,161,2,10.0
2292,75,44,68,112,2,10.0
2293,75,19,47,66,2,10.0
2294,75,8,47,55,2,10.0
2295,75,26,59,85,2,10.0
2296,75,13,39,52,2,10.0
2297,75,78,140,218,2,10.0
2298,75,27,44,71,2,10.0
2299,75,10,13,23,2,10.0
2300,75,59,136,195,2,10.0
2301,75,67,211,278,2,10.0
2302,75,34,88,122,2,10.0
2303,75,54,148,202,2,10.0
2304,75,74,140,214,2,10.0
2305,75,68,163,231,2,10.0
2306,75,45,137,182,2,10.0
2307,75,52,83,135,2,10.0
2308,75,34,83,117,2,10.0
2309,75,112,151,263,2,10.0
2310,75,15,58,73,2,10.0
2311,75,51,142,193,2,10.0
2312,75,10,27,37,2,10.0
2313,75,6,18,24,2,10.0
2314,75,26,37,63,2,10.0
2315,75,209,422,631,2,10.0
2316,75,120,196,316,2,10.0
2317,75,69,159,228,2,10.0
2318,75,33,122,155,2,10.0
2319,75,220,359,579,2,10.0
2320,75,127,333,460,2,10.0
2321,75,154,220,374,2,10.0
2322,75,41,65,106,2,10.0
2323,75,60,120,180,2,10.0
2324,75,13,49,62,2,10.0
2325,75,56,127,183,2,10.0
2326,75,43,81,124,2,10.0
2327,75,24,72,96,2,10.0
2328,75,51,109,160,2,10.0
2329,75,37,97,134,2,10.0
2330,75,96,194,290,2,10.0
2331,75,103,176,279,2,10.0
2332,75,89,171,260,2,10.0
2333,75,86,158,244,2,10.0
2334,75,69,68,137,2,10.0
2335,75,40,91,131,2,10.0
2336,75,56,88,144,2,10.0
2337,75,174,222,396,2,10.0
2338,75,79,96,175,2,10.0
2339,75,35,78,113,2,10.0
2340,75,18,51,69,2,10.0
2341,75,55,191,246,2,10.0
2342,75,95,182,277,2,10.0
2343,75,54,59,113,2,10.0
2344,75,19,89,108,2,10.0
2345,75,115,210,325,2,10.0
2346,75,228,525,753,2,10.0
2347,75,67,134,201,2,10.0
2348,75,89,153,242,2,10.0
2349,75,63,124,187,2,10.0
2350,75,139,155,294,2,10.0
2351,75,112,206,318,2,10.0
2352,75,74,114,188,2,10.0
2353,75,150,211,361,2,10.0
2354,75,335,645,980,2,10.0
2355,75,148,296,444,2,10.0
2356,75,30,91,121,2,10.0
2357,75,46,52,98,2,10.0
2358,75,77,132,209,2,10.0
2359,75,75,132,207,2,10.0
2360,75,55,118,173,2,10.0
2361,75,96,177,273,2,10.0
2362,75,85,166,251,2,10.0
2363,75,102,172,274,2,10.0
2364,75,97,141,238,2,10.0
2365,75,47,103,150,2,10.0
2366,75,51,72,123,2,10.0
2367,75,13,45,58,2,10.0
2368,75,34,73,107,2,10.0
2369,75,12,37,49,2,10.0
2370,75,58,213,271,2,10.0
2371,75,22,55,77,2,10.0
2372,75,82,196,278,2,10.0
2373,75,45,58,103,2,10.0
2374,75,25,29,54,2,10.0
2375,75,54,77,131,2,10.0
2376,75,84,144,228,2,10.0
2377,75,56,81,137,2,10.0
2378,75,66,122,188,2,10.0
2379,75,51,98,149,2,10.0
2380,75,22,39,61,2,10.0
2381,75,16,46,62,2,10.0
2382,75,1,6,7,2,10.0
2383,75,40,53,93,2,10.0
2384,75,70,130,200,2,10.0
2385,75,80,124,204,2,10.0
2386,75,147,208,355,2,10.0
2387,75,79,153,232,2,10.0
2388,75,80,183,263,2,10.0
2389,75,119,208,327,2,10.0
2390,75,78,125,203,2,10.0
2391,75,70,127,197,2,10.0
2392,75,26,52,78,2,10.0
2393,75,101,167,268,2,10.0
2394,75,54,115,169,2,10.0
2395,75,53,97,150,2,10.0
2396,75,18,34,52,2,10.0
2397,75,93,114,207,2,10.0
2398,75,20,70,90,2,10.0
2399,75,39,109,148,2,10.0
2400,75,68,163,231,2,10.0
2401,75,28,62,90,2,10.0
2402,75,55,98,153,2,10.0
2403,75,174,313,487,2,10.0
2404,75,63,148,211,2,10.0
2405,75,68,73,141,2,10.0
2406,75,25,125,150,2,10.0
2407,75,17,94,111,2,10.0
2408,75,47,114,161,2,10.0
2409,75,33,24,57,2,10.0
2410,75,22,56,78,2,10.0
2411,75,30,42,72,2,10.0
2412,75,29,63,92,2,10.0
2413,75,36,116,152,2,10.0
2414,75,71,120,191,2,10.0
2415,75,77,144,221,2,10.0
2416,75,53,122,175,2,10.0
2417,75,80,112,192,2,10.0
2418,75,85,137,222,2,10.0
2419,75,23,51,74,2,10.0
2420,75,20,43,63,2,10.0
2421,75,58,88,146,2,10.0
2422,75,15,29,44,2,10.0
2423,75,34,59,93,2,10.0
2424,75,67,93,160,2,10.0
2425,75,29,24,53,2,10.0
2426,75,25,55,80,2,10.0
2427,75,32,38,70,2,10.0
2428,75,71,119,190,2,10.0
2429,75,81,132,213,2,10.0
2430,75,66,160,226,2,10.0
2431,75,132,317,449,2,10.0
2432,75,37,161,198,2,10.0
2433,75,55,145,200,2,10.0
2434,75,116,219,335,2,10.0
2435,75,108,88,196,2,10.0
2436,75,57,150,207,2,10.0
2437,75,113,246,359,2,10.0
2438,75,118,235,353,2,10.0
2439,75,101,191,292,2,10.0
2440,75,36,82,118,2,10.0
2441,75,37,96,133,2,10.0
2442,75,43,116,159,2,10.0
2443,75,32,69,101,2,10.0
2444,75,71,149,220,2,10.0
2445,75,144,225,369,2,10.0
2446,75,108,288,396,2,10.0
2447,75,90,183,273,2,10.0
2448,75,109,252,361,2,10.0
2449,75,58,138,196,2,10.0
2450,75,23,27,50,2,10.0
2451,75,97,175,272,2,10.0
2452,75,25,64,89,2,10.0
2453,75,56,85,141,2,10.0
2454,75,22,65,87,2,10.0
2455,75,96,86,182,2,10.0
2456,75,50,111,161,2,10.0
2457,75,55,125,180,2,10.0
2458,75,78,92,170,2,10.0
2459,75,60,93,153,2,10.0
2460,75,45,164,209,2,10.0
2461,75,69,157,226,2,10.0
2462,75,20,74,94,2,10.0
2463,75,106,237,343,2,10.0
2464,75,139,232,371,2,10.0
2465,75,20,94,114,2,10.0
2466,75,20,40,60,2,10.0
2467,75,34,103,137,2,10.0
2468,75,7,29,36,2,10.0
2469,75,81,178,259,2,10.0
2470,75,165,348,513,2,10.0
2471,75,103,271,374,2,10.0
2472,75,131,350,481,2,10.0
2473,75,171,531,702,2,10.0
2474,75,180,335,515,2,10.0
2475,75,135,417,552,2,10.0
2476,75,82,215,297,2,10.0
2477,75,47,101,148,2,10.0
2478,75,48,91,139,2,10.0
2479,75,22,77,99,2,10.0
2480,75,249,669,918,2,10.0
2481,75,96,366,462,2,10.0
2482,75,71,163,234,2,10.0
2483,75,32,100,132,2,10.0
2484,75,47,116,163,2,10.0
2485,75,99,170,269,2,10.0
2486,75,65,162,227,2,10.0
2487,75,36,92,128,2,10.0
2488,75,34,66,100,2,10.0
2489,75,72,141,213,2,10.0
2490,75,13,36,49,2,10.0
2491,75,169,307,476,2,10.0
2492,75,75,211,286,2,10.0
2493,75,85,159,244,2,10.0
2494,75,163,282,445,2,10.0
2495,75,181,539,720,2,10.0
2496,75,123,211,334,2,10.0
2497,75,109,297,406,2,10.0
2498,75,81,161,242,2,10.0
2499,75,69,125,194,2,10.0
2500,75,137,250,387,2,10.0
2501,75,149,175,324,2,10.0
2502,75,98,159,257,2,10.0
2503,75,45,65,110,2,10.0
2504,75,7,19,26,2,10.0
2505,75,24,50,74,2,10.0
2506,75,40,73,113,2,10.0
2507,75,12,54,66,2,10.0
2508,75,149,363,512,2,10.0
2509,75,32,112,144,2,10.0
2510,75,76,126,202,2,10.0
2511,75,100,198,298,2,10.0
2512,75,77,131,208,2,10.0
2513,75,119,367,486,2,10.0
2514,75,39,75,114,2,10.0
2515,75,72,164,236,2,10.0
2516,75,34,144,178,2,10.0
2517,75,76,245,321,2,10.0
2518,75,49,121,170,2,10.0
2519,75,81,164,245,2,10.0
2520,75,53,106,159,2,10.0
2521,75,9,28,37,2,10.0
2522,75,184,165,349,2,1000.0
2523,75,165,242,407,2,1000.0
2524,75,95,29,124,2,1000.0
2525,75,93,221,314,2,1000.0
2526,75,33,102,135,2,1000.0
2527,75,171,301,472,2,1000.0
2528,75,129,245,374,2,1000.0
2529,75,75,91,166,2,1000.0
2530,75,27,61,88,2,1000.0
2531,75,53,83,136,2,1000.0
2532,75,10,38,48,2,1000.0
2533,75,60,155,215,2,1000.0
2534,75,47,117,164,2,1000.0
2535,75,51,185,236,2,1000.0
2536,75,28,100,128,2,1000.0
2537,75,90,241,331,2,1000.0
2538,75,136,208,344,2,1000.0
2539,75,145,219,364,2,1000.0
2540,75,86,149,235,2,1000.0
2541,75,187,467,654,2,1000.0
2542,75,104,268,372,2,1000.0
2543,75,98,290,388,2,1000.0
2544,75,185,476,661,2,1000.0
2545,75,87,104,191,2,1000.0
2546,75,53,81,134,2,1000.0
2547,75,90,128,218,2,1000.0
2548,75,63,144,207,2,1000.0
2549,75,42,90,132,2,1000.0
2550,75,37,93,130,2,1000.0
2551,75,67,232,299,2,1000.0
2552,75,72,146,218,2,1000.0
2553,75,135,206,341,2,1000.0
2554,75,135,278,413,2,1000.0
2555,75,78,111,189,2,1000.0
2556,75,87,141,228,2,1000.0
2557,75,146,328,474,2,1000.0
2558,75,87,110,197,2,1000.0
2559,75,93,137,230,2,1000.0
2560,75,80,118,198,2,1000.0
2561,75,158,128,286,2,1000.0
2562,75,24,26,50,2,1000.0
2563,75,13,13,26,2,1000.0
2564,75,27,40,67,2,1000.0
2565,75,148,294,442,2,1000.0
2566,75,53,86,139,2,1000.0
2567,75,189,290,479,2,1000.0
2568,75,48,55,103,2,1000.0
2569,75,20,131,151,2,1000.0
2570,75,108,200,308,2,1000.0
2571,75,69,88,157,2,1000.0
2572,75,142,320,462,2,1000.0
2573,75,46,88,134,2,1000.0
2574,75,43,98,141,2,1000.0
2575,75,58,110,168,2,1000.0
2576,75,55,170,225,2,1000.0
2577,75,214,526,740,2,1000.0
2578,75,19,159,178,2,1000.0
2579,75,98,202,300,2,1000.0
2580,75,264,655,919,2,1000.0
2581,75,105,185,290,2,1000.0
2582,75,140,255,395,2,1000.0
2583,75,80,107,187,2,1000.0
2584,75,72,231,303,2,1000.0
2585,75,183,402,585,2,1000.0
2586,75,50,116,166,2,1000.0
2587,75,83,128,211,2,1000.0
2588,75,115,240,355,2,1000.0
2589,75,72,168,240,2,1000.0
2590,75,34,95,129,2,1000.0
2591,75,24,61,85,2,1000.0
2592,75,38,117,155,2,1000.0
2593,75,9,31,40,2,1000.0
2594,75,67,104,171,2,1000.0
2595,75,106,144,250,2,1000.0
2596,75,78,83,161,2,1000.0
2597,75,91,188,279,2,1000.0
2598,75,89,110,199,2,1000.0
2599,75,210,365,575,2,1000.0
2600,75,115,229,344,2,1000.0
2601,75,152,249,401,2,1000.0
2602,75,51,122,173,2,1000.0
2603,75,101,218,319,2,1000.0
2604,75,110,183,293,2,1000.0
2605,75,110,216,326,2,1000.0
2606,75,159,192,351,2,1000.0
2607,75,139,215,354,2,1000.0
2608,75,117,222,339,2,1000.0
2609,75,177,337,514,2,1000.0
2610,75,79,156,235,2,1000.0
2611,75,20,53,73,2,1000.0
2612,75,132,225,357,2,1000.0
2613,75,131,279,410,2,1000.0
2614,75,123,239,362,2,1000.0
2615,75,108,282,390,2,1000.0
2616,75,149,315,464,2,1000.0
2617,75,84,174,258,2,1000.0
2618,75,85,106,191,2,1000.0
2619,75,68,103,171,2,1000.0
2620,75,43,97,140,2,1000.0
2621,75,98,118,216,2,1000.0
2622,75,88,167,255,2,1000.0
2623,75,70,118,188,2,1000.0
2624,75,112,161,273,2,1000.0
2625,75,39,57,96,2,1000.0
2626,75,51,88,139,2,1000.0
2627,75,19,49,68,2,1000.0
2628,75,94,106,200,2,1000.0
2629,75,56,163,219,2,1000.0
2630,75,202,287,489,2,1000.0
2631,75,97,177,274,2,1000.0
2632,75,80,263,343,2,1000.0
2633,75,118,168,286,2,1000.0
2634,75,194,292,486,2,1000.0
2635,75,109,173,282,2,1000.0
2636,75,89,190,279,2,1000.0
2637,75,39,30,69,2,1000.0
2638,75,64,132,196,2,1000.0
2639,75,242,714,956,2,1000.0
2640,75,186,613,799,2,1000.0
2641,75,168,390,558,2,1000.0
2642,75,77,165,242,2,1000.0
2643,75,121,209,330,2,1000.0
2644,75,29,77,106,2,1000.0
2645,75,56,222,278,2,1000.0
2646,75,142,312,454,2,1000.0
2647,75,128,224,352,2,1000.0
2648,75,60,194,254,2,1000.0
2649,75,25,74,99,2,1000.0
2650,75,171,303,474,2,1000.0
2651,75,121,194,315,2,1000.0
2652,75,33,54,87,2,1000.0
2653,75,139,260,399,2,1000.0
2654,75,75,99,174,2,1000.0
2655,75,92,161,253,2,1000.0
2656,75,75,200,275,2,1000.0
2657,75,67,151,218,2,1000.0
2658,75,213,564,777,2,1000.0
2659,75,304,574,878,2,1000.0
2660,75,42,89,131,2,1000.0
2661,75,139,266,405,2,1000.0
2662,75,25,33,58,2,1000.0
2663,75,65,141,206,2,1000.0
2664,75,205,435,640,2,1000.0
2665,75,127,303,430,2,1000.0
2666,75,85,154,239,2,1000.0
2667,75,114,290,404,2,1000.0
2668,75,108,266,374,2,1000.0
2669,75,92,219,311,2,1000.0
2670,75,88,191,279,2,1000.0
2671,75,154,299,453,2,1000.0
2672,75,129,181,310,2,1000.0
2673,75,100,212,312,2,1000.0
2674,75,183,270,453,2,1000.0
2675,75,63,217,280,2,1000.0
2676,75,89,158,247,2,1000.0
2677,75,84,111,195,2,1000.0
2678,75,110,163,273,2,1000.0
2679,75,65,104,169,2,1000.0
2680,75,77,231,308,2,1000.0
2681,75,116,306,422,2,1000.0
2682,75,217,406,623,2,1000.0
2683,75,69,101,170,2,1000.0
2684,75,26,119,145,2,1000.0
2685,75,119,279,398,2,1000.0
2686,75,84,153,237,2,1000.0
2687,75,167,411,578,2,1000.0
2688,75,111,272,383,2,1000.0
2689,75,281,428,709,2,1000.0
2690,75,120,165,285,2,1000.0
2691,75,99,252,351,2,1000.0
2692,75,135,246,381,2,1000.0
2693,75,91,170,261,2,1000.0
2694,75,122,211,333,2,1000.0
2695,75,35,126,161,2,1000.0
2696,75,56,125,181,2,1000.0
2697,75,108,178,286,2,1000.0
2698,75,78,101,179,2,1000.0
2699,75,68,124,192,2,1000.0
2700,75,88,143,231,2,1000.0
2701,75,47,95,142,2,1000.0
2702,75,143,341,484,2,1000.0
2703,75,26,79,105,2,1000.0
2704,75,33,57,90,2,1000.0
2705,75,59,120,179,2,1000.0
2706,75,94,109,203,2,1000.0
2707,75,54,125,179,2,1000.0
2708,75,91,215,306,2,1000.0
2709,75,46,23,69,2,1000.0
2710,75,55,76,131,2,1000.0
2711,75,160,333,493,2,1000.0
2712,75,168,261,429,2,1000.0
2713,75,12,39,51,2,1000.0
2714,75,104,224,328,2,1000.0
2715,75,86,163,249,2,1000.0
2716,75,43,54,97,2,1000.0
2717,75,70,171,241,2,1000.0
2718,75,109,143,252,2,1000.0
2719,75,118,150,268,2,1000.0
2720,75,55,71,126,2,1000.0
2721,75,104,244,348,2,1000.0
2722,75,70,188,258,2,1000.0
2723,75,88,183,271,2,1000.0
2724,75,39,116,155,2,1000.0
2725,75,45,58,103,2,1000.0
2726,75,38,76,114,2,1000.0
2727,75,95,178,273,2,1000.0
2728,75,57,115,172,2,1000.0
2729,75,15,33,48,2,1000.0
2730,75,65,105,170,2,1000.0
2731,75,48,93,141,2,1000.0
2732,75,109,312,421,2,1000.0
2733,75,89,136,225,2,1000.0
2734,75,55,131,186,2,1000.0
2735,75,54,80,134,2,1000.0
2736,75,170,190,360,2,1000.0
2737,75,309,600,909,2,1000.0
2738,75,167,272,439,2,1000.0
2739,75,50,123,173,2,1000.0
2740,75,150,235,385,2,1000.0
2741,75,108,165,273,2,1000.0
2742,75,134,247,381,2,1000.0
2743,75,74,128,202,2,1000.0
2744,75,6,20,26,2,1000.0
2745,75,149,286,435,2,1000.0
2746,75,102,259,361,2,1000.0
2747,75,64,166,230,2,1000.0
2748,75,86,184,270,2,1000.0
2749,75,121,158,279,2,1000.0
2750,75,72,204,276,2,1000.0
2751,75,94,156,250,2,1000.0
2752,75,103,258,361,2,1000.0
2753,75,71,95,166,2,1000.0
2754,75,102,168,270,2,1000.0
2755,75,62,220,282,2,1000.0
2756,75,92,191,283,2,1000.0
2757,75,31,66,97,2,1000.0
2758,75,42,134,176,2,1000.0
2759,75,120,231,351,2,1000.0
2760,75,117,232,349,2,1000.0
2761,75,137,186,323,2,1000.0
2762,75,128,231,359,2,1000.0
2763,75,75,168,243,2,1000.0
2764,75,175,313,488,2,1000.0
2765,75,137,244,381,2,1000.0
2766,75,111,203,314,2,1000.0
2767,75,70,138,208,2,1000.0
2768,75,14,20,34,2,1000.0
2769,75,58,62,120,2,1000.0
2770,75,156,509,665,2,1000.0
2771,75,68,162,230,2,1000.0
2772,75,132,236,368,2,1000.0
2773,75,153,282,435,2,1000.0
2774,75,196,362,558,2,1000.0
2775,75,92,255,347,2,1000.0
2776,75,23,100,123,2,1000.0
2777,75,109,236,345,2,1000.0
2778,75,27,58,85,2,1000.0
2779,75,100,210,310,2,1000.0
2780,75,49,126,175,2,1000.0
2781,75,171,327,498,2,1000.0
2782,75,48,85,133,2,1000.0
2783,75,173,361,534,2,1000.0
2784,75,137,415,552,2,1000.0
2785,75,76,217,293,2,1000.0
2786,75,92,225,317,2,1000.0
2787,75,99,272,371,2,1000.0
2788,75,125,239,364,2,1000.0
2789,75,226,336,562,2,1000.0
2790,75,122,273,395,2,1000.0
2791,75,124,224,348,2,1000.0
2792,75,158,178,336,2,1000.0
2793,75,146,338,484,2,1000.0
2794,75,141,229,370,2,1000.0
2795,75,194,321,515,2,1000.0
2796,75,113,254,367,2,1000.0
2797,75,259,357,616,2,1000.0
2798,75,161,307,468,2,1000.0
2799,75,218,369,587,2,1000.0
2800,75,97,235,332,2,1000.0
2801,75,104,323,427,2,1000.0
2802,75,180,326,506,2,1000.0
2803,75,54,157,211,2,1000.0
2804,75,75,197,272,2,1000.0
2805,75,85,215,300,2,1000.0
2806,75,26,85,111,2,1000.0
2807,75,128,266,394,2,1000.0
2808,75,182,329,511,2,1000.0
2809,75,90,220,310,2,1000.0
2810,75,135,339,474,2,1000.0
2811,75,43,129,172,2,1000.0
2812,75,68,177,245,2,1000.0
2813,75,84,226,310,2,1000.0
2814,75,32,58,90,2,1000.0
2815,75,118,207,325,2,1000.0
2816,75,75,167,242,2,1000.0
2817,75,150,315,465,2,1000.0
2818,75,137,180,317,2,1000.0
2819,75,54,100,154,2,1000.0
2820,75,93,191,284,2,1000.0
2821,75,123,209,332,2,1000.0
2822,75,112,54,166,2,1000.0
2823,75,164,313,477,2,1000.0
2824,75,105,346,451,2,1000.0
2825,75,151,356,507,2,1000.0
2826,75,242,624,866,2,1000.0
2827,75,84,256,340,2,1000.0
2828,75,145,382,527,2,1000.0
2829,75,66,196,262,2,1000.0
2830,75,53,217,270,2,1000.0
2831,75,61,144,205,2,1000.0
2832,75,183,309,492,2,1000.0
2833,75,93,158,251,2,1000.0
2834,75,89,251,340,2,1000.0
2835,75,155,314,469,2,1000.0
2836,75,144,365,509,2,1000.0
2837,75,117,327,444,2,1000.0
2838,75,94,241,335,2,1000.0
2839,75,177,310,487,2,1000.0
2840,75,92,238,330,2,1000.0
2841,75,51,152,203,2,1000.0
2842,75,26,39,65,2,1000.0
2843,75,133,153,286,2,1000.0
2844,75,49,159,208,2,1000.0
2845,75,58,134,192,2,1000.0
2846,75,104,186,290,2,1000.0
2847,75,85,210,295,2,1000.0
2848,75,138,348,486,2,1000.0
2849,75,77,196,273,2,1000.0
2850,75,162,423,585,2,1000.0
2851,75,92,273,365,2,1000.0
2852,75,6,43,49,2,1000.0
2853,75,59,222,281,2,1000.0
2854,75,60,205,265,2,1000.0
2855,75,67,113,180,2,1000.0
2856,75,42,143,185,2,1000.0
2857,75,89,184,273,2,1000.0
2858,75,37,213,250,2,1000.0
2859,75,120,264,384,2,1000.0
2860,75,5,23,28,2,1000.0
2861,75,81,167,248,2,1000.0
2862,75,62,120,182,2,1000.0
2863,75,116,140,256,2,1000.0
2864,75,79,124,203,2,1000.0
2865,75,91,151,242,2,1000.0
2866,75,62,134,196,2,1000.0
2867,75,72,103,175,2,1000.0
2868,75,63,135,198,2,1000.0
2869,75,93,202,295,2,1000.0
2870,75,73,118,191,2,1000.0
2871,75,42,88,130,2,1000.0
2872,75,89,163,252,2,1000.0
2873,75,100,326,426,2,1000.0
2874,75,130,259,389,2,1000.0
2875,75,203,289,492,2,1000.0
2876,75,53,97,150,2,1000.0
2877,75,68,145,213,2,1000.0
2878,75,74,211,285,2,1000.0
2879,75,38,111,149,2,1000.0
2880,75,131,270,401,2,1000.0
2881,75,136,241,377,2,1000.0
2882,75,106,172,278,2,1000.0
2883,75,87,239,326,2,1000.0
2884,75,243,535,778,2,1000.0
2885,75,78,162,240,2,1000.0
2886,75,158,254,412,2,1000.0
2887,75,128,176,304,2,1000.0
2888,75,208,339,547,2,1000.0
2889,75,67,93,160,2,1000.0
2890,75,78,136,214,2,1000.0
2891,75,151,275,426,2,1000.0
2892,75,119,304,423,2,1000.0
2893,75,41,99,140,2,1000.0
2894,75,34,37,71,2,1000.0
2895,75,116,262,378,2,1000.0
2896,75,42,79,121,2,1000.0
2897,75,42,109,151,2,1000.0
2898,75,83,148,231,2,1000.0
2899,75,174,293,467,2,1000.0
2900,75,165,324,489,2,1000.0
2901,75,171,254,425,2,1000.0
2902,75,110,288,398,2,1000.0
2903,75,203,455,658,2,1000.0
2904,75,76,135,211,2,1000.0
2905,75,187,331,518,2,1000.0
2906,75,88,221,309,2,1000.0
2907,75,77,125,202,2,1000.0
2908,75,51,98,149,2,10000.0
2909,75,115,232,347,2,10000.0
2910,75,32,120,152,2,10000.0
2911,75,167,265,432,2,10000.0
2912,75,58,189,247,2,10000.0
2913,75,109,223,332,2,10000.0
2914,75,127,169,296,2,10000.0
2915,75,127,198,325,2,10000.0
2916,75,54,156,210,2,10000.0
2917,75,65,85,150,2,10000.0
2918,75,45,61,106,2,10000.0
2919,75,74,78,152,2,10000.0
2920,75,36,57,93,2,10000.0
2921,75,57,136,193,2,10000.0
2922,75,90,208,298,2,10000.0
2923,75,95,253,348,2,10000.0
2924,75,103,170,273,2,10000.0
2925,75,123,279,402,2,10000.0
2926,75,109,163,272,2,10000.0
2927,75,76,252,328,2,10000.0
2928,75,123,218,341,2,10000.0
2929,75,30,89,119,2,10000.0
2930,75,74,121,195,2,10000.0
2931,75,60,96,156,2,10000.0
2932,75,68,133,201,2,10000.0
2933,75,60,93,153,2,10000.0
2934,75,27,52,79,2,10000.0
2935,75,23,29,52,2,10000.0
2936,75,72,87,159,2,10000.0
2937,75,92,225,317,2,10000.0
2938,75,88,153,241,2,10000.0
2939,75,32,111,143,2,10000.0
2940,75,88,89,177,2,10000.0
2941,75,36,122,158,2,10000.0
2942,75,46,114,160,2,10000.0
2943,75,74,224,298,2,10000.0
2944,75,102,224,326,2,10000.0
2945,75,152,281,433,2,10000.0
2946,75,48,97,145,2,10000.0
2947,75,131,305,436,2,10000.0
2948,75,22,67,89,2,10000.0
2949,75,135,311,446,2,10000.0
2950,75,70,140,210,2,10000.0
2951,75,96,244,340,2,10000.0
2952,75,47,95,142,2,10000.0
2953,75,9,108,117,2,10000.0
2954,75,42,88,130,2,10000.0
2955,75,116,221,337,2,10000.0
2956,75,78,168,246,2,10000.0
2957,75,35,79,114,2,10000.0
2958,75,35,102,137,2,10000.0
2959,75,30,97,127,2,10000.0
2960,75,93,170,263,2,10000.0
2961,75,63,161,224,2,10000.0
2962,75,69,107,176,2,10000.0
2963,75,74,144,218,2,10000.0
2964,75,8,48,56,2,10000.0
2965,75,73,170,243,2,10000.0
2966,75,32,52,84,2,10000.0
2967,75,61,176,237,2,10000.0
2968,75,193,388,581,2,10000.0
2969,75,64,135,199,2,10000.0
2970,75,46,126,172,2,10000.0
2971,75,151,282,433,2,10000.0
2972,75,14,44,58,2,10000.0
2973,75,15,44,59,2,10000.0
2974,75,49,158,207,2,10000.0
2975,75,38,93,131,2,10000.0
2976,75,6,96,102,2,10000.0
2977,75,31,155,186,2,10000.0
2978,75,64,133,197,2,10000.0
2979,75,53,138,191,2,10000.0
2980,75,79,153,232,2,10000.0
2981,75,137,352,489,2,10000.0
2982,75,27,95,122,2,10000.0
2983,75,162,234,396,2,10000.0
2984,75,111,222,333,2,10000.0
2985,75,82,241,323,2,10000.0
2986,75,54,186,240,2,10000.0
2987,75,44,133,177,2,10000.0
2988,75,59,167,226,2,10000.0
2989,75,96,281,377,2,10000.0
2990,75,102,154,256,2,10000.0
2991,75,57,122,179,2,10000.0
2992,75,34,94,128,2,10000.0
2993,75,33,109,142,2,10000.0
2994,75,63,143,206,2,10000.0
2995,75,10,37,47,2,10000.0
2996,75,83,163,246,2,10000.0
2997,75,74,158,232,2,10000.0
2998,75,36,89,125,2,10000.0
2999,75,18,28,46,2,10000.0
3000,75,113,293,406,2,10000.0
3001,75,83,219,302,2,10000.0
3002,75,79,139,218,2,10000.0
3003,75,130,259,389,2,10000.0
3004,75,56,153,209,2,10000.0
3005,75,84,189,273,2,10000.0
3006,75,32,72,104,2,10000.0
3007,75,36,94,130,2,10000.0
3008,75,106,209,315,2,10000.0
3009,75,113,236,349,2,10000.0
3010,75,38,84,122,2,10000.0
3011,75,11,26,37,2,10000.0
3012,75,41,89,130,2,10000.0
3013,75,106,248,354,2,10000.0
3014,75,30,63,93,2,10000.0
3015,75,96,245,341,2,10000.0
3016,75,20,80,100,2,10000.0
3017,75,160,316,476,2,10000.0
3018,75,195,347,542,2,10000.0
3019,75,60,215,275,2,10000.0
3020,75,36,82,118,2,10000.0
3021,75,174,379,553,2,10000.0
3022,75,84,147,231,2,10000.0
3023,75,80,145,225,2,10000.0
3024,75,93,206,299,2,10000.0
3025,75,93,143,236,2,10000.0
3026,75,62,105,167,2,10000.0
3027,75,27,69,96,2,10000.0
3028,75,113,264,377,2,10000.0
3029,75,95,175,270,2,10000.0
3030,75,56,143,199,2,10000.0
3031,75,89,249,338,2,10000.0
3032,75,79,259,338,2,10000.0
3033,75,192,371,563,2,10000.0
3034,75,10,33,43,2,10000.0
3035,75,65,171,236,2,10000.0
3036,75,35,102,137,2,10000.0
3037,75,36,84,120,2,10000.0
3038,75,44,117,161,2,10000.0
3039,75,25,112,137,2,10000.0
3040,75,99,345,444,2,10000.0
3041,75,96,139,235,2,10000.0
3042,75,48,112,160,2,10000.0
3043,75,54,159,213,2,10000.0
3044,75,33,109,142,2,10000.0
3045,75,63,97,160,2,10000.0
3046,75,46,71,117,2,10000.0
3047,75,62,122,184,2,10000.0
3048,75,85,156,241,2,10000.0
3049,75,130,213,343,2,10000.0
3050,75,32,107,139,2,10000.0
3051,75,66,108,174,2,10000.0
3052,75,39,111,150,2,10000.0
3053,75,32,81,113,2,10000.0
3054,75,28,65,93,2,10000.0
3055,75,123,142,265,2,10000.0
3056,75,28,88,116,2,10000.0
3057,75,144,198,342,2,10000.0
3058,75,6,43,49,2,10000.0
3059,75,38,45,83,2,10000.0
3060,75,22,20,42,2,10000.0
3061,75,25,62,87,2,10000.0
3062,75,18,79,97,2,10000.0
3063,75,195,289,484,2,10000.0
3064,75,34,42,76,2,10000.0
3065,75,46,225,271,2,10000.0
3066,75,83,158,241,2,10000.0
3067,75,214,404,618,2,10000.0
3068,75,130,283,413,2,10000.0
3069,75,143,200,343,2,10000.0
3070,75,150,315,465,2,10000.0
3071,75,93,222,315,2,10000.0
3072,75,92,146,238,2,10000.0
3073,75,118,230,348,2,10000.0
3074,75,48,88,136,2,10000.0
3075,75,7,96,103,2,10000.0
3076,75,12,44,56,2,10000.0
3077,75,21,54,75,2,10000.0
3078,75,19,10,29,2,10000.0
3079,75,121,164,285,2,10000.0
3080,75,60,150,210,2,10000.0
3081,75,16,114,130,2,10000.0
3082,75,78,125,203,2,10000.0
3083,75,73,152,225,2,10000.0
3084,75,96,174,270,2,10000.0
3085,75,50,107,157,2,10000.0
3086,75,26,26,52,2,10000.0
3087,75,29,67,96,2,10000.0
3088,75,28,80,108,2,10000.0
3089,75,44,53,97,2,10000.0
3090,75,34,58,92,2,10000.0
3091,75,47,81,128,2,10000.0
3092,75,19,40,59,2,10000.0
3093,75,34,60,94,2,10000.0
3094,75,7,20,27,2,10000.0
3095,75,47,153,200,2,10000.0
3096,75,84,213,297,2,10000.0
3097,75,60,183,243,2,10000.0
3098,75,108,279,387,2,10000.0
3099,75,142,278,420,2,10000.0
3100,75,37,87,124,2,10000.0
3101,75,90,154,244,2,10000.0
3102,75,53,116,169,2,10000.0
3103,75,102,276,378,2,10000.0
3104,75,36,40,76,2,10000.0
3105,75,96,225,321,2,10000.0
3106,75,59,116,175,2,10000.0
3107,75,166,252,418,2,10000.0
3108,75,85,185,270,2,10000.0
3109,75,69,175,244,2,10000.0
3110,75,40,76,116,2,10000.0
3111,75,59,133,192,2,10000.0
3112,75,31,62,93,2,10000.0
3113,75,77,121,198,2,10000.0
3114,75,15,19,34,2,10000.0
3115,75,34,69,103,2,10000.0
3116,75,103,326,429,2,10000.0
3117,75,47,70,117,2,10000.0
3118,75,9,38,47,2,10000.0
3119,75,64,121,185,2,10000.0
3120,75,11,58,69,2,10000.0
3121,75,142,228,370,2,10000.0
3122,75,106,169,275,2,10000.0
3123,75,42,182,224,2,10000.0
3124,75,89,209,298,2,10000.0
3125,75,18,31,49,2,10000.0
3126,75,63,94,157,2,10000.0
3127,75,59,62,121,2,10000.0
3128,75,71,109,180,2,10000.0
3129,75,18,49,67,2,10000.0
3130,75,38,72,110,2,10000.0
3131,75,43,137,180,2,10000.0
3132,75,23,64,87,2,10000.0
3133,75,46,124,170,2,10000.0
3134,75,56,96,152,2,10000.0
3135,75,54,112,166,2,10000.0
3136,75,63,111,174,2,10000.0
3137,75,43,91,134,2,10000.0
3138,75,105,246,351,2,10000.0
3139,75,24,27,51,2,10000.0
3140,75,58,80,138,2,10000.0
3141,75,100,260,360,2,10000.0
3142,75,55,188,243,2,10000.0
3143,75,141,282,423,2,10000.0
3144,75,55,86,141,2,10000.0
3145,75,71,135,206,2,10000.0
3146,75,29,131,160,2,10000.0
3147,75,45,108,153,2,10000.0
3148,75,3,13,16,2,10000.0
3149,75,125,344,469,2,10000.0
3150,75,89,273,362,2,10000.0
3151,75,101,196,297,2,10000.0
3152,75,88,241,329,2,10000.0
3153,75,78,228,306,2,10000.0
3154,75,76,223,299,2,10000.0
3155,75,51,137,188,2,10000.0
3156,75,88,223,311,2,10000.0
3157,75,29,116,145,2,10000.0
3158,75,49,45,94,2,10000.0
3159,75,21,41,62,2,10000.0
3160,75,33,64,97,2,10000.0
3161,75,8,29,37,2,10000.0
3162,75,52,113,165,2,10000.0
3163,75,35,93,128,2,10000.0
3164,75,18,25,43,2,10000.0
3165,75,32,71,103,2,10000.0
3166,75,26,30,56,2,10000.0
3167,75,28,48,76,2,10000.0
3168,75,146,272,418,2,10000.0
3169,75,38,90,128,2,10000.0
3170,75,54,61,115,2,10000.0
3171,75,63,88,151,2,10000.0
3172,75,19,60,79,2,10000.0
3173,75,92,126,218,2,10000.0
3174,75,79,163,242,2,10000.0
3175,75,116,264,380,2,10000.0
3176,75,76,100,176,2,10000.0
3177,75,116,359,475,2,10000.0
3178,75,76,164,240,2,10000.0
3179,75,156,295,451,2,10000.0
3180,75,83,157,240,2,10000.0
3181,75,84,168,252,2,10000.0
3182,75,46,285,331,2,10000.0
3183,75,37,106,143,2,10000.0
3184,75,34,100,134,2,10000.0
3185,75,82,144,226,2,10000.0
3186,75,87,228,315,2,10000.0
3187,75,41,24,65,2,10000.0
3188,75,79,210,289,2,10000.0
3189,75,86,220,306,2,10000.0
3190,75,50,119,169,2,10000.0
3191,75,73,121,194,2,10000.0
3192,75,54,153,207,2,10000.0
3193,75,105,161,266,2,10000.0
3194,75,16,58,74,2,10000.0
3195,75,80,182,262,2,10000.0
3196,75,75,216,291,2,10000.0
3197,75,86,118,204,2,10000.0
3198,75,30,98,128,2,10000.0
3199,75,101,145,246,2,10000.0
3200,75,47,155,202,2,10000.0
3201,75,22,46,68,2,10000.0
3202,75,13,20,33,2,10000.0
3203,75,176,345,521,2,10000.0
3204,75,27,33,60,2,10000.0
3205,75,63,105,168,2,10000.0
3206,75,88,66,154,2,10000.0
3207,75,85,185,270,2,10000.0
3208,75,182,366,548,2,10000.0
3209,75,65,133,198,2,10000.0
3210,75,44,81,125,2,10000.0
3211,75,110,175,285,2,10000.0
3212,75,117,229,346,2,10000.0
3213,75,79,163,242,2,10000.0
3214,75,116,81,197,2,10000.0
3215,75,105,139,244,2,10000.0
3216,75,71,209,280,2,10000.0
3217,75,51,123,174,2,10000.0
3218,75,85,169,254,2,10000.0
3219,75,65,118,183,2,10000.0
3220,75,35,86,121,2,10000.0
3221,75,27,62,89,2,10000.0
3222,75,154,225,379,2,10000.0
3223,75,97,171,268,2,10000.0
3224,75,79,102,181,2,10000.0
3225,75,187,347,534,2,10000.0
3226,75,176,331,507,2,10000.0
3227,75,132,286,418,2,10000.0
3228,75,98,195,293,2,10000.0
3229,75,108,244,352,2,10000.0
3230,75,41,101,142,2,10000.0
3231,75,53,73,126,2,10000.0
3232,75,103,201,304,2,10000.0
3233,75,47,73,120,2,10000.0
3234,75,29,31,60,2,10000.0
3235,75,44,61,105,2,10000.0
3236,75,23,83,106,2,10000.0
3237,75,17,38,55,2,10000.0
3238,75,21,37,58,2,10000.0
3239,75,29,59,88,2,10000.0
3240,75,51,58,109,2,10000.0
3241,75,57,153,210,2,10000.0
3242,75,64,229,293,2,10000.0
3243,75,161,379,540,2,10000.0
3244,75,51,113,164,2,10000.0
3245,75,105,245,350,2,10000.0
3246,75,118,188,306,2,10000.0
3247,75,96,307,403,2,10000.0
3248,75,129,291,420,2,10000.0
3249,75,64,165,229,2,10000.0
3250,75,39,75,114,2,10000.0
3251,75,41,71,112,2,10000.0
3252,75,83,179,262,2,10000.0
3253,75,41,125,166,2,10000.0
3254,75,13,30,43,2,10000.0
3255,75,34,118,152,2,10000.0
3256,75,34,113,147,2,10000.0
3257,75,123,233,356,2,10000.0
3258,75,39,107,146,2,10000.0
3259,75,33,79,112,2,10000.0
3260,75,79,178,257,2,10000.0
3261,75,144,355,499,2,10000.0
3262,75,73,200,273,2,10000.0
3263,75,64,115,179,2,10000.0
3264,75,72,167,239,2,10000.0
3265,75,30,94,124,2,10000.0
3266,75,45,90,135,2,10000.0
3267,75,77,170,247,2,10000.0
3268,75,20,35,55,2,10000.0
3269,75,107,169,276,2,10000.0
3270,75,117,275,392,2,10000.0
3271,75,93,172,265,2,10000.0
3272,75,64,123,187,2,10000.0
3273,75,63,110,173,2,10000.0
3274,75,61,107,168,2,10000.0
3275,75,95,123,218,2,10000.0
3276,75,91,182,273,2,10000.0
3277,75,142,370,512,2,10000.0
3278,75,98,194,292,2,10000.0
3279,75,139,297,436,2,10000.0
3280,75,68,80,148,2,10000.0
3281,75,38,100,138,2,10000.0
3282,75,40,56,96,2,10000.0
3283,75,78,106,184,2,10000.0
3284,75,174,395,569,2,10000.0
3285,75,135,299,434,2,10000.0
3286,75,43,60,103,2,10000.0
3287,75,133,272,405,2,10000.0
3288,75,150,278,428,2,10000.0
3289,75,33,126,159,2,10000.0
3290,75,32,88,120,2,10000.0
3291,75,40,77,117,2,10000.0
3292,75,48,126,174,2,10000.0
3293,75,31,78,109,2,10000.0
3294,75,10,25,35,2,10000.0
3295,75,33,57,90,2,10000.0
3296,75,15,37,52,2,10000.0
3297,75,154,257,411,2,10000.0
3298,75,83,142,225,2,10000.0
3299,75,146,277,423,2,10000.0
3300,75,120,214,334,2,10000.0
3301,75,15,44,59,2,10000.0
3302,75,75,207,282,2,10000.0
3303,75,103,158,261,2,10000.0
3304,75,37,107,144,2,10000.0
3305,75,149,372,521,2,10000.0
3306,75,154,381,535,2,10000.0
3307,75,106,294,400,2,10000.0
3308,75,102,166,268,2,10000.0
3309,75,153,314,467,2,10000.0
3310,75,93,133,226,2,10000.0
3311,75,84,168,252,2,10000.0
3312,75,31,34,65,2,10000.0
3313,75,91,234,325,2,10000.0
3314,75,73,146,219,2,10000.0
3315,75,54,126,180,2,10000.0
3316,75,86,284,370,2,10000.0
3317,75,107,215,322,2,10000.0
3318,75,35,99,134,2,10000.0
3319,75,69,264,333,2,10000.0
3320,75,142,224,366,2,10000.0
3321,75,79,103,182,2,10000.0
3322,75,50,129,179,2,10000.0
3323,75,57,106,163,2,10000.0
3324,75,71,127,198,2,10000.0
3325,75,11,51,62,2,10000.0
3326,75,33,50,83,2,10000.0
3327,75,41,86,127,2,10000.0
3328,75,76,195,271,2,10000.0
3329,75,37,127,164,2,10000.0
3330,75,68,137,205,2,10000.0
3331,75,67,232,299,2,10000.0
3332,75,45,73,118,2,10000.0
3333,75,301,777,1078,2,10000.0
3334,75,78,164,242,2,10000.0
3335,75,74,238,312,2,10000.0
3336,75,77,194,271,2,10000.0
3337,75,42,72,114,2,10000.0
3338,75,41,93,134,2,10000.0
3339,75,55,111,166,2,10000.0
3340,75,131,208,339,2,10000.0
3341,75,104,180,284,2,10000.0
3342,75,79,152,231,2,10000.0
3343,75,293,615,908,2,10000.0
3344,75,114,291,405,2,10000.0
3345,75,106,181,287,2,10000.0
3346,75,75,138,213,2,10000.0
3347,75,63,134,197,2,10000.0
3348,75,83,256,339,2,10000.0
3349,75,33,59,92,2,10000.0
3350,75,46,164,210,2,10000.0
3351,75,33,75,108,2,10000.0
0,0,11,11,22,3,0.0
1,0,24,48,72,3,0.0
2,0,12,38,50,3,0.0
3,0,22,37,59,3,0.0
4,0,24,29,53,3,0.0
5,0,21,49,70,3,0.0
6,0,18,33,51,3,0.0
7,0,21,15,36,3,0.0
8,0,15,18,33,3,0.0
9,0,8,35,43,3,0.0
10,0,6,15,21,3,0.0
11,0,9,3,12,3,0.0
12,0,4,6,10,3,0.0
13,0,17,39,56,3,0.0
14,0,24,30,54,3,0.0
15,0,65,165,230,3,0.0
16,0,7,14,21,3,0.0
17,0,3,21,24,3,0.0
18,0,19,32,51,3,0.0
19,0,10,24,34,3,0.0
20,0,14,24,38,3,0.0
21,0,9,21,30,3,0.0
22,0,14,37,51,3,0.0
23,0,4,25,29,3,0.0
24,0,6,9,15,3,0.0
25,0,5,10,15,3,0.0
26,0,6,10,16,3,0.0
27,0,10,2,12,3,0.0
28,0,44,80,124,3,0.0
29,0,16,31,47,3,0.0
30,0,13,20,33,3,0.0
31,0,54,106,160,3,0.0
32,0,16,32,48,3,0.0
33,0,4,35,39,3,0.0
34,0,84,153,237,3,0.0
35,0,36,49,85,3,0.0
36,0,20,48,68,3,0.0
37,0,20,21,41,3,0.0
38,0,9,25,34,3,0.0
39,0,14,47,61,3,0.0
40,0,5,9,14,3,0.0
41,0,17,36,53,3,0.0
42,0,21,24,45,3,0.0
43,0,23,20,43,3,0.0
44,0,45,113,158,3,0.0
45,0,5,17,22,3,0.0
46,0,14,30,44,3,0.0
47,0,11,24,35,3,0.0
48,0,9,37,46,3,0.0
49,0,3,24,27,3,0.0
50,0,7,25,32,3,0.0
51,0,6,15,21,3,0.0
52,0,1,6,7,3,0.0
53,0,12,19,31,3,0.0
54,0,9,23,32,3,0.0
55,0,15,23,38,3,0.0
56,0,8,27,35,3,0.0
57,0,17,33,50,3,0.0
58,0,10,10,20,3,0.0
59,0,16,33,49,3,0.0
60,0,16,33,49,3,0.0
61,0,10,10,20,3,0.0
62,0,18,30,48,3,0.0
63,0,22,53,75,3,0.0
64,0,3,7,10,3,0.0
65,0,17,20,37,3,0.0
66,0,1,5,6,3,0.0
67,0,3,3,6,3,0.0
68,0,7,19,26,3,0.0
69,0,34,57,91,3,0.0
70,0,12,48,60,3,0.0
71,0,8,11,19,3,0.0
72,0,43,43,86,3,0.0
73,0,7,23,30,3,0.0
74,0,14,39,53,3,0.0
75,0,9,25,34,3,0.0
76,0,16,33,49,3,0.0
77,0,26,63,89,3,0.0
78,0,10,42,52,3,0.0
79,0,4,10,14,3,0.0
80,0,7,24,31,3,0.0
81,0,13,22,35,3,0.0
82,0,1,7,8,3,0.0
83,0,6,21,27,3,0.0
84,0,12,28,40,3,0.0
85,0,10,15,25,3,0.0
86,0,2,18,20,3,0.0
87,0,19,47,66,3,0.0
88,0,82,102,184,3,0.0
89,0,22,63,85,3,0.0
90,0,28,53,81,3,0.0
91,0,12,32,44,3,0.0
92,0,17,34,51,3,0.0
93,0,15,16,31,3,0.0
94,0,6,11,17,3,0.0
95,0,3,0,3,3,0.0
96,0,12,21,33,3,0.0
97,0,6,11,17,3,0.0
98,0,30,122,152,3,0.0
99,0,14,26,40,3,0.0
100,0,45,76,121,3,0.0
101,0,3,13,16,3,0.0
102,0,26,60,86,3,0.0
103,0,17,26,43,3,0.0
104,0,6,24,30,3,0.0
105,0,25,55,80,3,0.0
106,0,21,40,61,3,0.0
107,0,26,50,76,3,0.0
108,0,76,147,223,3,0.0
109,0,18,79,97,3,0.0
110,0,18,39,57,3,0.0
111,0,4,9,13,3,0.0
112,0,7,21,28,3,0.0
113,0,66,97,163,3,0.0
114,0,14,40,54,3,0.0
115,0,45,96,141,3,0.0
116,0,35,104,139,3,0.0
117,0,7,17,24,3,0.0
118,0,8,21,29,3,0.0
119,0,16,24,40,3,0.0
120,0,24,38,62,3,0.0
121,0,10,35,45,3,0.0
122,0,12,39,51,3,0.0
123,0,25,8,33,3,0.0
124,0,2,6,8,3,0.0
125,0,28,47,75,3,0.0
126,0,9,14,23,3,0.0
127,0,13,24,37,3,0.0
128,0,36,74,110,3,0.0
129,0,8,26,34,3,0.0
130,0,15,23,38,3,0.0
131,0,5,28,33,3,0.0
132,0,21,33,54,3,0.0
133,0,11,28,39,3,0.0
134,0,16,18,34,3,0.0
135,0,11,27,38,3,0.0
136,0,33,66,99,3,0.0
137,0,9,16,25,3,0.0
138,0,1,10,11,3,0.0
139,0,10,7,17,3,0.0
140,0,21,20,41,3,0.0
141,0,23,22,45,3,0.0
142,0,26,51,77,3,0.0
143,0,17,19,36,3,0.0
144,0,52,103,155,3,0.0
145,0,17,28,45,3,0.0
146,0,12,39,51,3,0.0
147,0,10,11,21,3,0.0
148,0,19,35,54,3,0.0
149,0,10,25,35,3,0.0
150,0,66,96,162,3,0.0
151,0,16,37,53,3,0.0
152,0,35,47,82,3,0.0
153,0,15,12,27,3,0.0
154,0,5,13,18,3,0.0
155,0,15,24,39,3,0.0
156,0,27,40,67,3,0.0
157,0,11,13,24,3,0.0
158,0,4,4,8,3,0.0
159,0,6,10,16,3,0.0
160,0,4,5,9,3,0.0
161,0,7,23,30,3,0.0
162,0,21,37,58,3,0.0
163,0,3,9,12,3,0.0
164,0,1,14,15,3,0.0
165,0,2,13,15,3,0.0
166,0,29,43,72,3,0.0
167,0,18,37,55,3,0.0
168,0,4,24,28,3,0.0
169,0,27,38,65,3,0.0
170,0,32,58,90,3,0.0
171,0,10,26,36,3,0.0
172,0,15,26,41,3,0.0
173,0,9,23,32,3,0.0
174,0,29,26,55,3,0.0
175,0,14,20,34,3,0.0
176,0,3,13,16,3,0.0
177,0,11,18,29,3,0.0
178,0,23,34,57,3,0.0
179,0,2,6,8,3,0.0
180,0,14,7,21,3,0.0
181,0,23,40,63,3,0.0
182,0,13,20,33,3,0.0
183,0,7,33,40,3,0.0
184,0,30,31,61,3,0.0
185,0,13,25,38,3,0.0
186,0,20,29,49,3,0.0
187,0,14,12,26,3,0.0
188,0,18,13,31,3,0.0
189,0,23,33,56,3,0.0
190,0,7,20,27,3,0.0
191,0,10,32,42,3,0.0
192,0,54,73,127,3,0.0
193,0,6,23,29,3,0.0
194,0,3,12,15,3,0.0
195,0,2,5,7,3,0.0
196,0,4,4,8,3,0.0
197,0,7,19,26,3,0.0
198,0,27,51,78,3,0.0
199,0,34,78,112,3,0.0
200,0,18,26,44,3,0.0
201,0,16,44,60,3,0.0
202,0,12,26,38,3,0.0
203,0,24,31,55,3,0.0
204,0,23,20,43,3,0.0
205,0,25,52,77,3,0.0
206,0,27,56,83,3,0.0
207,0,12,24,36,3,0.0
208,0,20,36,56,3,0.0
209,0,4,22,26,3,0.0
210,0,5,19,24,3,0.0
211,0,15,35,50,3,0.0
212,0,54,75,129,3,0.0
213,0,17,36,53,3,0.0
214,0,10,33,43,3,0.0
215,0,23,49,72,3,0.0
216,0,1,6,7,3,0.0
217,0,8,16,24,3,0.0
218,0,3,11,14,3,0.0
219,0,15,27,42,3,0.0
220,0,26,52,78,3,0.0
221,0,7,19,26,3,0.0
222,0,3,9,12,3,0.0
223,0,0,3,3,3,0.0
224,0,38,35,73,3,0.0
225,0,27,64,91,3,0.0
226,0,33,67,100,3,0.0
227,0,19,47,66,3,0.0
228,0,7,18,25,3,0.0
229,0,30,51,81,3,0.0
230,0,22,68,90,3,0.0
231,0,12,15,27,3,0.0
232,0,8,22,30,3,0.0
233,0,14,35,49,3,0.0
234,0,9,28,37,3,0.0
235,0,10,28,38,3,0.0
236,0,8,19,27,3,0.0
237,0,11,30,41,3,0.0
238,0,4,11,15,3,0.0
239,0,3,4,7,3,0.0
240,0,7,5,12,3,0.0
241,0,18,27,45,3,0.0
242,0,22,25,47,3,0.0
243,0,25,45,70,3,0.0
244,0,12,25,37,3,0.0
245,0,41,76,117,3,0.0
246,0,38,49,87,3,0.0
247,0,33,27,60,3,0.0
248,0,31,72,103,3,0.0
249,0,14,43,57,3,0.0
250,0,7,18,25,3,0.0
251,0,13,32,45,3,0.0
252,0,1,7,8,3,0.0
253,0,28,29,57,3,0.0
254,0,5,15,20,3,0.0
255,0,25,32,57,3,0.0
256,0,1,7,8,3,0.0
257,0,19,37,56,3,0.0
258,0,89,150,239,3,0.0
259,0,32,38,70,3,0.0
260,0,11,12,23,3,0.0
261,0,28,29,57,3,0.0
262,0,19,21,40,3,0.0
263,0,21,32,53,3,0.0
264,0,11,40,51,3,0.0
265,0,13,29,42,3,0.0
266,0,8,16,24,3,0.0
267,0,13,13,26,3,0.0
268,0,4,7,11,3,0.0
269,0,3,14,17,3,0.0
270,0,6,3,9,3,0.0
271,0,0,0,0,3,0.0
272,0,57,59,116,3,0.0
273,0,16,17,33,3,0.0
274,0,32,70,102,3,0.0
275,0,20,22,42,3,0.0
276,0,29,59,88,3,0.0
277,0,15,46,61,3,0.0
278,0,13,53,66,3,0.0
279,0,8,21,29,3,0.0
280,0,12,13,25,3,0.0
281,0,7,9,16,3,0.0
282,0,6,6,12,3,0.0
283,0,7,33,40,3,0.0
284,0,15,52,67,3,0.0
285,0,36,53,89,3,0.0
286,0,15,42,57,3,0.0
287,0,29,34,63,3,0.0
288,0,20,16,36,3,0.0
289,0,64,81,145,3,0.0
290,0,17,51,68,3,0.0
291,0,6,17,23,3,0.0
292,0,37,65,102,3,0.0
293,0,12,35,47,3,0.0
294,0,4,27,31,3,0.0
295,0,6,24,30,3,0.0
296,0,29,24,53,3,0.0
297,0,23,33,56,3,0.0
298,0,7,13,20,3,0.0
299,0,21,40,61,3,0.0
300,0,14,33,47,3,0.0
301,0,22,54,76,3,0.0
302,0,10,21,31,3,0.0
303,0,21,51,72,3,0.0
304,0,19,38,57,3,0.0
305,0,16,38,54,3,0.0
306,0,10,21,31,3,0.0
307,0,10,6,16,3,0.0
308,0,12,14,26,3,0.0
309,0,6,26,32,3,0.0
310,0,8,15,23,3,0.0
311,0,6,7,13,3,0.0
312,0,1,3,4,3,0.0
313,0,2,10,12,3,0.0
314,0,10,8,18,3,0.0
315,0,10,20,30,3,0.0
316,0,18,27,45,3,0.0
317,0,16,37,53,3,0.0
318,0,12,29,41,3,0.0
319,0,18,67,85,3,0.0
320,0,18,46,64,3,0.0
321,0,8,23,31,3,0.0
322,0,7,29,36,3,0.0
323,0,13,13,26,3,0.0
324,0,10,31,41,3,0.0
325,0,2,8,10,3,0.0
326,0,28,65,93,3,0.0
327,0,7,12,19,3,0.0
328,0,47,56,103,3,0.0
329,0,14,34,48,3,0.0
330,0,31,57,88,3,0.0
331,0,13,28,41,3,0.0
332,0,14,20,34,3,0.0
333,0,35,79,114,3,0.0
334,0,9,23,32,3,0.0
335,0,4,9,13,3,0.0
336,0,5,56,61,3,0.0
337,0,11,16,27,3,0.0
338,0,5,9,14,3,0.0
339,0,3,6,9,3,0.0
340,0,4,20,24,3,0.0
341,0,8,5,13,3,0.0
342,0,0,6,6,3,0.0
343,0,17,30,47,3,0.0
344,0,7,5,12,3,0.0
345,0,41,111,152,3,0.0
346,0,15,23,38,3,0.0
347,0,20,41,61,3,0.0
348,0,6,21,27,3,0.0
349,0,30,49,79,3,0.0
350,0,35,83,118,3,0.0
351,0,26,33,59,3,0.0
352,0,35,41,76,3,0.0
353,0,58,103,161,3,0.0
354,0,31,42,73,3,0.0
355,0,31,66,97,3,0.0
356,0,31,84,115,3,0.0
357,0,13,69,82,3,0.0
358,0,26,36,62,3,0.0
359,0,10,18,28,3,0.0
360,0,5,13,18,3,0.0
361,0,43,76,119,3,0.0
362,0,25,82,107,3,0.0
363,0,33,54,87,3,0.0
364,0,24,56,80,3,0.0
365,0,30,41,71,3,0.0
366,0,30,58,88,3,0.0
367,0,21,60,81,3,0.0
368,0,20,47,67,3,0.0
369,0,4,40,44,3,0.0
370,0,24,50,74,3,0.0
371,0,3,9,12,3,0.0
372,0,0,12,12,3,0.0
373,0,10,36,46,3,0.0
374,0,36,72,108,3,0.0
375,0,30,38,68,3,0.0
376,0,26,39,65,3,0.0
377,0,9,29,38,3,0.0
378,0,31,72,103,3,0.0
379,0,31,54,85,3,0.0
380,0,16,26,42,3,0.0
381,0,9,34,43,3,0.0
382,0,11,38,49,3,0.0
383,0,10,10,20,3,0.0
384,0,7,18,25,3,0.0
385,0,5,20,25,3,0.0
386,0,12,31,43,3,0.0
387,0,32,109,141,3,0.0
388,0,6,17,23,3,0.0
389,0,16,34,50,3,0.0
390,0,21,39,60,3,0.0
391,0,27,41,68,3,0.0
392,0,19,69,88,3,0.0
393,0,10,17,27,3,0.0
394,0,10,23,33,3,0.0
395,0,8,13,21,3,0.0
396,0,11,25,36,3,0.0
397,0,14,15,29,3,0.0
398,0,12,49,61,3,0.0
399,0,41,123,164,3,0.0
400,0,36,89,125,3,0.0
401,0,8,43,51,3,0.0
402,0,30,36,66,3,0.0
403,0,35,48,83,3,0.0
404,0,11,7,18,3,0.0
405,0,14,27,41,3,0.0
406,0,17,41,58,3,0.0
407,0,42,110,152,3,0.0
408,0,23,20,43,3,0.0
409,0,6,34,40,3,0.0
410,0,87,226,313,3,0.0
411,0,13,25,38,3,0.0
412,0,73,76,149,3,0.0
413,0,4,10,14,3,0.0
414,0,9,9,18,3,0.0
415,0,3,7,10,3,0.0
416,0,13,34,47,3,0.0
417,0,33,72,105,3,0.0
418,0,25,74,99,3,0.0
419,0,13,17,30,3,0.0
420,0,38,65,103,3,0.0
421,0,18,75,93,3,0.0
422,0,37,53,90,3,0.0
423,0,35,90,125,3,0.0
424,0,26,46,72,3,0.0
425,0,15,43,58,3,0.0
426,0,13,28,41,3,0.0
427,0,9,24,33,3,0.0
428,0,6,30,36,3,0.0
429,0,3,24,27,3,0.0
430,0,1,7,8,3,0.0
431,75,13,12,25,3,0.001
432,75,1,7,8,3,0.001
433,75,12,38,50,3,0.001
434,75,14,36,50,3,0.001
435,75,31,48,79,3,0.001
436,75,11,26,37,3,0.001
437,75,22,29,51,3,0.001
438,75,16,30,46,3,0.001
439,75,19,41,60,3,0.001
440,75,53,74,127,3,0.001
441,75,27,49,76,3,0.001
442,75,12,2,14,3,0.001
443,75,28,60,88,3,0.001
444,75,34,45,79,3,0.001
445,75,37,94,131,3,0.001
446,75,25,41,66,3,0.001
447,75,21,37,58,3,0.001
448,75,31,61,92,3,0.001
449,75,16,33,49,3,0.001
450,75,32,56,88,3,0.001
451,75,28,56,84,3,0.001
452,75,52,164,216,3,0.001
453,75,23,42,65,3,0.001
454,75,27,47,74,3,0.001
455,75,11,15,26,3,0.001
456,75,21,25,46,3,0.001
457,75,5,3,8,3,0.001
458,75,2,1,3,3,0.001
459,75,4,7,11,3,0.001
460,75,9,26,35,3,0.001
461,75,9,2,11,3,0.001
462,75,16,53,69,3,0.001
463,75,16,45,61,3,0.001
464,75,2,23,25,3,0.001
465,75,9,14,23,3,0.001
466,75,20,72,92,3,0.001
467,75,19,71,90,3,0.001
468,75,4,38,42,3,0.001
469,75,3,12,15,3,0.001
470,75,1,22,23,3,0.001
471,75,10,11,21,3,0.001
472,75,1,4,5,3,0.001
473,75,39,65,104,3,0.001
474,75,14,23,37,3,0.001
475,75,19,43,62,3,0.001
476,75,4,10,14,3,0.001
477,75,11,22,33,3,0.001
478,75,12,34,46,3,0.001
479,75,8,11,19,3,0.001
480,75,20,36,56,3,0.001
481,75,6,63,69,3,0.001
482,75,3,10,13,3,0.001
483,75,7,13,20,3,0.001
484,75,0,5,5,3,0.001
485,75,11,41,52,3,0.001
486,75,21,43,64,3,0.001
487,75,9,28,37,3,0.001
488,75,6,23,29,3,0.001
489,75,15,83,98,3,0.001
490,75,4,28,32,3,0.001
491,75,33,41,74,3,0.001
492,75,20,42,62,3,0.001
493,75,0,2,2,3,0.001
494,75,11,94,105,3,0.001
495,75,3,9,12,3,0.001
496,75,9,23,32,3,0.001
497,75,7,10,17,3,0.001
498,75,11,27,38,3,0.001
499,75,7,16,23,3,0.001
500,75,26,37,63,3,0.001
501,75,27,61,88,3,0.001
502,75,15,49,64,3,0.001
503,75,14,20,34,3,0.001
504,75,50,91,141,3,0.001
505,75,16,21,37,3,0.001
506,75,26,36,62,3,0.001
507,75,10,24,34,3,0.001
508,75,19,18,37,3,0.001
509,75,26,50,76,3,0.001
510,75,5,14,19,3,0.001
511,75,11,22,33,3,0.001
512,75,4,33,37,3,0.001
513,75,26,35,61,3,0.001
514,75,15,44,59,3,0.001
515,75,7,77,84,3,0.001
516,75,3,32,35,3,0.001
517,75,14,72,86,3,0.001
518,75,16,39,55,3,0.001
519,75,15,29,44,3,0.001
520,75,12,26,38,3,0.001
521,75,8,31,39,3,0.001
522,75,9,18,27,3,0.001
523,75,20,63,83,3,0.001
524,75,40,71,111,3,0.001
525,75,6,57,63,3,0.001
526,75,10,24,34,3,0.001
527,75,4,13,17,3,0.001
528,75,15,65,80,3,0.001
529,75,5,20,25,3,0.001
530,75,32,47,79,3,0.001
531,75,14,32,46,3,0.001
532,75,14,40,54,3,0.001
533,75,14,53,67,3,0.001
534,75,35,54,89,3,0.001
535,75,28,84,112,3,0.001
536,75,19,25,44,3,0.001
537,75,15,37,52,3,0.001
538,75,14,13,27,3,0.001
539,75,3,24,27,3,0.001
540,75,1,13,14,3,0.001
541,75,16,49,65,3,0.001
542,75,6,6,12,3,0.001
543,75,38,26,64,3,0.001
544,75,16,26,42,3,0.001
545,75,24,27,51,3,0.001
546,75,23,36,59,3,0.001
547,75,20,18,38,3,0.001
548,75,12,41,53,3,0.001
549,75,17,27,44,3,0.001
550,75,14,27,41,3,0.001
551,75,7,8,15,3,0.001
552,75,90,102,192,3,0.001
553,75,3,11,14,3,0.001
554,75,5,8,13,3,0.001
555,75,5,4,9,3,0.001
556,75,3,8,11,3,0.001
557,75,4,6,10,3,0.001
558,75,8,20,28,3,0.001
559,75,17,34,51,3,0.001
560,75,36,32,68,3,0.001
561,75,13,13,26,3,0.001
562,75,56,73,129,3,0.001
563,75,6,17,23,3,0.001
564,75,29,29,58,3,0.001
565,75,34,45,79,3,0.001
566,75,19,45,64,3,0.001
567,75,6,19,25,3,0.001
568,75,8,18,26,3,0.001
569,75,8,27,35,3,0.001
570,75,5,20,25,3,0.001
571,75,38,47,85,3,0.001
572,75,10,41,51,3,0.001
573,75,2,7,9,3,0.001
574,75,23,73,96,3,0.001
575,75,15,21,36,3,0.001
576,75,6,29,35,3,0.001
577,75,21,59,80,3,0.001
578,75,29,56,85,3,0.001
579,75,37,66,103,3,0.001
580,75,17,12,29,3,0.001
581,75,27,85,112,3,0.001
582,75,49,59,108,3,0.001
583,75,8,29,37,3,0.001
584,75,4,10,14,3,0.001
585,75,7,4,11,3,0.001
586,75,2,6,8,3,0.001
587,75,10,13,23,3,0.001
588,75,5,22,27,3,0.001
589,75,14,35,49,3,0.001
590,75,24,12,36,3,0.001
591,75,21,38,59,3,0.001
592,75,65,92,157,3,0.001
593,75,21,44,65,3,0.001
594,75,21,34,55,3,0.001
595,75,12,36,48,3,0.001
596,75,6,13,19,3,0.001
597,75,13,20,33,3,0.001
598,75,3,19,22,3,0.001
599,75,4,27,31,3,0.001
600,75,20,18,38,3,0.001
601,75,15,39,54,3,0.001
602,75,0,3,3,3,0.001
603,75,14,11,25,3,0.001
604,75,21,21,42,3,0.001
605,75,28,23,51,3,0.001
606,75,44,66,110,3,0.001
607,75,17,28,45,3,0.001
608,75,21,28,49,3,0.001
609,75,24,19,43,3,0.001
610,75,14,15,29,3,0.001
611,75,5,10,15,3,0.001
612,75,2,3,5,3,0.001
613,75,25,74,99,3,0.001
614,75,16,47,63,3,0.001
615,75,3,8,11,3,0.001
616,75,9,38,47,3,0.001
617,75,12,27,39,3,0.001
618,75,12,55,67,3,0.001
619,75,24,47,71,3,0.001
620,75,53,68,121,3,0.001
621,75,14,13,27,3,0.001
622,75,38,147,185,3,0.001
623,75,30,58,88,3,0.001
624,75,26,42,68,3,0.001
625,75,11,23,34,3,0.001
626,75,14,26,40,3,0.001
627,75,10,39,49,3,0.001
628,75,16,59,75,3,0.001
629,75,15,63,78,3,0.001
630,75,5,42,47,3,0.001
631,75,4,21,25,3,0.001
632,75,56,198,254,3,0.001
633,75,32,73,105,3,0.001
634,75,19,26,45,3,0.001
635,75,6,12,18,3,0.001
636,75,15,34,49,3,0.001
637,75,4,23,27,3,0.001
638,75,15,27,42,3,0.001
639,75,2,8,10,3,0.001
640,75,23,45,68,3,0.001
641,75,1,14,15,3,0.001
642,75,18,18,36,3,0.001
643,75,25,44,69,3,0.001
644,75,10,23,33,3,0.001
645,75,21,20,41,3,0.001
646,75,9,11,20,3,0.001
647,75,10,16,26,3,0.001
648,75,26,29,55,3,0.001
649,75,18,43,61,3,0.001
650,75,25,65,90,3,0.001
651,75,19,80,99,3,0.001
652,75,68,168,236,3,0.001
653,75,18,43,61,3,0.001
654,75,28,65,93,3,0.001
655,75,16,30,46,3,0.001
656,75,30,72,102,3,0.001
657,75,16,29,45,3,0.001
658,75,23,46,69,3,0.001
659,75,10,12,22,3,0.001
660,75,6,35,41,3,0.001
661,75,11,21,32,3,0.001
662,75,56,241,297,3,0.001
663,75,29,43,72,3,0.001
664,75,35,100,135,3,0.001
665,75,33,57,90,3,0.001
666,75,23,47,70,3,0.001
667,75,17,67,84,3,0.001
668,75,24,75,99,3,0.001
669,75,77,199,276,3,0.001
670,75,28,92,120,3,0.001
671,75,47,237,284,3,0.001
672,75,33,65,98,3,0.001
673,75,11,9,20,3,0.001
674,75,92,163,255,3,0.001
675,75,81,159,240,3,0.001
676,75,35,84,119,3,0.001
677,75,75,105,180,3,0.001
678,75,56,73,129,3,0.001
679,75,35,61,96,3,0.001
680,75,44,69,113,3,0.001
681,75,60,42,102,3,0.001
682,75,25,63,88,3,0.001
683,75,18,10,28,3,0.001
684,75,44,77,121,3,0.001
685,75,30,49,79,3,0.001
686,75,20,38,58,3,0.001
687,75,18,31,49,3,0.001
688,75,7,12,19,3,0.001
689,75,44,67,111,3,0.001
690,75,29,105,134,3,0.001
691,75,37,116,153,3,0.001
692,75,10,23,33,3,0.001
693,75,100,54,154,3,0.001
694,75,46,151,197,3,0.001
695,75,50,73,123,3,0.001
696,75,47,98,145,3,0.001
697,75,11,26,37,3,0.001
698,75,43,40,83,3,0.001
699,75,2,14,16,3,0.001
700,75,1,16,17,3,0.001
701,75,32,66,98,3,0.001
702,75,54,70,124,3,0.001
703,75,26,70,96,3,0.001
704,75,8,9,17,3,0.001
705,75,66,91,157,3,0.001
706,75,7,35,42,3,0.001
707,75,12,27,39,3,0.001
708,75,26,49,75,3,0.001
709,75,9,24,33,3,0.001
710,75,10,16,26,3,0.001
711,75,11,41,52,3,0.001
712,75,2,22,24,3,0.001
713,75,40,79,119,3,0.001
714,75,25,21,46,3,0.001
715,75,38,39,77,3,0.001
716,75,43,65,108,3,0.001
717,75,47,87,134,3,0.001
718,75,38,57,95,3,0.001
719,75,15,17,32,3,0.001
720,75,83,132,215,3,0.001
721,75,63,114,177,3,0.001
722,75,17,47,64,3,0.001
723,75,76,113,189,3,0.001
724,75,19,15,34,3,0.001
725,75,29,36,65,3,0.001
726,75,35,55,90,3,0.001
727,75,24,22,46,3,0.001
728,75,6,4,10,3,0.001
729,75,12,35,47,3,0.001
730,75,6,36,42,3,0.001
731,75,31,51,82,3,0.001
732,75,18,37,55,3,0.001
733,75,27,26,53,3,0.001
734,75,31,92,123,3,0.001
735,75,6,32,38,3,0.001
736,75,38,57,95,3,0.001
737,75,19,40,59,3,0.001
738,75,4,8,12,3,0.001
739,75,38,76,114,3,0.001
740,75,33,41,74,3,0.001
741,75,16,66,82,3,0.001
742,75,21,42,63,3,0.001
743,75,21,38,59,3,0.001
744,75,14,60,74,3,0.001
745,75,12,30,42,3,0.001
746,75,28,50,78,3,0.001
747,75,25,66,91,3,0.001
748,75,15,51,66,3,0.001
749,75,3,8,11,3,0.001
750,75,11,31,42,3,0.001
751,75,9,19,28,3,0.001
752,75,10,40,50,3,0.001
753,75,3,24,27,3,0.001
754,75,34,76,110,3,0.001
755,75,7,14,21,3,0.001
756,75,10,16,26,3,0.001
757,75,30,36,66,3,0.001
758,75,19,32,51,3,0.001
759,75,7,9,16,3,0.001
760,75,16,47,63,3,0.001
761,75,19,18,37,3,0.001
762,75,12,29,41,3,0.001
763,75,7,24,31,3,0.001
764,75,38,74,112,3,0.001
765,75,42,130,172,3,0.001
766,75,20,52,72,3,0.001
767,75,4,15,19,3,0.001
768,75,51,64,115,3,0.001
769,75,15,37,52,3,0.001
770,75,64,88,152,3,0.001
771,75,44,66,110,3,0.001
772,75,55,59,114,3,0.001
773,75,43,71,114,3,0.001
774,75,7,15,22,3,0.001
775,75,27,45,72,3,0.001
776,75,20,51,71,3,0.001
777,75,12,21,33,3,0.001
778,75,6,14,20,3,0.001
779,75,7,19,26,3,0.001
780,75,12,38,50,3,0.001
781,75,1,4,5,3,0.001
782,75,38,36,74,3,0.001
783,75,25,62,87,3,0.001
784,75,20,55,75,3,0.001
785,75,34,33,67,3,0.001
786,75,50,94,144,3,0.001
787,75,63,71,134,3,0.001
788,75,57,122,179,3,0.001
789,75,23,56,79,3,0.001
790,75,15,35,50,3,0.001
791,75,6,14,20,3,0.001
792,75,11,18,29,3,0.001
793,75,11,6,17,3,0.001
794,75,6,15,21,3,0.001
795,75,1,6,7,3,0.001
796,75,27,28,55,3,0.001
797,75,6,22,28,3,0.001
798,75,32,110,142,3,0.001
799,75,39,57,96,3,0.001
800,75,20,49,69,3,0.001
801,75,6,8,14,3,0.001
802,75,21,28,49,3,0.001
803,75,28,52,80,3,0.001
804,75,9,36,45,3,0.001
805,75,14,57,71,3,0.001
806,75,5,15,20,3,0.001
807,75,33,77,110,3,0.001
808,75,29,65,94,3,0.001
809,75,74,89,163,3,0.001
810,75,26,27,53,3,0.001
811,75,76,71,147,3,0.001
812,75,10,30,40,3,0.001
813,75,16,52,68,3,0.001
814,75,20,40,60,3,0.001
815,75,0,13,13,3,0.001
816,75,3,28,31,3,0.001
817,75,161,394,555,3,0.001
818,75,52,142,194,3,0.001
819,75,60,173,233,3,0.001
820,75,44,49,93,3,0.001
821,75,24,72,96,3,0.001
822,75,30,48,78,3,0.001
823,75,7,23,30,3,0.001
824,75,35,117,152,3,0.001
825,75,44,69,113,3,0.001
826,75,11,18,29,3,0.001
827,75,8,57,65,3,0.001
828,75,20,27,47,3,0.001
829,75,17,52,69,3,0.001
830,75,19,17,36,3,0.001
831,75,1,10,11,3,0.01
832,75,16,27,43,3,0.01
833,75,14,35,49,3,0.01
834,75,29,70,99,3,0.01
835,75,13,27,40,3,0.01
836,75,81,115,196,3,0.01
837,75,20,51,71,3,0.01
838,75,28,86,114,3,0.01
839,75,9,35,44,3,0.01
840,75,32,97,129,3,0.01
841,75,1,11,12,3,0.01
842,75,10,25,35,3,0.01
843,75,1,20,21,3,0.01
844,75,26,16,42,3,0.01
845,75,61,121,182,3,0.01
846,75,31,33,64,3,0.01
847,75,5,1,6,3,0.01
848,75,19,44,63,3,0.01
849,75,14,24,38,3,0.01
850,75,7,13,20,3,0.01
851,75,19,34,53,3,0.01
852,75,32,46,78,3,0.01
853,75,9,11,20,3,0.01
854,75,8,43,51,3,0.01
855,75,5,9,14,3,0.01
856,75,4,7,11,3,0.01
857,75,8,30,38,3,0.01
858,75,57,91,148,3,0.01
859,75,63,147,210,3,0.01
860,75,46,69,115,3,0.01
861,75,10,7,17,3,0.01
862,75,34,108,142,3,0.01
863,75,8,21,29,3,0.01
864,75,24,25,49,3,0.01
865,75,16,26,42,3,0.01
866,75,9,33,42,3,0.01
867,75,4,28,32,3,0.01
868,75,15,29,44,3,0.01
869,75,17,32,49,3,0.01
870,75,26,52,78,3,0.01
871,75,4,33,37,3,0.01
872,75,5,33,38,3,0.01
873,75,32,35,67,3,0.01
874,75,42,96,138,3,0.01
875,75,10,28,38,3,0.01
876,75,15,36,51,3,0.01
877,75,21,65,86,3,0.01
878,75,44,47,91,3,0.01
879,75,28,41,69,3,0.01
880,75,16,33,49,3,0.01
881,75,29,55,84,3,0.01
882,75,8,12,20,3,0.01
883,75,13,38,51,3,0.01
884,75,6,5,11,3,0.01
885,75,3,6,9,3,0.01
886,75,46,67,113,3,0.01
887,75,20,23,43,3,0.01
888,75,34,67,101,3,0.01
889,75,36,36,72,3,0.01
890,75,13,27,40,3,0.01
891,75,30,32,62,3,0.01
892,75,7,6,13,3,0.01
893,75,25,45,70,3,0.01
894,75,26,77,103,3,0.01
895,75,23,20,43,3,0.01
896,75,9,9,18,3,0.01
897,75,27,69,96,3,0.01
898,75,37,80,117,3,0.01
899,75,21,43,64,3,0.01
900,75,25,28,53,3,0.01
901,75,45,62,107,3,0.01
902,75,20,56,76,3,0.01
903,75,15,42,57,3,0.01
904,75,54,103,157,3,0.01
905,75,6,16,22,3,0.01
906,75,71,161,232,3,0.01
907,75,29,46,75,3,0.01
908,75,63,145,208,3,0.01
909,75,2,9,11,3,0.01
910,75,28,72,100,3,0.01
911,75,0,5,5,3,0.01
912,75,24,16,40,3,0.01
913,75,34,46,80,3,0.01
914,75,58,95,153,3,0.01
915,75,11,9,20,3,0.01
916,75,29,62,91,3,0.01
917,75,39,153,192,3,0.01
918,75,29,99,128,3,0.01
919,75,7,17,24,3,0.01
920,75,27,33,60,3,0.01
921,75,12,45,57,3,0.01
922,75,21,53,74,3,0.01
923,75,3,9,12,3,0.01
924,75,19,44,63,3,0.01
925,75,4,10,14,3,0.01
926,75,25,77,102,3,0.01
927,75,11,18,29,3,0.01
928,75,16,41,57,3,0.01
929,75,17,40,57,3,0.01
930,75,32,39,71,3,0.01
931,75,41,76,117,3,0.01
932,75,37,101,138,3,0.01
933,75,9,29,38,3,0.01
934,75,22,44,66,3,0.01
935,75,7,12,19,3,0.01
936,75,42,23,65,3,0.01
937,75,7,21,28,3,0.01
938,75,43,107,150,3,0.01
939,75,29,71,100,3,0.01
940,75,13,29,42,3,0.01
941,75,58,85,143,3,0.01
942,75,11,19,30,3,0.01
943,75,5,27,32,3,0.01
944,75,6,24,30,3,0.01
945,75,20,29,49,3,0.01
946,75,10,14,24,3,0.01
947,75,7,11,18,3,0.01
948,75,16,49,65,3,0.01
949,75,1,5,6,3,0.01
950,75,17,18,35,3,0.01
951,75,13,32,45,3,0.01
952,75,63,107,170,3,0.01
953,75,21,48,69,3,0.01
954,75,30,70,100,3,0.01
955,75,29,48,77,3,0.01
956,75,16,19,35,3,0.01
957,75,24,42,66,3,0.01
958,75,10,33,43,3,0.01
959,75,18,41,59,3,0.01
960,75,9,10,19,3,0.01
961,75,22,33,55,3,0.01
962,75,4,7,11,3,0.01
963,75,5,16,21,3,0.01
964,75,35,27,62,3,0.01
965,75,7,32,39,3,0.01
966,75,18,43,61,3,0.01
967,75,77,173,250,3,0.01
968,75,49,85,134,3,0.01
969,75,21,31,52,3,0.01
970,75,36,55,91,3,0.01
971,75,5,15,20,3,0.01
972,75,30,48,78,3,0.01
973,75,3,12,15,3,0.01
974,75,4,11,15,3,0.01
975,75,5,17,22,3,0.01
976,75,4,11,15,3,0.01
977,75,15,7,22,3,0.01
978,75,7,16,23,3,0.01
979,75,35,93,128,3,0.01
980,75,25,30,55,3,0.01
981,75,40,76,116,3,0.01
982,75,16,32,48,3,0.01
983,75,33,60,93,3,0.01
984,75,63,134,197,3,0.01
985,75,87,209,296,3,0.01
986,75,27,76,103,3,0.01
987,75,12,30,42,3,0.01
988,75,1,3,4,3,0.01
989,75,19,59,78,3,0.01
990,75,3,5,8,3,0.01
991,75,5,6,11,3,0.01
992,75,1,5,6,3,0.01
993,75,63,90,153,3,0.01
994,75,28,39,67,3,0.01
995,75,55,69,124,3,0.01
996,75,33,64,97,3,0.01
997,75,26,40,66,3,0.01
998,75,33,61,94,3,0.01
999,75,15,30,45,3,0.01
1000,75,21,48,69,3,0.01
1001,75,6,82,88,3,0.01
1002,75,13,31,44,3,0.01
1003,75,11,17,28,3,0.01
1004,75,15,54,69,3,0.01
1005,75,3,3,6,3,0.01
1006,75,1,6,7,3,0.01
1007,75,20,44,64,3,0.01
1008,75,20,43,63,3,0.01
1009,75,21,30,51,3,0.01
1010,75,9,6,15,3,0.01
1011,75,41,75,116,3,0.01
1012,75,3,9,12,3,0.01
1013,75,66,86,152,3,0.01
1014,75,23,66,89,3,0.01
1015,75,17,21,38,3,0.01
1016,75,29,28,57,3,0.01
1017,75,12,18,30,3,0.01
1018,75,50,81,131,3,0.01
1019,75,10,23,33,3,0.01
1020,75,37,90,127,3,0.01
1021,75,12,55,67,3,0.01
1022,75,4,25,29,3,0.01
1023,75,9,26,35,3,0.01
1024,75,8,23,31,3,0.01
1025,75,11,25,36,3,0.01
1026,75,38,81,119,3,0.01
1027,75,35,60,95,3,0.01
1028,75,27,24,51,3,0.01
1029,75,19,16,35,3,0.01
1030,75,54,129,183,3,0.01
1031,75,18,64,82,3,0.01
1032,75,4,13,17,3,0.01
1033,75,9,23,32,3,0.01
1034,75,6,25,31,3,0.01
1035,75,23,47,70,3,0.01
1036,75,27,39,66,3,0.01
1037,75,28,37,65,3,0.01
1038,75,25,58,83,3,0.01
1039,75,21,50,71,3,0.01
1040,75,26,58,84,3,0.01
1041,75,34,102,136,3,0.01
1042,75,36,86,122,3,0.01
1043,75,11,39,50,3,0.01
1044,75,22,14,36,3,0.01
1045,75,12,80,92,3,0.01
1046,75,3,31,34,3,0.01
1047,75,16,50,66,3,0.01
1048,75,10,7,17,3,0.01
1049,75,14,17,31,3,0.01
1050,75,12,19,31,3,0.01
1051,75,28,20,48,3,0.01
1052,75,31,23,54,3,0.01
1053,75,24,33,57,3,0.01
1054,75,52,56,108,3,0.01
1055,75,23,44,67,3,0.01
1056,75,18,11,29,3,0.01
1057,75,31,33,64,3,0.01
1058,75,23,29,52,3,0.01
1059,75,14,28,42,3,0.01
1060,75,9,18,27,3,0.01
1061,75,14,26,40,3,0.01
1062,75,21,35,56,3,0.01
1063,75,16,26,42,3,0.01
1064,75,7,9,16,3,0.01
1065,75,6,22,28,3,0.01
1066,75,4,3,7,3,0.01
1067,75,2,2,4,3,0.01
1068,75,4,9,13,3,0.01
1069,75,15,26,41,3,0.01
1070,75,15,27,42,3,0.01
1071,75,12,3,15,3,0.01
1072,75,24,42,66,3,0.01
1073,75,35,60,95,3,0.01
1074,75,36,46,82,3,0.01
1075,75,28,68,96,3,0.01
1076,75,54,51,105,3,0.01
1077,75,31,36,67,3,0.01
1078,75,71,159,230,3,0.01
1079,75,14,37,51,3,0.01
1080,75,9,12,21,3,0.01
1081,75,42,75,117,3,0.01
1082,75,12,22,34,3,0.01
1083,75,6,9,15,3,0.01
1084,75,13,24,37,3,0.01
1085,75,7,19,26,3,0.01
1086,75,42,56,98,3,0.01
1087,75,3,12,15,3,0.01
1088,75,15,66,81,3,0.01
1089,75,22,30,52,3,0.01
1090,75,5,14,19,3,0.01
1091,75,14,24,38,3,0.01
1092,75,11,30,41,3,0.01
1093,75,22,44,66,3,0.01
1094,75,39,59,98,3,0.01
1095,75,22,46,68,3,0.01
1096,75,45,74,119,3,0.01
1097,75,48,117,165,3,0.01
1098,75,11,17,28,3,0.01
1099,75,11,11,22,3,0.01
1100,75,36,86,122,3,0.01
1101,75,14,21,35,3,0.01
1102,75,2,3,5,3,0.01
1103,75,16,48,64,3,0.01
1104,75,16,49,65,3,0.01
1105,75,12,84,96,3,0.01
1106,75,7,41,48,3,0.01
1107,75,7,21,28,3,0.01
1108,75,41,65,106,3,0.01
1109,75,7,27,34,3,0.01
1110,75,14,33,47,3,0.01
1111,75,2,30,32,3,0.01
1112,75,21,26,47,3,0.01
1113,75,7,18,25,3,0.01
1114,75,4,22,26,3,0.01
1115,75,8,16,24,3,0.01
1116,75,24,30,54,3,0.01
1117,75,18,39,57,3,0.01
1118,75,22,37,59,3,0.01
1119,75,68,125,193,3,0.01
1120,75,18,32,50,3,0.01
1121,75,21,55,76,3,0.01
1122,75,21,36,57,3,0.01
1123,75,19,36,55,3,0.01
1124,75,23,64,87,3,0.01
1125,75,13,34,47,3,0.01
1126,75,8,10,18,3,0.01
1127,75,14,19,33,3,0.01
1128,75,34,34,68,3,0.01
1129,75,28,43,71,3,0.01
1130,75,7,21,28,3,0.01
1131,75,31,79,110,3,0.01
1132,75,18,47,65,3,0.01
1133,75,28,55,83,3,0.01
1134,75,15,47,62,3,0.01
1135,75,19,74,93,3,0.01
1136,75,5,37,42,3,0.01
1137,75,14,24,38,3,0.01
1138,75,17,35,52,3,0.01
1139,75,10,18,28,3,0.01
1140,75,1,1,2,3,0.01
1141,75,26,82,108,3,0.01
1142,75,26,58,84,3,0.01
1143,75,1,32,33,3,0.01
1144,75,8,28,36,3,0.01
1145,75,64,120,184,3,0.01
1146,75,9,34,43,3,0.01
1147,75,10,49,59,3,0.01
1148,75,12,35,47,3,0.01
1149,75,29,75,104,3,0.01
1150,75,14,18,32,3,0.01
1151,75,0,2,2,3,0.01
1152,75,19,16,35,3,0.01
1153,75,20,44,64,3,0.01
1154,75,6,14,20,3,0.01
1155,75,1,4,5,3,0.01
1156,75,37,69,106,3,0.01
1157,75,25,16,41,3,0.01
1158,75,27,17,44,3,0.01
1159,75,65,80,145,3,0.01
1160,75,28,24,52,3,0.01
1161,75,5,15,20,3,0.01
1162,75,32,48,80,3,0.01
1163,75,63,68,131,3,0.01
1164,75,29,37,66,3,0.01
1165,75,39,42,81,3,0.01
1166,75,30,49,79,3,0.01
1167,75,58,81,139,3,0.01
1168,75,23,20,43,3,0.01
1169,75,25,36,61,3,0.01
1170,75,12,19,31,3,0.01
1171,75,72,122,194,3,0.01
1172,75,72,105,177,3,0.01
1173,75,4,7,11,3,0.01
1174,75,16,31,47,3,0.01
1175,75,44,33,77,3,0.01
1176,75,64,104,168,3,0.01
1177,75,37,40,77,3,0.01
1178,75,26,40,66,3,0.01
1179,75,20,19,39,3,0.01
1180,75,36,68,104,3,0.01
1181,75,26,82,108,3,0.01
1182,75,20,65,85,3,0.01
1183,75,87,118,205,3,0.01
1184,75,32,84,116,3,0.01
1185,75,11,23,34,3,0.01
1186,75,22,24,46,3,0.01
1187,75,22,68,90,3,0.01
1188,75,8,6,14,3,0.01
1189,75,10,38,48,3,0.01
1190,75,26,35,61,3,0.01
1191,75,13,24,37,3,0.01
1192,75,37,39,76,3,0.01
1193,75,0,5,5,3,0.01
1194,75,13,20,33,3,0.01
1195,75,39,118,157,3,0.01
1196,75,12,20,32,3,0.01
1197,75,36,59,95,3,0.01
1198,75,17,32,49,3,0.01
1199,75,35,57,92,3,0.01
1200,75,59,138,197,3,0.01
1201,75,33,46,79,3,0.01
1202,75,4,18,22,3,0.01
1203,75,48,92,140,3,0.01
1204,75,39,30,69,3,0.01
1205,75,13,71,84,3,0.01
1206,75,14,13,27,3,0.01
1207,75,6,14,20,3,0.01
1208,75,2,6,8,3,0.01
1209,75,21,21,42,3,0.01
1210,75,21,11,32,3,0.01
1211,75,22,45,67,3,0.01
1212,75,11,24,35,3,0.01
1213,75,26,46,72,3,0.01
1214,75,23,43,66,3,0.01
1215,75,2,1,3,3,0.01
1216,75,6,21,27,3,0.01
1217,75,11,35,46,3,0.01
1218,75,14,17,31,3,0.01
1219,75,12,41,53,3,0.01
1220,75,67,125,192,3,0.01
1221,75,21,28,49,3,0.01
1222,75,30,47,77,3,0.01
1223,75,2,4,6,3,0.01
1224,75,3,10,13,3,0.01
1225,75,5,29,34,3,0.01
1226,75,19,30,49,3,0.01
1227,75,14,42,56,3,0.01
1228,75,20,40,60,3,0.01
1229,75,17,36,53,3,0.01
1230,75,3,26,29,3,0.01
1231,75,14,57,71,3,0.01
1232,75,23,12,35,3,0.01
1233,75,23,39,62,3,0.01
1234,75,15,19,34,3,0.01
1235,75,3,25,28,3,0.01
1236,75,11,16,27,3,0.01
1237,75,11,15,26,3,0.01
1238,75,7,14,21,3,0.01
1239,75,4,13,17,3,0.01
1240,75,7,18,25,3,0.01
1241,75,9,42,51,3,0.01
1242,75,19,13,32,3,0.01
1243,75,34,48,82,3,0.01
1244,75,16,35,51,3,0.01
1245,75,12,16,28,3,0.01
1246,75,39,75,114,3,0.01
1247,75,12,44,56,3,0.01
1248,75,10,25,35,3,0.01
1249,75,14,35,49,3,0.01
1250,75,8,15,23,3,0.01
1251,75,7,10,17,3,0.01
1252,75,17,40,57,3,0.01
1253,75,6,58,64,3,0.01
1254,75,4,14,18,3,0.01
1255,75,96,190,286,3,0.01
1256,75,166,359,525,3,0.01
1257,75,20,45,65,3,0.01
1258,75,26,91,117,3,0.01
1259,75,163,301,464,3,0.01
1260,75,46,73,119,3,0.01
1261,75,22,65,87,3,0.01
1262,75,31,61,92,3,0.01
1263,75,36,94,130,3,0.01
1264,75,25,39,64,3,0.01
1265,75,15,28,43,3,0.01
1266,75,31,65,96,3,0.01
1267,75,14,40,54,3,0.1
1268,75,11,23,34,3,0.1
1269,75,19,58,77,3,0.1
1270,75,12,46,58,3,0.1
1271,75,28,77,105,3,0.1
1272,75,7,25,32,3,0.1
1273,75,11,27,38,3,0.1
1274,75,26,89,115,3,0.1
1275,75,16,38,54,3,0.1
1276,75,4,43,47,3,0.1
1277,75,3,16,19,3,0.1
1278,75,13,69,82,3,0.1
1279,75,34,75,109,3,0.1
1280,75,36,77,113,3,0.1
1281,75,67,69,136,3,0.1
1282,75,16,44,60,3,0.1
1283,75,62,94,156,3,0.1
1284,75,11,35,46,3,0.1
1285,75,104,193,297,3,0.1
1286,75,76,208,284,3,0.1
1287,75,5,25,30,3,0.1
1288,75,10,9,19,3,0.1
1289,75,34,37,71,3,0.1
1290,75,59,95,154,3,0.1
1291,75,6,21,27,3,0.1
1292,75,19,24,43,3,0.1
1293,75,14,27,41,3,0.1
1294,75,52,131,183,3,0.1
1295,75,14,25,39,3,0.1
1296,75,65,67,132,3,0.1
1297,75,16,33,49,3,0.1
1298,75,12,14,26,3,0.1
1299,75,10,24,34,3,0.1
1300,75,3,13,16,3,0.1
1301,75,3,12,15,3,0.1
1302,75,12,23,35,3,0.1
1303,75,21,49,70,3,0.1
1304,75,52,98,150,3,0.1
1305,75,19,34,53,3,0.1
1306,75,39,89,128,3,0.1
1307,75,25,36,61,3,0.1
1308,75,23,97,120,3,0.1
1309,75,36,87,123,3,0.1
1310,75,57,180,237,3,0.1
1311,75,55,106,161,3,0.1
1312,75,7,45,52,3,0.1
1313,75,10,42,52,3,0.1
1314,75,21,35,56,3,0.1
1315,75,23,81,104,3,0.1
1316,75,14,22,36,3,0.1
1317,75,20,28,48,3,0.1
1318,75,22,41,63,3,0.1
1319,75,3,31,34,3,0.1
1320,75,29,48,77,3,0.1
1321,75,30,34,64,3,0.1
1322,75,42,46,88,3,0.1
1323,75,8,12,20,3,0.1
1324,75,6,26,32,3,0.1
1325,75,5,23,28,3,0.1
1326,75,5,4,9,3,0.1
1327,75,33,45,78,3,0.1
1328,75,7,14,21,3,0.1
1329,75,30,34,64,3,0.1
1330,75,3,5,8,3,0.1
1331,75,23,46,69,3,0.1
1332,75,27,62,89,3,0.1
1333,75,11,57,68,3,0.1
1334,75,17,134,151,3,0.1
1335,75,40,83,123,3,0.1
1336,75,21,32,53,3,0.1
1337,75,52,140,192,3,0.1
1338,75,8,13,21,3,0.1
1339,75,4,12,16,3,0.1
1340,75,11,79,90,3,0.1
1341,75,24,48,72,3,0.1
1342,75,2,4,6,3,0.1
1343,75,52,92,144,3,0.1
1344,75,28,74,102,3,0.1
1345,75,9,7,16,3,0.1
1346,75,89,152,241,3,0.1
1347,75,16,48,64,3,0.1
1348,75,3,13,16,3,0.1
1349,75,18,24,42,3,0.1
1350,75,13,26,39,3,0.1
1351,75,43,96,139,3,0.1
1352,75,18,25,43,3,0.1
1353,75,24,67,91,3,0.1
1354,75,24,49,73,3,0.1
1355,75,30,67,97,3,0.1
1356,75,53,65,118,3,0.1
1357,75,33,54,87,3,0.1
1358,75,57,107,164,3,0.1
1359,75,4,15,19,3,0.1
1360,75,5,17,22,3,0.1
1361,75,11,24,35,3,0.1
1362,75,34,149,183,3,0.1
1363,75,23,54,77,3,0.1
1364,75,9,26,35,3,0.1
1365,75,13,20,33,3,0.1
1366,75,11,13,24,3,0.1
1367,75,21,14,35,3,0.1
1368,75,32,50,82,3,0.1
1369,75,27,57,84,3,0.1
1370,75,5,22,27,3,0.1
1371,75,147,272,419,3,0.1
1372,75,24,45,69,3,0.1
1373,75,4,14,18,3,0.1
1374,75,5,7,12,3,0.1
1375,75,16,30,46,3,0.1
1376,75,10,24,34,3,0.1
1377,75,37,65,102,3,0.1
1378,75,29,24,53,3,0.1
1379,75,8,22,30,3,0.1
1380,75,44,34,78,3,0.1
1381,75,26,80,106,3,0.1
1382,75,15,14,29,3,0.1
1383,75,26,39,65,3,0.1
1384,75,8,28,36,3,0.1
1385,75,2,9,11,3,0.1
1386,75,6,10,16,3,0.1
1387,75,39,145,184,3,0.1
1388,75,9,29,38,3,0.1
1389,75,23,43,66,3,0.1
1390,75,30,71,101,3,0.1
1391,75,7,17,24,3,0.1
1392,75,14,26,40,3,0.1
1393,75,37,42,79,3,0.1
1394,75,11,36,47,3,0.1
1395,75,8,19,27,3,0.1
1396,75,25,58,83,3,0.1
1397,75,8,8,16,3,0.1
1398,75,45,83,128,3,0.1
1399,75,11,7,18,3,0.1
1400,75,25,54,79,3,0.1
1401,75,10,19,29,3,0.1
1402,75,20,34,54,3,0.1
1403,75,24,42,66,3,0.1
1404,75,39,71,110,3,0.1
1405,75,27,43,70,3,0.1
1406,75,23,46,69,3,0.1
1407,75,17,24,41,3,0.1
1408,75,12,30,42,3,0.1
1409,75,23,32,55,3,0.1
1410,75,23,32,55,3,0.1
1411,75,11,28,39,3,0.1
1412,75,7,13,20,3,0.1
1413,75,21,46,67,3,0.1
1414,75,50,101,151,3,0.1
1415,75,2,17,19,3,0.1
1416,75,13,31,44,3,0.1
1417,75,45,55,100,3,0.1
1418,75,15,25,40,3,0.1
1419,75,15,33,48,3,0.1
1420,75,12,26,38,3,0.1
1421,75,22,20,42,3,0.1
1422,75,5,5,10,3,0.1
1423,75,7,13,20,3,0.1
1424,75,12,49,61,3,0.1
1425,75,17,45,62,3,0.1
1426,75,9,6,15,3,0.1
1427,75,4,24,28,3,0.1
1428,75,17,36,53,3,0.1
1429,75,30,43,73,3,0.1
1430,75,8,32,40,3,0.1
1431,75,13,31,44,3,0.1
1432,75,20,84,104,3,0.1
1433,75,11,34,45,3,0.1
1434,75,3,12,15,3,0.1
1435,75,5,20,25,3,0.1
1436,75,16,20,36,3,0.1
1437,75,5,21,26,3,0.1
1438,75,20,47,67,3,0.1
1439,75,14,39,53,3,0.1
1440,75,93,193,286,3,0.1
1441,75,23,60,83,3,0.1
1442,75,42,118,160,3,0.1
1443,75,76,127,203,3,0.1
1444,75,39,73,112,3,0.1
1445,75,92,140,232,3,0.1
1446,75,89,203,292,3,0.1
1447,75,28,82,110,3,0.1
1448,75,35,138,173,3,0.1
1449,75,97,263,360,3,0.1
1450,75,5,7,12,3,0.1
1451,75,16,62,78,3,0.1
1452,75,42,45,87,3,0.1
1453,75,15,25,40,3,0.1
1454,75,39,56,95,3,0.1
1455,75,18,31,49,3,0.1
1456,75,21,51,72,3,0.1
1457,75,15,78,93,3,0.1
1458,75,17,42,59,3,0.1
1459,75,55,96,151,3,0.1
1460,75,41,55,96,3,0.1
1461,75,4,5,9,3,0.1
1462,75,14,40,54,3,0.1
1463,75,4,3,7,3,0.1
1464,75,27,46,73,3,0.1
1465,75,10,18,28,3,0.1
1466,75,31,29,60,3,0.1
1467,75,9,55,64,3,0.1
1468,75,53,88,141,3,0.1
1469,75,21,66,87,3,0.1
1470,75,14,53,67,3,0.1
1471,75,12,27,39,3,0.1
1472,75,16,64,80,3,0.1
1473,75,11,25,36,3,0.1
1474,75,11,59,70,3,0.1
1475,75,18,61,79,3,0.1
1476,75,62,104,166,3,0.1
1477,75,52,40,92,3,0.1
1478,75,29,59,88,3,0.1
1479,75,25,25,50,3,0.1
1480,75,53,115,168,3,0.1
1481,75,23,44,67,3,0.1
1482,75,46,120,166,3,0.1
1483,75,52,101,153,3,0.1
1484,75,36,80,116,3,0.1
1485,75,18,26,44,3,0.1
1486,75,4,17,21,3,0.1
1487,75,12,94,106,3,0.1
1488,75,25,61,86,3,0.1
1489,75,22,46,68,3,0.1
1490,75,23,38,61,3,0.1
1491,75,25,31,56,3,0.1
1492,75,43,37,80,3,0.1
1493,75,49,45,94,3,0.1
1494,75,35,33,68,3,0.1
1495,75,21,20,41,3,0.1
1496,75,25,84,109,3,0.1
1497,75,29,55,84,3,0.1
1498,75,32,90,122,3,0.1
1499,75,25,19,44,3,0.1
1500,75,8,17,25,3,0.1
1501,75,35,74,109,3,0.1
1502,75,32,58,90,3,0.1
1503,75,58,149,207,3,0.1
1504,75,45,76,121,3,0.1
1505,75,27,47,74,3,0.1
1506,75,18,73,91,3,0.1
1507,75,10,8,18,3,0.1
1508,75,24,49,73,3,0.1
1509,75,13,44,57,3,0.1
1510,75,27,56,83,3,0.1
1511,75,26,43,69,3,0.1
1512,75,1,1,2,3,0.1
1513,75,24,51,75,3,0.1
1514,75,19,20,39,3,0.1
1515,75,23,42,65,3,0.1
1516,75,18,32,50,3,0.1
1517,75,27,69,96,3,0.1
1518,75,18,40,58,3,0.1
1519,75,39,56,95,3,0.1
1520,75,30,51,81,3,0.1
1521,75,17,31,48,3,0.1
1522,75,11,20,31,3,0.1
1523,75,24,21,45,3,0.1
1524,75,17,20,37,3,0.1
1525,75,4,18,22,3,0.1
1526,75,15,20,35,3,0.1
1527,75,6,27,33,3,0.1
1528,75,11,30,41,3,0.1
1529,75,21,29,50,3,0.1
1530,75,17,24,41,3,0.1
1531,75,29,16,45,3,0.1
1532,75,59,96,155,3,0.1
1533,75,25,42,67,3,0.1
1534,75,39,65,104,3,0.1
1535,75,11,33,44,3,0.1
1536,75,4,18,22,3,0.1
1537,75,57,72,129,3,0.1
1538,75,15,58,73,3,0.1
1539,75,19,44,63,3,0.1
1540,75,23,54,77,3,0.1
1541,75,87,96,183,3,0.1
1542,75,24,26,50,3,0.1
1543,75,3,14,17,3,0.1
1544,75,23,46,69,3,0.1
1545,75,46,127,173,3,0.1
1546,75,15,41,56,3,0.1
1547,75,25,52,77,3,0.1
1548,75,15,36,51,3,0.1
1549,75,26,62,88,3,0.1
1550,75,8,28,36,3,0.1
1551,75,13,15,28,3,0.1
1552,75,4,5,9,3,0.1
1553,75,22,25,47,3,0.1
1554,75,18,49,67,3,0.1
1555,75,36,37,73,3,0.1
1556,75,36,46,82,3,0.1
1557,75,22,33,55,3,0.1
1558,75,35,55,90,3,0.1
1559,75,31,51,82,3,0.1
1560,75,56,120,176,3,0.1
1561,75,39,79,118,3,0.1
1562,75,47,102,149,3,0.1
1563,75,15,88,103,3,0.1
1564,75,25,36,61,3,0.1
1565,75,20,25,45,3,0.1
1566,75,37,107,144,3,0.1
1567,75,17,53,70,3,0.1
1568,75,5,13,18,3,0.1
1569,75,8,49,57,3,0.1
1570,75,6,14,20,3,0.1
1571,75,10,6,16,3,0.1
1572,75,8,19,27,3,0.1
1573,75,53,107,160,3,0.1
1574,75,12,33,45,3,0.1
1575,75,17,64,81,3,0.1
1576,75,124,306,430,3,0.1
1577,75,53,87,140,3,0.1
1578,75,2,23,25,3,0.1
1579,75,12,49,61,3,0.1
1580,75,20,59,79,3,0.1
1581,75,7,15,22,3,0.1
1582,75,0,17,17,3,0.1
1583,75,16,23,39,3,0.1
1584,75,7,20,27,3,0.1
1585,75,28,24,52,3,0.1
1586,75,8,45,53,3,0.1
1587,75,47,125,172,3,0.1
1588,75,15,28,43,3,0.1
1589,75,80,203,283,3,0.1
1590,75,9,15,24,3,0.1
1591,75,30,103,133,3,0.1
1592,75,44,96,140,3,0.1
1593,75,9,32,41,3,0.1
1594,75,59,178,237,3,0.1
1595,75,41,54,95,3,0.1
1596,75,6,52,58,3,0.1
1597,75,11,34,45,3,0.1
1598,75,13,25,38,3,0.1
1599,75,51,49,100,3,0.1
1600,75,3,16,19,3,0.1
1601,75,2,13,15,3,0.1
1602,75,30,79,109,3,0.1
1603,75,35,70,105,3,0.1
1604,75,4,12,16,3,0.1
1605,75,14,16,30,3,0.1
1606,75,31,107,138,3,0.1
1607,75,20,27,47,3,0.1
1608,75,47,96,143,3,0.1
1609,75,19,18,37,3,0.1
1610,75,18,66,84,3,0.1
1611,75,20,28,48,3,0.1
1612,75,12,71,83,3,0.1
1613,75,6,8,14,3,0.1
1614,75,12,36,48,3,0.1
1615,75,6,33,39,3,0.1
1616,75,3,14,17,3,0.1
1617,75,26,62,88,3,0.1
1618,75,33,69,102,3,0.1
1619,75,22,60,82,3,0.1
1620,75,25,53,78,3,0.1
1621,75,37,64,101,3,0.1
1622,75,76,150,226,3,0.1
1623,75,11,51,62,3,0.1
1624,75,13,55,68,3,0.1
1625,75,17,37,54,3,0.1
1626,75,22,24,46,3,0.1
1627,75,9,35,44,3,0.1
1628,75,16,66,82,3,0.1
1629,75,3,15,18,3,0.1
1630,75,21,49,70,3,0.1
1631,75,27,22,49,3,0.1
1632,75,38,56,94,3,0.1
1633,75,48,60,108,3,0.1
1634,75,39,48,87,3,0.1
1635,75,129,90,219,3,0.1
1636,75,32,88,120,3,0.1
1637,75,8,27,35,3,0.1
1638,75,17,45,62,3,0.1
1639,75,25,44,69,3,0.1
1640,75,8,34,42,3,0.1
1641,75,1,6,7,3,0.1
1642,75,15,22,37,3,0.1
1643,75,31,51,82,3,0.1
1644,75,23,33,56,3,0.1
1645,75,39,80,119,3,0.1
1646,75,22,35,57,3,0.1
1647,75,127,147,274,3,0.1
1648,75,10,21,31,3,0.1
1649,75,26,40,66,3,0.1
1650,75,0,0,0,3,0.1
1651,75,35,58,93,3,1.0
1652,75,4,17,21,3,1.0
1653,75,14,31,45,3,1.0
1654,75,51,43,94,3,1.0
1655,75,26,35,61,3,1.0
1656,75,54,110,164,3,1.0
1657,75,18,48,66,3,1.0
1658,75,5,23,28,3,1.0
1659,75,29,47,76,3,1.0
1660,75,31,82,113,3,1.0
1661,75,22,41,63,3,1.0
1662,75,47,37,84,3,1.0
1663,75,17,30,47,3,1.0
1664,75,10,42,52,3,1.0
1665,75,14,13,27,3,1.0
1666,75,69,147,216,3,1.0
1667,75,20,40,60,3,1.0
1668,75,35,74,109,3,1.0
1669,75,29,54,83,3,1.0
1670,75,107,130,237,3,1.0
1671,75,21,34,55,3,1.0
1672,75,30,42,72,3,1.0
1673,75,67,87,154,3,1.0
1674,75,12,23,35,3,1.0
1675,75,62,131,193,3,1.0
1676,75,19,33,52,3,1.0
1677,75,12,19,31,3,1.0
1678,75,16,70,86,3,1.0
1679,75,24,18,42,3,1.0
1680,75,59,107,166,3,1.0
1681,75,57,82,139,3,1.0
1682,75,18,17,35,3,1.0
1683,75,21,28,49,3,1.0
1684,75,16,22,38,3,1.0
1685,75,3,10,13,3,1.0
1686,75,71,112,183,3,1.0
1687,75,15,13,28,3,1.0
1688,75,6,17,23,3,1.0
1689,75,28,63,91,3,1.0
1690,75,0,6,6,3,1.0
1691,75,22,17,39,3,1.0
1692,75,86,106,192,3,1.0
1693,75,26,56,82,3,1.0
1694,75,29,46,75,3,1.0
1695,75,25,83,108,3,1.0
1696,75,12,19,31,3,1.0
1697,75,37,50,87,3,1.0
1698,75,12,16,28,3,1.0
1699,75,38,29,67,3,1.0
1700,75,20,24,44,3,1.0
1701,75,13,21,34,3,1.0
1702,75,34,68,102,3,1.0
1703,75,49,100,149,3,1.0
1704,75,16,22,38,3,1.0
1705,75,70,208,278,3,1.0
1706,75,38,112,150,3,1.0
1707,75,61,82,143,3,1.0
1708,75,52,70,122,3,1.0
1709,75,64,111,175,3,1.0
1710,75,30,57,87,3,1.0
1711,75,31,67,98,3,1.0
1712,75,69,152,221,3,1.0
1713,75,52,127,179,3,1.0
1714,75,42,94,136,3,1.0
1715,75,78,145,223,3,1.0
1716,75,91,139,230,3,1.0
1717,75,89,123,212,3,1.0
1718,75,89,198,287,3,1.0
1719,75,12,51,63,3,1.0
1720,75,26,30,56,3,1.0
1721,75,87,114,201,3,1.0
1722,75,107,129,236,3,1.0
1723,75,51,103,154,3,1.0
1724,75,58,90,148,3,1.0
1725,75,98,211,309,3,1.0
1726,75,18,22,40,3,1.0
1727,75,17,32,49,3,1.0
1728,75,25,29,54,3,1.0
1729,75,10,26,36,3,1.0
1730,75,32,65,97,3,1.0
1731,75,88,133,221,3,1.0
1732,75,20,26,46,3,1.0
1733,75,44,73,117,3,1.0
1734,75,159,295,454,3,1.0
1735,75,20,55,75,3,1.0
1736,75,119,200,319,3,1.0
1737,75,161,260,421,3,1.0
1738,75,159,318,477,3,1.0
1739,75,114,235,349,3,1.0
1740,75,47,105,152,3,1.0
1741,75,73,117,190,3,1.0
1742,75,47,68,115,3,1.0
1743,75,11,44,55,3,1.0
1744,75,19,42,61,3,1.0
1745,75,39,58,97,3,1.0
1746,75,9,23,32,3,1.0
1747,75,18,18,36,3,1.0
1748,75,10,21,31,3,1.0
1749,75,130,265,395,3,1.0
1750,75,23,51,74,3,1.0
1751,75,93,122,215,3,1.0
1752,75,31,50,81,3,1.0
1753,75,27,35,62,3,1.0
1754,75,54,129,183,3,1.0
1755,75,23,26,49,3,1.0
1756,75,27,41,68,3,1.0
1757,75,30,39,69,3,1.0
1758,75,39,55,94,3,1.0
1759,75,52,134,186,3,1.0
1760,75,57,101,158,3,1.0
1761,75,151,249,400,3,1.0
1762,75,77,122,199,3,1.0
1763,75,61,111,172,3,1.0
1764,75,129,230,359,3,1.0
1765,75,27,60,87,3,1.0
1766,75,158,303,461,3,1.0
1767,75,39,88,127,3,1.0
1768,75,42,71,113,3,1.0
1769,75,34,51,85,3,1.0
1770,75,19,33,52,3,1.0
1771,75,20,23,43,3,1.0
1772,75,41,58,99,3,1.0
1773,75,21,20,41,3,1.0
1774,75,45,56,101,3,1.0
1775,75,56,105,161,3,1.0
1776,75,10,18,28,3,1.0
1777,75,45,75,120,3,1.0
1778,75,40,52,92,3,1.0
1779,75,37,47,84,3,1.0
1780,75,53,134,187,3,1.0
1781,75,11,80,91,3,1.0
1782,75,64,95,159,3,1.0
1783,75,74,169,243,3,1.0
1784,75,10,14,24,3,1.0
1785,75,26,45,71,3,1.0
1786,75,16,31,47,3,1.0
1787,75,38,79,117,3,1.0
1788,75,10,18,28,3,1.0
1789,75,21,41,62,3,1.0
1790,75,172,138,310,3,1.0
1791,75,112,217,329,3,1.0
1792,75,50,119,169,3,1.0
1793,75,41,85,126,3,1.0
1794,75,79,113,192,3,1.0
1795,75,111,236,347,3,1.0
1796,75,23,81,104,3,1.0
1797,75,164,444,608,3,1.0
1798,75,108,188,296,3,1.0
1799,75,31,46,77,3,1.0
1800,75,56,88,144,3,1.0
1801,75,92,134,226,3,1.0
1802,75,21,36,57,3,1.0
1803,75,50,120,170,3,1.0
1804,75,5,39,44,3,1.0
1805,75,23,43,66,3,1.0
1806,75,31,42,73,3,1.0
1807,75,30,78,108,3,1.0
1808,75,20,38,58,3,1.0
1809,75,46,91,137,3,1.0
1810,75,17,29,46,3,1.0
1811,75,41,43,84,3,1.0
1812,75,54,48,102,3,1.0
1813,75,52,73,125,3,1.0
1814,75,29,63,92,3,1.0
1815,75,151,398,549,3,1.0
1816,75,16,72,88,3,1.0
1817,75,25,46,71,3,1.0
1818,75,65,140,205,3,1.0
1819,75,3,15,18,3,1.0
1820,75,8,15,23,3,1.0
1821,75,18,4,22,3,1.0
1822,75,23,39,62,3,1.0
1823,75,36,51,87,3,1.0
1824,75,17,39,56,3,1.0
1825,75,50,101,151,3,1.0
1826,75,32,58,90,3,1.0
1827,75,59,90,149,3,1.0
1828,75,32,45,77,3,1.0
1829,75,21,49,70,3,1.0
1830,75,20,37,57,3,1.0
1831,75,24,31,55,3,1.0
1832,75,17,29,46,3,1.0
1833,75,12,13,25,3,1.0
1834,75,48,107,155,3,1.0
1835,75,20,21,41,3,1.0
1836,75,5,12,17,3,1.0
1837,75,3,14,17,3,1.0
1838,75,17,25,42,3,1.0
1839,75,14,32,46,3,1.0
1840,75,17,40,57,3,1.0
1841,75,34,53,87,3,1.0
1842,75,15,36,51,3,1.0
1843,75,33,60,93,3,1.0
1844,75,40,69,109,3,1.0
1845,75,22,26,48,3,1.0
1846,75,24,52,76,3,1.0
1847,75,26,51,77,3,1.0
1848,75,30,75,105,3,1.0
1849,75,16,27,43,3,1.0
1850,75,50,100,150,3,1.0
1851,75,50,100,150,3,1.0
1852,75,53,77,130,3,1.0
1853,75,22,30,52,3,1.0
1854,75,22,20,42,3,1.0
1855,75,40,66,106,3,1.0
1856,75,17,36,53,3,1.0
1857,75,17,38,55,3,1.0
1858,75,38,55,93,3,1.0
1859,75,93,156,249,3,1.0
1860,75,21,33,54,3,1.0
1861,75,73,150,223,3,1.0
1862,75,63,114,177,3,1.0
1863,75,62,56,118,3,1.0
1864,75,42,58,100,3,1.0
1865,75,57,89,146,3,1.0
1866,75,75,90,165,3,1.0
1867,75,17,28,45,3,1.0
1868,75,61,106,167,3,1.0
1869,75,21,42,63,3,1.0
1870,75,55,103,158,3,1.0
1871,75,3,12,15,3,1.0
1872,75,2,6,8,3,1.0
1873,75,45,80,125,3,1.0
1874,75,38,70,108,3,1.0
1875,75,67,132,199,3,1.0
1876,75,20,22,42,3,1.0
1877,75,48,96,144,3,1.0
1878,75,53,85,138,3,1.0
1879,75,18,37,55,3,1.0
1880,75,37,68,105,3,1.0
1881,75,27,28,55,3,1.0
1882,75,9,12,21,3,1.0
1883,75,83,191,274,3,1.0
1884,75,39,100,139,3,1.0
1885,75,55,73,128,3,1.0
1886,75,23,38,61,3,1.0
1887,75,32,60,92,3,1.0
1888,75,22,58,80,3,1.0
1889,75,64,74,138,3,1.0
1890,75,20,17,37,3,1.0
1891,75,25,27,52,3,1.0
1892,75,11,15,26,3,1.0
1893,75,14,18,32,3,1.0
1894,75,11,10,21,3,1.0
1895,75,19,22,41,3,1.0
1896,75,5,15,20,3,1.0
1897,75,29,14,43,3,1.0
1898,75,22,56,78,3,1.0
1899,75,62,114,176,3,1.0
1900,75,42,78,120,3,1.0
1901,75,30,71,101,3,1.0
1902,75,8,16,24,3,1.0
1903,75,39,76,115,3,1.0
1904,75,52,31,83,3,1.0
1905,75,60,136,196,3,1.0
1906,75,98,229,327,3,1.0
1907,75,40,89,129,3,1.0
1908,75,29,77,106,3,1.0
1909,75,113,410,523,3,1.0
1910,75,28,63,91,3,1.0
1911,75,68,91,159,3,1.0
1912,75,27,36,63,3,1.0
1913,75,6,26,32,3,1.0
1914,75,64,125,189,3,1.0
1915,75,19,23,42,3,1.0
1916,75,76,179,255,3,1.0
1917,75,26,32,58,3,1.0
1918,75,45,83,128,3,1.0
1919,75,27,80,107,3,1.0
1920,75,54,76,130,3,1.0
1921,75,96,146,242,3,1.0
1922,75,34,67,101,3,1.0
1923,75,23,101,124,3,1.0
1924,75,54,63,117,3,1.0
1925,75,44,89,133,3,1.0
1926,75,61,74,135,3,1.0
1927,75,26,81,107,3,1.0
1928,75,24,63,87,3,1.0
1929,75,45,80,125,3,1.0
1930,75,11,50,61,3,1.0
1931,75,13,61,74,3,1.0
1932,75,114,120,234,3,1.0
1933,75,26,63,89,3,1.0
1934,75,46,73,119,3,1.0
1935,75,21,14,35,3,1.0
1936,75,24,43,67,3,1.0
1937,75,43,72,115,3,1.0
1938,75,3,12,15,3,1.0
1939,75,56,60,116,3,1.0
1940,75,37,162,199,3,1.0
1941,75,116,129,245,3,1.0
1942,75,46,82,128,3,1.0
1943,75,19,41,60,3,1.0
1944,75,7,12,19,3,1.0
1945,75,59,57,116,3,1.0
1946,75,9,24,33,3,1.0
1947,75,23,100,123,3,1.0
1948,75,19,45,64,3,1.0
1949,75,43,81,124,3,1.0
1950,75,18,28,46,3,1.0
1951,75,28,31,59,3,1.0
1952,75,16,63,79,3,1.0
1953,75,59,230,289,3,1.0
1954,75,91,123,214,3,1.0
1955,75,177,293,470,3,1.0
1956,75,119,205,324,3,1.0
1957,75,29,84,113,3,1.0
1958,75,32,29,61,3,1.0
1959,75,71,263,334,3,1.0
1960,75,72,172,244,3,1.0
1961,75,30,46,76,3,1.0
1962,75,21,23,44,3,1.0
1963,75,11,20,31,3,1.0
1964,75,17,84,101,3,1.0
1965,75,67,71,138,3,1.0
1966,75,29,38,67,3,1.0
1967,75,55,98,153,3,1.0
1968,75,55,103,158,3,1.0
1969,75,31,70,101,3,1.0
1970,75,50,35,85,3,1.0
1971,75,58,104,162,3,1.0
1972,75,57,53,110,3,1.0
1973,75,5,22,27,3,1.0
1974,75,66,139,205,3,1.0
1975,75,0,15,15,3,1.0
1976,75,26,35,61,3,1.0
1977,75,70,227,297,3,1.0
1978,75,11,15,26,3,1.0
1979,75,21,17,38,3,1.0
1980,75,1,11,12,3,1.0
1981,75,3,6,9,3,1.0
1982,75,22,48,70,3,1.0
1983,75,30,36,66,3,1.0
1984,75,21,34,55,3,1.0
1985,75,43,68,111,3,1.0
1986,75,36,83,119,3,1.0
1987,75,40,54,94,3,1.0
1988,75,116,345,461,3,1.0
1989,75,64,133,197,3,1.0
1990,75,28,46,74,3,1.0
1991,75,12,12,24,3,1.0
1992,75,58,59,117,3,1.0
1993,75,28,52,80,3,1.0
1994,75,6,25,31,3,1.0
1995,75,27,30,57,3,1.0
1996,75,59,106,165,3,1.0
1997,75,4,26,30,3,1.0
1998,75,102,151,253,3,1.0
1999,75,75,142,217,3,1.0
2000,75,51,75,126,3,1.0
2001,75,82,156,238,3,1.0
2002,75,56,138,194,3,1.0
2003,75,49,78,127,3,1.0
2004,75,56,115,171,3,1.0
2005,75,14,29,43,3,1.0
2006,75,14,71,85,3,1.0
2007,75,22,42,64,3,1.0
2008,75,40,121,161,3,1.0
2009,75,3,19,22,3,1.0
2010,75,27,93,120,3,1.0
2011,75,44,68,112,3,1.0
2012,75,40,124,164,3,1.0
2013,75,27,58,85,3,1.0
2014,75,26,66,92,3,1.0
2015,75,49,159,208,3,1.0
2016,75,59,138,197,3,1.0
2017,75,30,230,260,3,1.0
2018,75,30,76,106,3,1.0
2019,75,28,82,110,3,1.0
2020,75,8,7,15,3,1.0
2021,75,13,20,33,3,1.0
2022,75,28,79,107,3,1.0
2023,75,28,54,82,3,1.0
2024,75,42,128,170,3,1.0
2025,75,42,70,112,3,1.0
2026,75,59,148,207,3,1.0
2027,75,37,111,148,3,1.0
2028,75,38,73,111,3,1.0
2029,75,108,345,453,3,1.0
2030,75,32,93,125,3,1.0
2031,75,57,95,152,3,1.0
2032,75,98,225,323,3,1.0
2033,75,75,155,230,3,1.0
2034,75,60,148,208,3,1.0
2035,75,71,203,274,3,1.0
2036,75,37,83,120,3,1.0
2037,75,32,41,73,3,1.0
2038,75,117,111,228,3,1.0
2039,75,101,150,251,3,1.0
2040,75,25,30,55,3,1.0
2041,75,150,198,348,3,1.0
2042,75,28,31,59,3,1.0
2043,75,120,156,276,3,1.0
2044,75,62,116,178,3,1.0
2045,75,17,50,67,3,1.0
2046,75,23,63,86,3,1.0
2047,75,156,91,247,3,10.0
2048,75,74,91,165,3,10.0
2049,75,64,106,170,3,10.0
2050,75,69,107,176,3,10.0
2051,75,99,172,271,3,10.0
2052,75,31,61,92,3,10.0
2053,75,179,293,472,3,10.0
2054,75,69,89,158,3,10.0
2055,75,72,143,215,3,10.0
2056,75,16,48,64,3,10.0
2057,75,15,38,53,3,10.0
2058,75,17,46,63,3,10.0
2059,75,32,102,134,3,10.0
2060,75,133,145,278,3,10.0
2061,75,7,55,62,3,10.0
2062,75,40,67,107,3,10.0
2063,75,113,203,316,3,10.0
2064,75,127,191,318,3,10.0
2065,75,77,198,275,3,10.0
2066,75,94,172,266,3,10.0
2067,75,107,214,321,3,10.0
2068,75,138,277,415,3,10.0
2069,75,65,80,145,3,10.0
2070,75,121,220,341,3,10.0
2071,75,43,71,114,3,10.0
2072,75,120,252,372,3,10.0
2073,75,29,78,107,3,10.0
2074,75,39,115,154,3,10.0
2075,75,101,119,220,3,10.0
2076,75,140,197,337,3,10.0
2077,75,128,257,385,3,10.0
2078,75,75,99,174,3,10.0
2079,75,148,201,349,3,10.0
2080,75,75,159,234,3,10.0
2081,75,169,279,448,3,10.0
2082,75,93,135,228,3,10.0
2083,75,66,217,283,3,10.0
2084,75,90,177,267,3,10.0
2085,75,41,129,170,3,10.0
2086,75,72,46,118,3,10.0
2087,75,60,82,142,3,10.0
2088,75,89,163,252,3,10.0
2089,75,102,92,194,3,10.0
2090,75,62,115,177,3,10.0
2091,75,39,115,154,3,10.0
2092,75,62,137,199,3,10.0
2093,75,151,309,460,3,10.0
2094,75,36,71,107,3,10.0
2095,75,50,94,144,3,10.0
2096,75,164,296,460,3,10.0
2097,75,51,120,171,3,10.0
2098,75,36,116,152,3,10.0
2099,75,40,43,83,3,10.0
2100,75,71,80,151,3,10.0
2101,75,30,37,67,3,10.0
2102,75,34,33,67,3,10.0
2103,75,32,90,122,3,10.0
2104,75,64,114,178,3,10.0
2105,75,45,102,147,3,10.0
2106,75,25,85,110,3,10.0
2107,75,48,107,155,3,10.0
2108,75,16,53,69,3,10.0
2109,75,55,107,162,3,10.0
2110,75,106,191,297,3,10.0
2111,75,61,103,164,3,10.0
2112,75,95,114,209,3,10.0
2113,75,49,97,146,3,10.0
2114,75,52,140,192,3,10.0
2115,75,66,135,201,3,10.0
2116,75,78,137,215,3,10.0
2117,75,156,280,436,3,10.0
2118,75,149,230,379,3,10.0
2119,75,96,173,269,3,10.0
2120,75,97,144,241,3,10.0
2121,75,104,247,351,3,10.0
2122,75,82,154,236,3,10.0
2123,75,111,280,391,3,10.0
2124,75,34,95,129,3,10.0
2125,75,58,168,226,3,10.0
2126,75,57,108,165,3,10.0
2127,75,62,107,169,3,10.0
2128,75,86,188,274,3,10.0
2129,75,57,138,195,3,10.0
2130,75,64,115,179,3,10.0
2131,75,42,76,118,3,10.0
2132,75,66,140,206,3,10.0
2133,75,25,43,68,3,10.0
2134,75,69,123,192,3,10.0
2135,75,100,175,275,3,10.0
2136,75,29,75,104,3,10.0
2137,75,17,83,100,3,10.0
2138,75,24,74,98,3,10.0
2139,75,51,91,142,3,10.0
2140,75,111,164,275,3,10.0
2141,75,79,151,230,3,10.0
2142,75,129,215,344,3,10.0
2143,75,71,103,174,3,10.0
2144,75,64,75,139,3,10.0
2145,75,31,67,98,3,10.0
2146,75,106,121,227,3,10.0
2147,75,51,93,144,3,10.0
2148,75,109,158,267,3,10.0
2149,75,76,193,269,3,10.0
2150,75,65,125,190,3,10.0
2151,75,37,66,103,3,10.0
2152,75,44,58,102,3,10.0
2153,75,24,30,54,3,10.0
2154,75,29,80,109,3,10.0
2155,75,98,156,254,3,10.0
2156,75,55,62,117,3,10.0
2157,75,16,71,87,3,10.0
2158,75,98,181,279,3,10.0
2159,75,26,38,64,3,10.0
2160,75,55,146,201,3,10.0
2161,75,59,129,188,3,10.0
2162,75,80,158,238,3,10.0
2163,75,42,100,142,3,10.0
2164,75,61,75,136,3,10.0
2165,75,149,197,346,3,10.0
2166,75,36,92,128,3,10.0
2167,75,61,118,179,3,10.0
2168,75,53,98,151,3,10.0
2169,75,80,142,222,3,10.0
2170,75,81,149,230,3,10.0
2171,75,62,51,113,3,10.0
2172,75,20,17,37,3,10.0
2173,75,74,73,147,3,10.0
2174,75,61,153,214,3,10.0
2175,75,67,117,184,3,10.0
2176,75,51,146,197,3,10.0
2177,75,27,59,86,3,10.0
2178,75,78,108,186,3,10.0
2179,75,63,188,251,3,10.0
2180,75,23,177,200,3,10.0
2181,75,24,62,86,3,10.0
2182,75,15,42,57,3,10.0
2183,75,136,246,382,3,10.0
2184,75,53,62,115,3,10.0
2185,75,62,38,100,3,10.0
2186,75,115,176,291,3,10.0
2187,75,53,120,173,3,10.0
2188,75,113,248,361,3,10.0
2189,75,107,281,388,3,10.0
2190,75,118,155,273,3,10.0
2191,75,23,35,58,3,10.0
2192,75,158,353,511,3,10.0
2193,75,107,204,311,3,10.0
2194,75,175,382,557,3,10.0
2195,75,85,186,271,3,10.0
2196,75,17,36,53,3,10.0
2197,75,194,320,514,3,10.0
2198,75,47,68,115,3,10.0
2199,75,28,39,67,3,10.0
2200,75,81,64,145,3,10.0
2201,75,83,188,271,3,10.0
2202,75,63,96,159,3,10.0
2203,75,95,191,286,3,10.0
2204,75,72,88,160,3,10.0
2205,75,80,106,186,3,10.0
2206,75,78,115,193,3,10.0
2207,75,38,113,151,3,10.0
2208,75,52,119,171,3,10.0
2209,75,33,105,138,3,10.0
2210,75,40,99,139,3,10.0
2211,75,109,241,350,3,10.0
2212,75,69,166,235,3,10.0
2213,75,67,150,217,3,10.0
2214,75,44,75,119,3,10.0
2215,75,141,216,357,3,10.0
2216,75,76,187,263,3,10.0
2217,75,110,225,335,3,10.0
2218,75,206,221,427,3,10.0
2219,75,44,73,117,3,10.0
2220,75,57,101,158,3,10.0
2221,75,32,89,121,3,10.0
2222,75,47,123,170,3,10.0
2223,75,12,16,28,3,10.0
2224,75,112,139,251,3,10.0
2225,75,17,75,92,3,10.0
2226,75,138,261,399,3,10.0
2227,75,85,103,188,3,10.0
2228,75,60,83,143,3,10.0
2229,75,57,80,137,3,10.0
2230,75,36,74,110,3,10.0
2231,75,13,44,57,3,10.0
2232,75,93,163,256,3,10.0
2233,75,89,144,233,3,10.0
2234,75,33,83,116,3,10.0
2235,75,54,114,168,3,10.0
2236,75,30,62,92,3,10.0
2237,75,29,103,132,3,10.0
2238,75,26,72,98,3,10.0
2239,75,111,141,252,3,10.0
2240,75,93,105,198,3,10.0
2241,75,98,171,269,3,10.0
2242,75,43,66,109,3,10.0
2243,75,89,87,176,3,10.0
2244,75,85,116,201,3,10.0
2245,75,74,108,182,3,10.0
2246,75,15,54,69,3,10.0
2247,75,71,95,166,3,10.0
2248,75,42,61,103,3,10.0
2249,75,28,101,129,3,10.0
2250,75,26,78,104,3,10.0
2251,75,47,134,181,3,10.0
2252,75,55,80,135,3,10.0
2253,75,36,41,77,3,10.0
2254,75,81,77,158,3,10.0
2255,75,97,116,213,3,10.0
2256,75,145,157,302,3,10.0
2257,75,72,67,139,3,10.0
2258,75,75,123,198,3,10.0
2259,75,58,146,204,3,10.0
2260,75,88,59,147,3,10.0
2261,75,39,60,99,3,10.0
2262,75,111,174,285,3,10.0
2263,75,121,75,196,3,10.0
2264,75,167,232,399,3,10.0
2265,75,239,223,462,3,10.0
2266,75,33,44,77,3,10.0
2267,75,113,149,262,3,10.0
2268,75,194,321,515,3,10.0
2269,75,175,203,378,3,10.0
2270,75,50,128,178,3,10.0
2271,75,98,173,271,3,10.0
2272,75,126,231,357,3,10.0
2273,75,228,580,808,3,10.0
2274,75,157,158,315,3,10.0
2275,75,69,56,125,3,10.0
2276,75,77,144,221,3,10.0
2277,75,76,146,222,3,10.0
2278,75,76,129,205,3,10.0
2279,75,55,90,145,3,10.0
2280,75,23,63,86,3,10.0
2281,75,181,300,481,3,10.0
2282,75,101,170,271,3,10.0
2283,75,28,70,98,3,10.0
2284,75,26,53,79,3,10.0
2285,75,30,71,101,3,10.0
2286,75,199,204,403,3,10.0
2287,75,62,138,200,3,10.0
2288,75,61,136,197,3,10.0
2289,75,126,114,240,3,10.0
2290,75,73,84,157,3,10.0
2291,75,100,151,251,3,10.0
2292,75,115,192,307,3,10.0
2293,75,73,153,226,3,10.0
2294,75,58,174,232,3,10.0
2295,75,51,115,166,3,10.0
2296,75,79,94,173,3,10.0
2297,75,52,77,129,3,10.0
2298,75,63,100,163,3,10.0
2299,75,38,58,96,3,10.0
2300,75,73,112,185,3,10.0
2301,75,41,60,101,3,10.0
2302,75,85,124,209,3,10.0
2303,75,77,61,138,3,10.0
2304,75,37,75,112,3,10.0
2305,75,85,137,222,3,10.0
2306,75,87,121,208,3,10.0
2307,75,229,378,607,3,10.0
2308,75,170,341,511,3,10.0
2309,75,86,160,246,3,10.0
2310,75,37,57,94,3,10.0
2311,75,25,55,80,3,10.0
2312,75,55,149,204,3,10.0
2313,75,59,141,200,3,10.0
2314,75,54,163,217,3,10.0
2315,75,35,194,229,3,10.0
2316,75,19,57,76,3,10.0
2317,75,153,168,321,3,10.0
2318,75,64,121,185,3,10.0
2319,75,64,119,183,3,10.0
2320,75,79,79,158,3,10.0
2321,75,70,150,220,3,10.0
2322,75,37,39,76,3,10.0
2323,75,147,175,322,3,10.0
2324,75,11,22,33,3,10.0
2325,75,142,223,365,3,10.0
2326,75,68,112,180,3,10.0
2327,75,48,83,131,3,10.0
2328,75,25,63,88,3,10.0
2329,75,38,145,183,3,10.0
2330,75,27,32,59,3,10.0
2331,75,32,127,159,3,10.0
2332,75,43,66,109,3,10.0
2333,75,134,215,349,3,10.0
2334,75,138,153,291,3,10.0
2335,75,53,193,246,3,10.0
2336,75,155,301,456,3,10.0
2337,75,129,167,296,3,10.0
2338,75,158,273,431,3,10.0
2339,75,71,99,170,3,10.0
2340,75,93,213,306,3,10.0
2341,75,124,253,377,3,10.0
2342,75,81,230,311,3,10.0
2343,75,102,201,303,3,10.0
2344,75,111,215,326,3,10.0
2345,75,122,232,354,3,10.0
2346,75,162,222,384,3,10.0
2347,75,45,82,127,3,10.0
2348,75,83,143,226,3,10.0
2349,75,134,55,189,3,10.0
2350,75,29,39,68,3,10.0
2351,75,31,120,151,3,10.0
2352,75,53,147,200,3,10.0
2353,75,57,151,208,3,10.0
2354,75,177,403,580,3,10.0
2355,75,72,115,187,3,10.0
2356,75,97,155,252,3,10.0
2357,75,112,236,348,3,10.0
2358,75,86,187,273,3,10.0
2359,75,9,87,96,3,10.0
2360,75,99,209,308,3,10.0
2361,75,72,97,169,3,10.0
2362,75,54,55,109,3,10.0
2363,75,102,178,280,3,10.0
2364,75,31,87,118,3,10.0
2365,75,80,177,257,3,10.0
2366,75,26,44,70,3,10.0
2367,75,85,107,192,3,10.0
2368,75,39,20,59,3,10.0
2369,75,74,150,224,3,10.0
2370,75,73,114,187,3,10.0
2371,75,106,178,284,3,10.0
2372,75,164,331,495,3,10.0
2373,75,80,134,214,3,10.0
2374,75,47,58,105,3,10.0
2375,75,50,107,157,3,10.0
2376,75,102,146,248,3,10.0
2377,75,45,97,142,3,10.0
2378,75,79,143,222,3,10.0
2379,75,79,128,207,3,10.0
2380,75,103,189,292,3,10.0
2381,75,13,25,38,3,10.0
2382,75,46,114,160,3,10.0
2383,75,102,267,369,3,10.0
2384,75,79,188,267,3,10.0
2385,75,94,207,301,3,10.0
2386,75,108,165,273,3,10.0
2387,75,52,83,135,3,10.0
2388,75,128,255,383,3,10.0
2389,75,36,112,148,3,10.0
2390,75,45,68,113,3,10.0
2391,75,36,95,131,3,10.0
2392,75,59,76,135,3,10.0
2393,75,75,134,209,3,10.0
2394,75,16,43,59,3,10.0
2395,75,117,351,468,3,10.0
2396,75,85,228,313,3,10.0
2397,75,166,205,371,3,10.0
2398,75,139,203,342,3,10.0
2399,75,117,207,324,3,10.0
2400,75,110,155,265,3,10.0
2401,75,186,294,480,3,10.0
2402,75,96,245,341,3,10.0
2403,75,216,959,1175,3,10.0
2404,75,137,292,429,3,10.0
2405,75,53,159,212,3,10.0
2406,75,90,148,238,3,10.0
2407,75,42,44,86,3,10.0
2408,75,21,40,61,3,10.0
2409,75,5,59,64,3,10.0
2410,75,113,167,280,3,10.0
2411,75,56,80,136,3,10.0
2412,75,56,89,145,3,10.0
2413,75,44,63,107,3,10.0
2414,75,37,63,100,3,10.0
2415,75,74,138,212,3,10.0
2416,75,126,249,375,3,10.0
2417,75,105,182,287,3,10.0
2418,75,72,207,279,3,10.0
2419,75,67,296,363,3,10.0
2420,75,50,152,202,3,10.0
2421,75,36,209,245,3,10.0
2422,75,85,178,263,3,10.0
2423,75,109,108,217,3,10.0
2424,75,47,89,136,3,10.0
2425,75,88,183,271,3,10.0
2426,75,9,17,26,3,10.0
2427,75,29,57,86,3,10.0
2428,75,13,48,61,3,10.0
2429,75,54,110,164,3,10.0
2430,75,41,105,146,3,10.0
2431,75,25,75,100,3,10.0
2432,75,53,150,203,3,10.0
2433,75,32,30,62,3,10.0
2434,75,50,69,119,3,10.0
2435,75,63,214,277,3,10.0
2436,75,60,143,203,3,10.0
2437,75,44,76,120,3,10.0
2438,75,46,82,128,3,10.0
2439,75,47,60,107,3,10.0
2440,75,43,232,275,3,10.0
2441,75,41,100,141,3,10.0
2442,75,38,119,157,3,10.0
2443,75,88,232,320,3,10.0
2444,75,98,249,347,3,10.0
2445,75,17,48,65,3,10.0
2446,75,71,203,274,3,10.0
2447,75,7,6,13,3,10.0
2448,75,45,115,160,3,100.0
2449,75,78,134,212,3,100.0
2450,75,158,208,366,3,100.0
2451,75,47,110,157,3,100.0
2452,75,172,194,366,3,100.0
2453,75,78,185,263,3,100.0
2454,75,85,201,286,3,100.0
2455,75,152,256,408,3,100.0
2456,75,220,305,525,3,100.0
2457,75,103,184,287,3,100.0
2458,75,37,89,126,3,100.0
2459,75,58,91,149,3,100.0
2460,75,50,123,173,3,100.0
2461,75,13,33,46,3,100.0
2462,75,27,40,67,3,100.0
2463,75,38,62,100,3,100.0
2464,75,16,35,51,3,100.0
2465,75,124,147,271,3,100.0
2466,75,93,196,289,3,100.0
2467,75,79,95,174,3,100.0
2468,75,96,173,269,3,100.0
2469,75,109,150,259,3,100.0
2470,75,102,110,212,3,100.0
2471,75,59,79,138,3,100.0
2472,75,84,129,213,3,100.0
2473,75,24,78,102,3,100.0
2474,75,71,122,193,3,100.0
2475,75,47,76,123,3,100.0
2476,75,80,145,225,3,100.0
2477,75,33,47,80,3,100.0
2478,75,113,255,368,3,100.0
2479,75,66,201,267,3,100.0
2480,75,41,123,164,3,100.0
2481,75,122,224,346,3,100.0
2482,75,57,196,253,3,100.0
2483,75,45,121,166,3,100.0
2484,75,33,78,111,3,100.0
2485,75,46,109,155,3,100.0
2486,75,114,143,257,3,100.0
2487,75,48,205,253,3,100.0
2488,75,15,37,52,3,100.0
2489,75,89,194,283,3,100.0
2490,75,107,198,305,3,100.0
2491,75,59,184,243,3,100.0
2492,75,130,278,408,3,100.0
2493,75,63,192,255,3,100.0
2494,75,69,222,291,3,100.0
2495,75,71,127,198,3,100.0
2496,75,62,180,242,3,100.0
2497,75,48,243,291,3,100.0
2498,75,6,105,111,3,100.0
2499,75,92,292,384,3,100.0
2500,75,74,161,235,3,100.0
2501,75,65,226,291,3,100.0
2502,75,137,369,506,3,100.0
2503,75,71,171,242,3,100.0
2504,75,109,313,422,3,100.0
2505,75,143,477,620,3,100.0
2506,75,135,112,247,3,100.0
2507,75,107,139,246,3,100.0
2508,75,80,528,608,3,100.0
2509,75,22,42,64,3,100.0
2510,75,12,85,97,3,100.0
2511,75,351,520,871,3,100.0
2512,75,163,275,438,3,100.0
2513,75,54,129,183,3,100.0
2514,75,78,197,275,3,100.0
2515,75,39,68,107,3,100.0
2516,75,51,99,150,3,100.0
2517,75,55,141,196,3,100.0
2518,75,66,93,159,3,100.0
2519,75,177,325,502,3,100.0
2520,75,27,65,92,3,100.0
2521,75,26,49,75,3,100.0
2522,75,146,260,406,3,100.0
2523,75,11,26,37,3,100.0
2524,75,62,106,168,3,100.0
2525,75,121,233,354,3,100.0
2526,75,134,329,463,3,100.0
2527,75,289,276,565,3,100.0
2528,75,50,147,197,3,100.0
2529,75,60,58,118,3,100.0
2530,75,92,182,274,3,100.0
2531,75,113,232,345,3,100.0
2532,75,95,147,242,3,100.0
2533,75,85,194,279,3,100.0
2534,75,66,194,260,3,100.0
2535,75,80,124,204,3,100.0
2536,75,58,215,273,3,100.0
2537,75,26,48,74,3,100.0
2538,75,27,94,121,3,100.0
2539,75,25,70,95,3,100.0
2540,75,81,134,215,3,100.0
2541,75,73,123,196,3,100.0
2542,75,91,122,213,3,100.0
2543,75,101,156,257,3,100.0
2544,75,43,46,89,3,100.0
2545,75,58,124,182,3,100.0
2546,75,63,110,173,3,100.0
2547,75,85,188,273,3,100.0
2548,75,33,65,98,3,100.0
2549,75,44,153,197,3,100.0
2550,75,26,48,74,3,100.0
2551,75,22,23,45,3,100.0
2552,75,95,184,279,3,100.0
2553,75,35,104,139,3,100.0
2554,75,97,189,286,3,100.0
2555,75,51,74,125,3,100.0
2556,75,97,214,311,3,100.0
2557,75,87,133,220,3,100.0
2558,75,177,352,529,3,100.0
2559,75,108,174,282,3,100.0
2560,75,36,124,160,3,100.0
2561,75,67,174,241,3,100.0
2562,75,76,193,269,3,100.0
2563,75,51,111,162,3,100.0
2564,75,51,157,208,3,100.0
2565,75,34,77,111,3,100.0
2566,75,7,10,17,3,100.0
2567,75,46,170,216,3,100.0
2568,75,50,67,117,3,100.0
2569,75,44,47,91,3,100.0
2570,75,42,58,100,3,100.0
2571,75,73,119,192,3,100.0
2572,75,114,184,298,3,100.0
2573,75,27,66,93,3,100.0
2574,75,50,76,126,3,100.0
2575,75,29,78,107,3,100.0
2576,75,67,115,182,3,100.0
2577,75,22,55,77,3,100.0
2578,75,18,52,70,3,100.0
2579,75,45,90,135,3,100.0
2580,75,141,230,371,3,100.0
2581,75,95,202,297,3,100.0
2582,75,222,331,553,3,100.0
2583,75,52,126,178,3,100.0
2584,75,114,168,282,3,100.0
2585,75,32,83,115,3,100.0
2586,75,80,188,268,3,100.0
2587,75,43,95,138,3,100.0
2588,75,125,143,268,3,100.0
2589,75,71,100,171,3,100.0
2590,75,101,122,223,3,100.0
2591,75,46,82,128,3,100.0
2592,75,129,225,354,3,100.0
2593,75,65,116,181,3,100.0
2594,75,217,324,541,3,100.0
2595,75,106,140,246,3,100.0
2596,75,80,168,248,3,100.0
2597,75,207,237,444,3,100.0
2598,75,55,163,218,3,100.0
2599,75,45,73,118,3,100.0
2600,75,124,156,280,3,100.0
2601,75,10,19,29,3,100.0
2602,75,154,185,339,3,100.0
2603,75,135,223,358,3,100.0
2604,75,71,153,224,3,100.0
2605,75,129,261,390,3,100.0
2606,75,111,112,223,3,100.0
2607,75,74,158,232,3,100.0
2608,75,51,117,168,3,100.0
2609,75,76,135,211,3,100.0
2610,75,91,222,313,3,100.0
2611,75,163,229,392,3,100.0
2612,75,100,88,188,3,100.0
2613,75,27,67,94,3,100.0
2614,75,46,95,141,3,100.0
2615,75,77,100,177,3,100.0
2616,75,48,83,131,3,100.0
2617,75,176,349,525,3,100.0
2618,75,58,115,173,3,100.0
2619,75,71,129,200,3,100.0
2620,75,42,80,122,3,100.0
2621,75,105,311,416,3,100.0
2622,75,8,15,23,3,100.0
2623,75,53,71,124,3,100.0
2624,75,40,80,120,3,100.0
2625,75,18,26,44,3,100.0
2626,75,151,279,430,3,100.0
2627,75,241,340,581,3,100.0
2628,75,63,115,178,3,100.0
2629,75,49,69,118,3,100.0
2630,75,73,326,399,3,100.0
2631,75,51,162,213,3,100.0
2632,75,47,111,158,3,100.0
2633,75,75,178,253,3,100.0
2634,75,38,109,147,3,100.0
2635,75,50,96,146,3,100.0
2636,75,40,102,142,3,100.0
2637,75,121,268,389,3,100.0
2638,75,88,124,212,3,100.0
2639,75,43,68,111,3,100.0
2640,75,91,111,202,3,100.0
2641,75,31,102,133,3,100.0
2642,75,51,91,142,3,100.0
2643,75,39,97,136,3,100.0
2644,75,14,27,41,3,100.0
2645,75,114,145,259,3,100.0
2646,75,44,171,215,3,100.0
2647,75,38,247,285,3,100.0
2648,75,87,178,265,3,100.0
2649,75,85,107,192,3,100.0
2650,75,66,190,256,3,100.0
2651,75,37,58,95,3,100.0
2652,75,26,99,125,3,100.0
2653,75,35,69,104,3,100.0
2654,75,73,192,265,3,100.0
2655,75,58,84,142,3,100.0
2656,75,37,87,124,3,100.0
2657,75,19,159,178,3,100.0
2658,75,42,64,106,3,100.0
2659,75,57,128,185,3,100.0
2660,75,65,87,152,3,100.0
2661,75,184,223,407,3,100.0
2662,75,64,118,182,3,100.0
2663,75,74,145,219,3,100.0
2664,75,45,101,146,3,100.0
2665,75,139,315,454,3,100.0
2666,75,10,54,64,3,100.0
2667,75,39,82,121,3,100.0
2668,75,9,25,34,3,100.0
2669,75,107,117,224,3,100.0
2670,75,73,115,188,3,100.0
2671,75,139,70,209,3,100.0
2672,75,15,43,58,3,100.0
2673,75,30,56,86,3,100.0
2674,75,95,133,228,3,100.0
2675,75,56,137,193,3,100.0
2676,75,94,77,171,3,100.0
2677,75,97,89,186,3,100.0
2678,75,100,165,265,3,100.0
2679,75,198,149,347,3,100.0
2680,75,56,101,157,3,100.0
2681,75,44,85,129,3,100.0
2682,75,49,136,185,3,100.0
2683,75,24,40,64,3,100.0
2684,75,82,120,202,3,100.0
2685,75,40,71,111,3,100.0
2686,75,65,188,253,3,100.0
2687,75,40,78,118,3,100.0
2688,75,46,160,206,3,100.0
2689,75,22,84,106,3,100.0
2690,75,32,87,119,3,100.0
2691,75,83,172,255,3,100.0
2692,75,164,255,419,3,100.0
2693,75,52,59,111,3,100.0
2694,75,121,135,256,3,100.0
2695,75,65,125,190,3,100.0
2696,75,98,81,179,3,100.0
2697,75,98,150,248,3,100.0
2698,75,87,181,268,3,100.0
2699,75,69,84,153,3,100.0
2700,75,84,189,273,3,100.0
2701,75,65,95,160,3,100.0
2702,75,55,71,126,3,100.0
2703,75,53,148,201,3,100.0
2704,75,42,33,75,3,100.0
2705,75,20,45,65,3,100.0
2706,75,83,203,286,3,100.0
2707,75,25,171,196,3,100.0
2708,75,112,121,233,3,100.0
2709,75,80,104,184,3,100.0
2710,75,34,55,89,3,100.0
2711,75,105,195,300,3,100.0
2712,75,202,358,560,3,100.0
2713,75,37,108,145,3,100.0
2714,75,13,33,46,3,100.0
2715,75,73,83,156,3,100.0
2716,75,74,122,196,3,100.0
2717,75,151,169,320,3,100.0
2718,75,53,177,230,3,100.0
2719,75,92,224,316,3,100.0
2720,75,14,29,43,3,100.0
2721,75,24,28,52,3,100.0
2722,75,69,145,214,3,100.0
2723,75,34,98,132,3,100.0
2724,75,107,172,279,3,100.0
2725,75,52,90,142,3,100.0
2726,75,157,233,390,3,100.0
2727,75,23,50,73,3,100.0
2728,75,42,103,145,3,100.0
2729,75,23,29,52,3,100.0
2730,75,92,117,209,3,100.0
2731,75,60,89,149,3,100.0
2732,75,71,129,200,3,100.0
2733,75,61,93,154,3,100.0
2734,75,121,114,235,3,100.0
2735,75,59,88,147,3,100.0
2736,75,33,49,82,3,100.0
2737,75,122,172,294,3,100.0
2738,75,68,106,174,3,100.0
2739,75,14,21,35,3,100.0
2740,75,192,193,385,3,100.0
2741,75,53,45,98,3,100.0
2742,75,77,96,173,3,100.0
2743,75,102,160,262,3,100.0
2744,75,92,168,260,3,100.0
2745,75,16,27,43,3,100.0
2746,75,62,81,143,3,100.0
2747,75,135,188,323,3,100.0
2748,75,97,155,252,3,100.0
2749,75,42,60,102,3,100.0
2750,75,36,44,80,3,100.0
2751,75,36,78,114,3,100.0
2752,75,20,31,51,3,100.0
2753,75,38,99,137,3,100.0
2754,75,10,44,54,3,100.0
2755,75,35,124,159,3,100.0
2756,75,11,14,25,3,100.0
2757,75,16,68,84,3,100.0
2758,75,9,56,65,3,100.0
2759,75,158,283,441,3,100.0
2760,75,29,214,243,3,100.0
2761,75,168,264,432,3,100.0
2762,75,105,152,257,3,100.0
2763,75,76,246,322,3,100.0
2764,75,54,127,181,3,100.0
2765,75,94,190,284,3,100.0
2766,75,9,27,36,3,100.0
2767,75,15,38,53,3,100.0
2768,75,61,179,240,3,100.0
2769,75,107,248,355,3,100.0
2770,75,52,95,147,3,100.0
2771,75,13,73,86,3,100.0
2772,75,114,150,264,3,100.0
2773,75,43,57,100,3,100.0
2774,75,11,15,26,3,100.0
2775,75,101,199,300,3,100.0
2776,75,29,73,102,3,100.0
2777,75,178,320,498,3,100.0
2778,75,105,195,300,3,100.0
2779,75,104,185,289,3,100.0
2780,75,40,91,131,3,100.0
2781,75,109,230,339,3,100.0
2782,75,68,101,169,3,100.0
2783,75,34,97,131,3,100.0
2784,75,67,231,298,3,100.0
2785,75,105,122,227,3,100.0
2786,75,157,159,316,3,100.0
2787,75,87,200,287,3,100.0
2788,75,92,202,294,3,100.0
2789,75,53,86,139,3,100.0
2790,75,129,229,358,3,100.0
2791,75,145,218,363,3,100.0
2792,75,44,86,130,3,100.0
2793,75,114,193,307,3,100.0
2794,75,145,137,282,3,100.0
2795,75,46,123,169,3,100.0
2796,75,83,171,254,3,100.0
2797,75,96,196,292,3,100.0
2798,75,45,95,140,3,100.0
2799,75,43,126,169,3,100.0
2800,75,89,219,308,3,100.0
2801,75,31,80,111,3,100.0
2802,75,77,176,253,3,100.0
2803,75,65,106,171,3,100.0
2804,75,46,91,137,3,100.0
2805,75,76,183,259,3,100.0
2806,75,96,133,229,3,100.0
2807,75,110,190,300,3,100.0
2808,75,72,72,144,3,100.0
2809,75,103,211,314,3,100.0
2810,75,55,122,177,3,100.0
2811,75,178,262,440,3,100.0
2812,75,37,132,169,3,100.0
2813,75,63,79,142,3,100.0
2814,75,152,299,451,3,100.0
2815,75,26,36,62,3,100.0
2816,75,14,32,46,3,100.0
2817,75,40,136,176,3,100.0
2818,75,13,43,56,3,100.0
2819,75,60,211,271,3,100.0
2820,75,76,120,196,3,100.0
2821,75,32,86,118,3,100.0
2822,75,64,119,183,3,100.0
2823,75,93,101,194,3,100.0
2824,75,138,328,466,3,100.0
2825,75,310,582,892,3,100.0
2826,75,116,177,293,3,100.0
2827,75,60,105,165,3,100.0
2828,75,79,123,202,3,100.0
2829,75,32,44,76,3,100.0
2830,75,14,13,27,3,100.0
2831,75,44,44,88,3,100.0
2832,75,18,25,43,3,100.0
2833,75,74,132,206,3,100.0
2834,75,141,196,337,3,100.0
2835,75,56,89,145,3,100.0
2836,75,222,424,646,3,100.0
2837,75,148,214,362,3,100.0
2838,75,42,48,90,3,100.0
2839,75,90,89,179,3,100.0
2840,75,71,76,147,3,100.0
2841,75,112,184,296,3,100.0
2842,75,67,130,197,3,100.0
2843,75,64,112,176,3,100.0
2844,75,57,102,159,3,100.0
2845,75,78,141,219,3,100.0
2846,75,155,280,435,3,100.0
2847,75,7,43,50,3,100.0
2848,75,12,28,40,3,100.0
2849,75,45,153,198,3,100.0
2850,75,42,102,144,3,100.0
2851,75,54,110,164,3,100.0
2852,75,67,80,147,3,100.0
2853,75,140,244,384,3,100.0
2854,75,138,267,405,3,100.0
2855,75,136,260,396,3,100.0
2856,75,56,146,202,3,100.0
2857,75,87,215,302,3,100.0
2858,75,95,123,218,3,100.0
2859,75,23,185,208,3,100.0
2860,75,61,82,143,3,100.0
2861,75,23,71,94,3,100.0
2862,75,71,113,184,3,100.0
2863,75,86,178,264,3,100.0
2864,75,46,39,85,3,100.0
2865,75,37,115,152,3,100.0
2866,75,52,65,117,3,100.0
2867,75,65,75,140,3,100.0
2868,75,86,91,177,3,100.0
2869,75,38,65,103,3,100.0
2870,75,142,332,474,3,100.0
2871,75,15,39,54,3,100.0
2872,75,88,148,236,3,1000.0
2873,75,77,144,221,3,1000.0
2874,75,87,194,281,3,1000.0
2875,75,95,164,259,3,1000.0
2876,75,65,97,162,3,1000.0
2877,75,134,175,309,3,1000.0
2878,75,92,169,261,3,1000.0
2879,75,42,91,133,3,1000.0
2880,75,12,49,61,3,1000.0
2881,75,98,71,169,3,1000.0
2882,75,98,91,189,3,1000.0
2883,75,35,101,136,3,1000.0
2884,75,40,43,83,3,1000.0
2885,75,30,37,67,3,1000.0
2886,75,94,166,260,3,1000.0
2887,75,18,42,60,3,1000.0
2888,75,97,140,237,3,1000.0
2889,75,5,48,53,3,1000.0
2890,75,51,107,158,3,1000.0
2891,75,152,223,375,3,1000.0
2892,75,36,105,141,3,1000.0
2893,75,25,151,176,3,1000.0
2894,75,142,263,405,3,1000.0
2895,75,31,57,88,3,1000.0
2896,75,53,181,234,3,1000.0
2897,75,23,212,235,3,1000.0
2898,75,63,142,205,3,1000.0
2899,75,41,92,133,3,1000.0
2900,75,81,144,225,3,1000.0
2901,75,243,351,594,3,1000.0
2902,75,81,195,276,3,1000.0
2903,75,71,92,163,3,1000.0
2904,75,68,131,199,3,1000.0
2905,75,124,268,392,3,1000.0
2906,75,172,165,337,3,1000.0
2907,75,13,42,55,3,1000.0
2908,75,122,199,321,3,1000.0
2909,75,27,41,68,3,1000.0
2910,75,35,62,97,3,1000.0
2911,75,23,58,81,3,1000.0
2912,75,70,135,205,3,1000.0
2913,75,21,29,50,3,1000.0
2914,75,56,121,177,3,1000.0
2915,75,181,277,458,3,1000.0
2916,75,65,91,156,3,1000.0
2917,75,92,294,386,3,1000.0
2918,75,81,250,331,3,1000.0
2919,75,96,236,332,3,1000.0
2920,75,39,288,327,3,1000.0
2921,75,63,219,282,3,1000.0
2922,75,40,176,216,3,1000.0
2923,75,65,145,210,3,1000.0
2924,75,23,131,154,3,1000.0
2925,75,59,111,170,3,1000.0
2926,75,115,221,336,3,1000.0
2927,75,57,144,201,3,1000.0
2928,75,129,161,290,3,1000.0
2929,75,84,138,222,3,1000.0
2930,75,41,101,142,3,1000.0
2931,75,135,207,342,3,1000.0
2932,75,25,84,109,3,1000.0
2933,75,84,164,248,3,1000.0
2934,75,89,132,221,3,1000.0
2935,75,73,153,226,3,1000.0
2936,75,137,157,294,3,1000.0
2937,75,24,60,84,3,1000.0
2938,75,47,100,147,3,1000.0
2939,75,123,186,309,3,1000.0
2940,75,107,193,300,3,1000.0
2941,75,96,125,221,3,1000.0
2942,75,30,50,80,3,1000.0
2943,75,98,114,212,3,1000.0
2944,75,67,120,187,3,1000.0
2945,75,100,130,230,3,1000.0
2946,75,121,298,419,3,1000.0
2947,75,42,35,77,3,1000.0
2948,75,81,145,226,3,1000.0
2949,75,113,190,303,3,1000.0
2950,75,46,231,277,3,1000.0
2951,75,305,333,638,3,1000.0
2952,75,110,204,314,3,1000.0
2953,75,39,129,168,3,1000.0
2954,75,53,127,180,3,1000.0
2955,75,50,105,155,3,1000.0
2956,75,133,216,349,3,1000.0
2957,75,44,127,171,3,1000.0
2958,75,50,132,182,3,1000.0
2959,75,107,282,389,3,1000.0
2960,75,100,187,287,3,1000.0
2961,75,51,181,232,3,1000.0
2962,75,179,398,577,3,1000.0
2963,75,38,120,158,3,1000.0
2964,75,82,247,329,3,1000.0
2965,75,60,108,168,3,1000.0
2966,75,91,198,289,3,1000.0
2967,75,130,463,593,3,1000.0
2968,75,49,221,270,3,1000.0
2969,75,25,90,115,3,1000.0
2970,75,54,281,335,3,1000.0
2971,75,14,141,155,3,1000.0
2972,75,154,451,605,3,1000.0
2973,75,82,269,351,3,1000.0
2974,75,108,202,310,3,1000.0
2975,75,119,287,406,3,1000.0
2976,75,73,140,213,3,1000.0
2977,75,95,257,352,3,1000.0
2978,75,7,118,125,3,1000.0
2979,75,45,125,170,3,1000.0
2980,75,22,102,124,3,1000.0
2981,75,63,133,196,3,1000.0
2982,75,51,129,180,3,1000.0
2983,75,51,81,132,3,1000.0
2984,75,157,250,407,3,1000.0
2985,75,17,61,78,3,1000.0
2986,75,92,241,333,3,1000.0
2987,75,20,133,153,3,1000.0
2988,75,67,201,268,3,1000.0
2989,75,47,143,190,3,1000.0
2990,75,31,124,155,3,1000.0
2991,75,21,75,96,3,1000.0
2992,75,39,102,141,3,1000.0
2993,75,52,248,300,3,1000.0
2994,75,19,101,120,3,1000.0
2995,75,25,89,114,3,1000.0
2996,75,85,220,305,3,1000.0
2997,75,60,210,270,3,1000.0
2998,75,21,141,162,3,1000.0
2999,75,75,139,214,3,1000.0
3000,75,88,120,208,3,1000.0
3001,75,42,132,174,3,1000.0
3002,75,127,334,461,3,1000.0
3003,75,83,170,253,3,1000.0
3004,75,91,235,326,3,1000.0
3005,75,92,169,261,3,1000.0
3006,75,11,38,49,3,1000.0
3007,75,72,163,235,3,1000.0
3008,75,96,133,229,3,1000.0
3009,75,130,280,410,3,1000.0
3010,75,29,32,61,3,1000.0
3011,75,47,112,159,3,1000.0
3012,75,21,50,71,3,1000.0
3013,75,11,112,123,3,1000.0
3014,75,37,194,231,3,1000.0
3015,75,56,110,166,3,1000.0
3016,75,56,108,164,3,1000.0
3017,75,54,88,142,3,1000.0
3018,75,46,93,139,3,1000.0
3019,75,42,65,107,3,1000.0
3020,75,75,150,225,3,1000.0
3021,75,27,75,102,3,1000.0
3022,75,52,155,207,3,1000.0
3023,75,34,64,98,3,1000.0
3024,75,72,125,197,3,1000.0
3025,75,46,107,153,3,1000.0
3026,75,76,122,198,3,1000.0
3027,75,71,184,255,3,1000.0
3028,75,75,111,186,3,1000.0
3029,75,60,84,144,3,1000.0
3030,75,122,209,331,3,1000.0
3031,75,75,194,269,3,1000.0
3032,75,107,239,346,3,1000.0
3033,75,91,261,352,3,1000.0
3034,75,85,137,222,3,1000.0
3035,75,8,42,50,3,1000.0
3036,75,97,85,182,3,1000.0
3037,75,69,114,183,3,1000.0
3038,75,40,107,147,3,1000.0
3039,75,160,326,486,3,1000.0
3040,75,145,256,401,3,1000.0
3041,75,154,179,333,3,1000.0
3042,75,43,105,148,3,1000.0
3043,75,99,223,322,3,1000.0
3044,75,37,123,160,3,1000.0
3045,75,60,156,216,3,1000.0
3046,75,134,261,395,3,1000.0
3047,75,76,199,275,3,1000.0
3048,75,10,59,69,3,1000.0
3049,75,16,111,127,3,1000.0
3050,75,81,63,144,3,1000.0
3051,75,137,195,332,3,1000.0
3052,75,45,100,145,3,1000.0
3053,75,138,239,377,3,1000.0
3054,75,29,117,146,3,1000.0
3055,75,60,225,285,3,1000.0
3056,75,136,206,342,3,1000.0
3057,75,74,197,271,3,1000.0
3058,75,79,126,205,3,1000.0
3059,75,115,293,408,3,1000.0
3060,75,73,95,168,3,1000.0
3061,75,90,170,260,3,1000.0
3062,75,33,59,92,3,1000.0
3063,75,28,97,125,3,1000.0
3064,75,84,167,251,3,1000.0
3065,75,34,88,122,3,1000.0
3066,75,30,74,104,3,1000.0
3067,75,21,28,49,3,1000.0
3068,75,50,137,187,3,1000.0
3069,75,52,122,174,3,1000.0
3070,75,85,276,361,3,1000.0
3071,75,184,324,508,3,1000.0
3072,75,9,36,45,3,1000.0
3073,75,116,181,297,3,1000.0
3074,75,32,62,94,3,1000.0
3075,75,90,146,236,3,1000.0
3076,75,26,39,65,3,1000.0
3077,75,107,159,266,3,1000.0
3078,75,25,100,125,3,1000.0
3079,75,74,132,206,3,1000.0
3080,75,43,156,199,3,1000.0
3081,75,5,15,20,3,1000.0
3082,75,60,121,181,3,1000.0
3083,75,127,219,346,3,1000.0
3084,75,53,94,147,3,1000.0
3085,75,127,207,334,3,1000.0
3086,75,29,80,109,3,1000.0
3087,75,46,95,141,3,1000.0
3088,75,144,210,354,3,1000.0
3089,75,25,103,128,3,1000.0
3090,75,29,71,100,3,1000.0
3091,75,14,131,145,3,1000.0
3092,75,8,90,98,3,1000.0
3093,75,45,105,150,3,1000.0
3094,75,146,252,398,3,1000.0
3095,75,88,171,259,3,1000.0
3096,75,77,242,319,3,1000.0
3097,75,93,106,199,3,1000.0
3098,75,101,147,248,3,1000.0
3099,75,19,70,89,3,1000.0
3100,75,92,113,205,3,1000.0
3101,75,68,222,290,3,1000.0
3102,75,50,148,198,3,1000.0
3103,75,45,98,143,3,1000.0
3104,75,30,57,87,3,1000.0
3105,75,86,238,324,3,1000.0
3106,75,15,35,50,3,1000.0
3107,75,57,72,129,3,1000.0
3108,75,76,161,237,3,1000.0
3109,75,99,242,341,3,1000.0
3110,75,99,193,292,3,1000.0
3111,75,26,116,142,3,1000.0
3112,75,25,112,137,3,1000.0
3113,75,24,60,84,3,1000.0
3114,75,20,34,54,3,1000.0
3115,75,34,66,100,3,1000.0
3116,75,72,138,210,3,1000.0
3117,75,182,248,430,3,1000.0
3118,75,194,242,436,3,1000.0
3119,75,66,96,162,3,1000.0
3120,75,82,108,190,3,1000.0
3121,75,133,181,314,3,1000.0
3122,75,62,98,160,3,1000.0
3123,75,82,95,177,3,1000.0
3124,75,68,157,225,3,1000.0
3125,75,47,80,127,3,1000.0
3126,75,14,30,44,3,1000.0
3127,75,24,55,79,3,1000.0
3128,75,29,63,92,3,1000.0
3129,75,32,82,114,3,1000.0
3130,75,105,185,290,3,1000.0
3131,75,44,151,195,3,1000.0
3132,75,141,240,381,3,1000.0
3133,75,68,128,196,3,1000.0
3134,75,71,143,214,3,1000.0
3135,75,89,133,222,3,1000.0
3136,75,136,367,503,3,1000.0
3137,75,122,189,311,3,1000.0
3138,75,49,223,272,3,1000.0
3139,75,61,82,143,3,1000.0
3140,75,61,115,176,3,1000.0
3141,75,58,223,281,3,1000.0
3142,75,80,116,196,3,1000.0
3143,75,59,114,173,3,1000.0
3144,75,13,47,60,3,1000.0
3145,75,144,146,290,3,1000.0
3146,75,68,574,642,3,1000.0
3147,75,137,372,509,3,1000.0
3148,75,131,174,305,3,1000.0
3149,75,17,88,105,3,1000.0
3150,75,36,171,207,3,1000.0
3151,75,9,27,36,3,1000.0
3152,75,49,203,252,3,1000.0
3153,75,121,249,370,3,1000.0
3154,75,122,224,346,3,1000.0
3155,75,79,231,310,3,1000.0
3156,75,134,224,358,3,1000.0
3157,75,100,260,360,3,1000.0
3158,75,66,78,144,3,1000.0
3159,75,78,90,168,3,1000.0
3160,75,69,206,275,3,1000.0
3161,75,16,252,268,3,1000.0
3162,75,85,186,271,3,1000.0
3163,75,42,85,127,3,1000.0
3164,75,82,132,214,3,1000.0
3165,75,18,36,54,3,1000.0
3166,75,132,164,296,3,1000.0
3167,75,92,110,202,3,1000.0
3168,75,54,138,192,3,1000.0
3169,75,100,201,301,3,1000.0
3170,75,90,183,273,3,1000.0
3171,75,76,112,188,3,1000.0
3172,75,43,67,110,3,1000.0
3173,75,60,116,176,3,1000.0
3174,75,103,180,283,3,1000.0
3175,75,110,216,326,3,1000.0
3176,75,66,116,182,3,1000.0
3177,75,77,129,206,3,1000.0
3178,75,50,213,263,3,1000.0
3179,75,281,435,716,3,1000.0
3180,75,389,225,614,3,1000.0
3181,75,106,222,328,3,1000.0
3182,75,106,256,362,3,1000.0
3183,75,54,173,227,3,1000.0
3184,75,116,183,299,3,1000.0
3185,75,93,217,310,3,1000.0
3186,75,86,221,307,3,1000.0
3187,75,166,211,377,3,1000.0
3188,75,56,241,297,3,1000.0
3189,75,43,194,237,3,1000.0
3190,75,27,217,244,3,1000.0
3191,75,98,170,268,3,1000.0
3192,75,44,179,223,3,1000.0
3193,75,59,197,256,3,1000.0
3194,75,59,90,149,3,1000.0
3195,75,33,136,169,3,1000.0
3196,75,33,91,124,3,1000.0
3197,75,43,102,145,3,1000.0
3198,75,17,74,91,3,1000.0
3199,75,27,49,76,3,1000.0
3200,75,112,209,321,3,1000.0
3201,75,27,152,179,3,1000.0
3202,75,72,123,195,3,1000.0
3203,75,40,69,109,3,1000.0
3204,75,33,115,148,3,1000.0
3205,75,40,93,133,3,1000.0
3206,75,73,113,186,3,1000.0
3207,75,37,42,79,3,1000.0
3208,75,187,244,431,3,1000.0
3209,75,53,96,149,3,1000.0
3210,75,22,57,79,3,1000.0
3211,75,106,215,321,3,1000.0
3212,75,133,200,333,3,1000.0
3213,75,26,60,86,3,1000.0
3214,75,72,108,180,3,1000.0
3215,75,106,201,307,3,1000.0
3216,75,43,95,138,3,1000.0
3217,75,84,132,216,3,1000.0
3218,75,111,242,353,3,1000.0
3219,75,90,253,343,3,1000.0
3220,75,38,52,90,3,1000.0
3221,75,152,166,318,3,10000.0
3222,75,24,142,166,3,10000.0
3223,75,51,96,147,3,10000.0
3224,75,87,181,268,3,10000.0
3225,75,104,235,339,3,10000.0
3226,75,77,247,324,3,10000.0
3227,75,66,179,245,3,10000.0
3228,75,60,205,265,3,10000.0
3229,75,15,177,192,3,10000.0
3230,75,51,204,255,3,10000.0
3231,75,10,82,92,3,10000.0
3232,75,92,146,238,3,10000.0
3233,75,174,270,444,3,10000.0
3234,75,68,108,176,3,10000.0
3235,75,75,92,167,3,10000.0
3236,75,90,220,310,3,10000.0
3237,75,94,207,301,3,10000.0
3238,75,126,171,297,3,10000.0
3239,75,143,211,354,3,10000.0
3240,75,66,143,209,3,10000.0
3241,75,27,135,162,3,10000.0
3242,75,35,87,122,3,10000.0
3243,75,27,79,106,3,10000.0
3244,75,57,97,154,3,10000.0
3245,75,78,119,197,3,10000.0
3246,75,101,173,274,3,10000.0
3247,75,36,101,137,3,10000.0
3248,75,47,77,124,3,10000.0
3249,75,86,188,274,3,10000.0
3250,75,82,58,140,3,10000.0
3251,75,36,52,88,3,10000.0
3252,75,97,157,254,3,10000.0
3253,75,119,182,301,3,10000.0
3254,75,86,193,279,3,10000.0
3255,75,106,223,329,3,10000.0
3256,75,37,14,51,3,10000.0
3257,75,56,104,160,3,10000.0
3258,75,81,142,223,3,10000.0
3259,75,93,233,326,3,10000.0
3260,75,89,172,261,3,10000.0
3261,75,63,208,271,3,10000.0
3262,75,114,157,271,3,10000.0
3263,75,142,286,428,3,10000.0
3264,75,37,184,221,3,10000.0
3265,75,59,231,290,3,10000.0
3266,75,111,233,344,3,10000.0
3267,75,160,314,474,3,10000.0
3268,75,91,205,296,3,10000.0
3269,75,25,64,89,3,10000.0
3270,75,36,179,215,3,10000.0
3271,75,91,137,228,3,10000.0
3272,75,24,86,110,3,10000.0
3273,75,35,59,94,3,10000.0
3274,75,5,22,27,3,10000.0
3275,75,78,235,313,3,10000.0
3276,75,106,167,273,3,10000.0
3277,75,106,187,293,3,10000.0
3278,75,225,325,550,3,10000.0
3279,75,35,126,161,3,10000.0
3280,75,60,148,208,3,10000.0
3281,75,69,109,178,3,10000.0
3282,75,55,181,236,3,10000.0
3283,75,45,181,226,3,10000.0
3284,75,46,85,131,3,10000.0
3285,75,120,268,388,3,10000.0
3286,75,99,167,266,3,10000.0
3287,75,77,126,203,3,10000.0
3288,75,64,148,212,3,10000.0
3289,75,102,245,347,3,10000.0
3290,75,161,335,496,3,10000.0
3291,75,172,452,624,3,10000.0
3292,75,182,318,500,3,10000.0
3293,75,124,244,368,3,10000.0
3294,75,41,28,69,3,10000.0
3295,75,84,188,272,3,10000.0
3296,75,20,72,92,3,10000.0
3297,75,116,420,536,3,10000.0
3298,75,79,126,205,3,10000.0
3299,75,86,252,338,3,10000.0
3300,75,96,222,318,3,10000.0
3301,75,41,56,97,3,10000.0
3302,75,130,237,367,3,10000.0
3303,75,29,110,139,3,10000.0
3304,75,51,57,108,3,10000.0
3305,75,128,343,471,3,10000.0
3306,75,29,72,101,3,10000.0
3307,75,86,113,199,3,10000.0
3308,75,17,167,184,3,10000.0
3309,75,27,59,86,3,10000.0
3310,75,425,824,1249,3,10000.0
3311,75,95,265,360,3,10000.0
3312,75,71,235,306,3,10000.0
3313,75,182,298,480,3,10000.0
3314,75,158,244,402,3,10000.0
3315,75,114,208,322,3,10000.0
3316,75,58,170,228,3,10000.0
3317,75,164,280,444,3,10000.0
3318,75,38,96,134,3,10000.0
3319,75,40,93,133,3,10000.0
3320,75,21,26,47,3,10000.0
3321,75,152,299,451,3,10000.0
3322,75,93,205,298,3,10000.0
3323,75,66,140,206,3,10000.0
3324,75,106,113,219,3,10000.0
3325,75,138,215,353,3,10000.0
3326,75,76,118,194,3,10000.0
3327,75,44,93,137,3,10000.0
3328,75,189,338,527,3,10000.0
3329,75,50,184,234,3,10000.0
3330,75,113,183,296,3,10000.0
3331,75,74,198,272,3,10000.0
3332,75,84,174,258,3,10000.0
3333,75,98,80,178,3,10000.0
3334,75,71,103,174,3,10000.0
3335,75,142,291,433,3,10000.0
3336,75,111,299,410,3,10000.0
3337,75,140,119,259,3,10000.0
3338,75,113,111,224,3,10000.0
3339,75,158,177,335,3,10000.0
3340,75,23,73,96,3,10000.0
3341,75,75,149,224,3,10000.0
3342,75,25,71,96,3,10000.0
3343,75,48,89,137,3,10000.0
3344,75,87,151,238,3,10000.0
3345,75,15,72,87,3,10000.0
3346,75,134,264,398,3,10000.0
3347,75,178,238,416,3,10000.0
3348,75,82,94,176,3,10000.0
3349,75,20,53,73,3,10000.0
3350,75,125,176,301,3,10000.0
3351,75,140,172,312,3,10000.0
3352,75,443,230,673,3,10000.0
3353,75,108,166,274,3,10000.0
3354,75,66,116,182,3,10000.0
3355,75,82,107,189,3,10000.0
3356,75,97,111,208,3,10000.0
3357,75,61,83,144,3,10000.0
3358,75,60,107,167,3,10000.0
3359,75,35,76,111,3,10000.0
3360,75,22,61,83,3,10000.0
3361,75,41,74,115,3,10000.0
3362,75,18,35,53,3,10000.0
3363,75,124,113,237,3,10000.0
3364,75,7,63,70,3,10000.0
3365,75,133,233,366,3,10000.0
3366,75,103,198,301,3,10000.0
3367,75,86,56,142,3,10000.0
3368,75,65,94,159,3,10000.0
3369,75,73,101,174,3,10000.0
3370,75,70,82,152,3,10000.0
3371,75,25,42,67,3,10000.0
3372,75,68,130,198,3,10000.0
3373,75,102,164,266,3,10000.0
3374,75,65,107,172,3,10000.0
3375,75,18,28,46,3,10000.0
3376,75,16,38,54,3,10000.0
3377,75,111,463,574,3,10000.0
3378,75,107,214,321,3,10000.0
3379,75,99,220,319,3,10000.0
3380,75,143,210,353,3,10000.0
3381,75,71,126,197,3,10000.0
3382,75,109,203,312,3,10000.0
3383,75,60,106,166,3,10000.0
3384,75,95,163,258,3,10000.0
3385,75,72,200,272,3,10000.0
3386,75,19,47,66,3,10000.0
3387,75,2,22,24,3,10000.0
3388,75,201,365,566,3,10000.0
3389,75,216,378,594,3,10000.0
3390,75,99,237,336,3,10000.0
3391,75,158,377,535,3,10000.0
3392,75,218,231,449,3,10000.0
3393,75,179,286,465,3,10000.0
3394,75,191,298,489,3,10000.0
3395,75,82,241,323,3,10000.0
3396,75,3,73,76,3,10000.0
3397,75,40,72,112,3,10000.0
3398,75,95,116,211,3,10000.0
3399,75,161,179,340,3,10000.0
3400,75,148,199,347,3,10000.0
3401,75,85,251,336,3,10000.0
3402,75,53,115,168,3,10000.0
3403,75,160,181,341,3,10000.0
3404,75,181,389,570,3,10000.0
3405,75,222,367,589,3,10000.0
3406,75,71,105,176,3,10000.0
3407,75,28,94,122,3,10000.0
3408,75,20,90,110,3,10000.0
3409,75,45,52,97,3,10000.0
3410,75,27,94,121,3,10000.0
3411,75,77,176,253,3,10000.0
3412,75,136,170,306,3,10000.0
3413,75,68,174,242,3,10000.0
3414,75,63,157,220,3,10000.0
3415,75,69,261,330,3,10000.0
3416,75,59,155,214,3,10000.0
3417,75,158,405,563,3,10000.0
3418,75,41,57,98,3,10000.0
3419,75,50,107,157,3,10000.0
3420,75,41,108,149,3,10000.0
3421,75,82,47,129,3,10000.0
3422,75,56,305,361,3,10000.0
3423,75,57,65,122,3,10000.0
3424,75,90,360,450,3,10000.0
3425,75,15,53,68,3,10000.0
3426,75,24,74,98,3,10000.0
3427,75,28,79,107,3,10000.0
3428,75,54,91,145,3,10000.0
3429,75,19,170,189,3,10000.0
3430,75,60,288,348,3,10000.0
3431,75,39,110,149,3,10000.0
3432,75,96,357,453,3,10000.0
3433,75,30,102,132,3,10000.0
3434,75,19,115,134,3,10000.0
3435,75,70,141,211,3,10000.0
3436,75,14,208,222,3,10000.0
3437,75,2,52,54,3,10000.0
3438,75,20,98,118,3,10000.0
3439,75,7,47,54,3,10000.0
3440,75,83,101,184,3,10000.0
3441,75,63,162,225,3,10000.0
3442,75,78,25,103,3,10000.0
3443,75,108,169,277,3,10000.0
3444,75,225,253,478,3,10000.0
3445,75,13,256,269,3,10000.0
3446,75,147,216,363,3,10000.0
3447,75,59,166,225,3,10000.0
3448,75,101,180,281,3,10000.0
3449,75,87,152,239,3,10000.0
3450,75,132,219,351,3,10000.0
3451,75,35,65,100,3,10000.0
3452,75,33,105,138,3,10000.0
3453,75,79,216,295,3,10000.0
3454,75,12,49,61,3,10000.0
3455,75,27,104,131,3,10000.0
3456,75,63,169,232,3,10000.0
3457,75,45,142,187,3,10000.0
3458,75,31,160,191,3,10000.0
3459,75,102,220,322,3,10000.0
3460,75,128,317,445,3,10000.0
3461,75,24,78,102,3,10000.0
3462,75,10,48,58,3,10000.0
3463,75,38,98,136,3,10000.0
3464,75,23,67,90,3,10000.0
3465,75,55,207,262,3,10000.0
3466,75,55,78,133,3,10000.0
3467,75,54,113,167,3,10000.0
3468,75,85,81,166,3,10000.0
3469,75,70,153,223,3,10000.0
3470,75,57,87,144,3,10000.0
3471,75,170,291,461,3,10000.0
3472,75,110,127,237,3,10000.0
3473,75,46,61,107,3,10000.0
3474,75,112,211,323,3,10000.0
3475,75,41,106,147,3,10000.0
3476,75,80,134,214,3,10000.0
3477,75,24,30,54,3,10000.0
3478,75,84,117,201,3,10000.0
3479,75,52,183,235,3,10000.0
3480,75,71,132,203,3,10000.0
3481,75,45,123,168,3,10000.0
3482,75,61,63,124,3,10000.0
3483,75,75,73,148,3,10000.0
3484,75,148,276,424,3,10000.0
3485,75,128,221,349,3,10000.0
3486,75,42,165,207,3,10000.0
3487,75,67,165,232,3,10000.0
3488,75,52,84,136,3,10000.0
3489,75,26,62,88,3,10000.0
3490,75,18,75,93,3,10000.0
3491,75,109,158,267,3,10000.0
3492,75,15,36,51,3,10000.0
3493,75,83,192,275,3,10000.0
3494,75,140,311,451,3,10000.0
3495,75,34,93,127,3,10000.0
3496,75,5,31,36,3,10000.0
3497,75,115,233,348,3,10000.0
3498,75,117,101,218,3,10000.0
3499,75,99,134,233,3,10000.0
3500,75,81,261,342,3,10000.0
3501,75,55,143,198,3,10000.0
3502,75,65,56,121,3,10000.0
3503,75,41,125,166,3,10000.0
3504,75,31,110,141,3,10000.0
3505,75,7,41,48,3,10000.0
3506,75,18,82,100,3,10000.0
3507,75,99,113,212,3,10000.0
3508,75,70,142,212,3,10000.0
3509,75,21,77,98,3,10000.0
3510,75,74,187,261,3,10000.0
3511,75,77,168,245,3,10000.0
3512,75,37,108,145,3,10000.0
3513,75,109,188,297,3,10000.0
3514,75,36,56,92,3,10000.0
3515,75,12,74,86,3,10000.0
3516,75,35,109,144,3,10000.0
3517,75,22,232,254,3,10000.0
3518,75,91,162,253,3,10000.0
3519,75,64,270,334,3,10000.0
3520,75,162,186,348,3,10000.0
3521,75,44,86,130,3,10000.0
3522,75,38,47,85,3,10000.0
3523,75,112,188,300,3,10000.0
3524,75,86,132,218,3,10000.0
3525,75,126,290,416,3,10000.0
3526,75,48,124,172,3,10000.0
3527,75,59,101,160,3,10000.0
3528,75,88,320,408,3,10000.0
3529,75,18,112,130,3,10000.0
3530,75,10,24,34,3,10000.0
3531,75,50,258,308,3,10000.0
3532,75,26,54,80,3,10000.0
3533,75,21,154,175,3,10000.0
3534,75,105,270,375,3,10000.0
3535,75,43,88,131,3,10000.0
3536,75,53,158,211,3,10000.0
3537,75,89,315,404,3,10000.0
3538,75,67,229,296,3,10000.0
3539,75,79,197,276,3,10000.0
3540,75,21,123,144,3,10000.0
3541,75,55,106,161,3,10000.0
3542,75,13,34,47,3,10000.0
3543,75,34,185,219,3,10000.0
3544,75,143,157,300,3,10000.0
3545,75,107,192,299,3,10000.0
3546,75,68,162,230,3,10000.0
3547,75,83,252,335,3,10000.0
3548,75,25,225,250,3,10000.0
3549,75,74,190,264,3,10000.0
3550,75,87,216,303,3,10000.0
3551,75,48,93,141,3,10000.0
3552,75,154,314,468,3,10000.0
3553,75,16,61,77,3,10000.0
3554,75,79,165,244,3,10000.0
3555,75,17,85,102,3,10000.0
3556,75,37,152,189,3,10000.0
3557,75,132,450,582,3,10000.0
3558,75,70,285,355,3,10000.0
3559,75,18,121,139,3,10000.0
3560,75,16,115,131,3,10000.0
3561,75,79,520,599,3,10000.0
3562,75,59,162,221,3,10000.0
3563,75,54,101,155,3,10000.0
3564,75,46,102,148,3,10000.0
3565,75,59,289,348,3,10000.0
3566,75,57,562,619,3,10000.0
3567,75,84,229,313,3,10000.0
3568,75,58,136,194,3,10000.0
3569,75,82,179,261,3,10000.0
3570,75,28,181,209,3,10000.0
3571,75,61,119,180,3,10000.0
3572,75,20,130,150,3,10000.0
3573,75,8,69,77,3,10000.0
3574,75,21,90,111,3,10000.0
3575,75,40,76,116,3,10000.0
3576,75,107,161,268,3,10000.0
3577,75,126,275,401,3,10000.0
3578,75,42,87,129,3,10000.0
3579,75,121,182,303,3,10000.0
3580,75,149,232,381,3,10000.0
3581,75,97,173,270,3,10000.0
3582,75,46,102,148,3,10000.0
3583,75,81,104,185,3,10000.0
3584,75,99,152,251,3,10000.0
3585,75,76,147,223,3,10000.0
3586,75,54,70,124,3,10000.0
3587,75,15,47,62,3,10000.0
3588,75,166,316,482,3,10000.0
3589,75,9,14,23,3,10000.0
