Unnamed: 0,time_index,RNA_nuc,RNA_cyto,RNA_total,rep,conc,TPL,t_TPL
0,0,53,110,163,1,0,NaN,NaN
1,0,66,90,156,1,0,NaN,NaN
2,0,150,236,386,1,0,NaN,NaN
3,0,97,195,292,1,0,NaN,NaN
4,0,51,103,154,1,0,NaN,NaN
5,0,135,246,381,1,0,NaN,NaN
6,0,40,121,161,1,0,NaN,NaN
7,0,35,119,154,1,0,NaN,NaN
8,0,60,103,163,1,0,NaN,NaN
9,0,87,215,302,1,0,NaN,NaN
10,0,48,153,201,1,0,NaN,NaN
11,0,142,250,392,1,0,NaN,NaN
12,0,25,23,48,1,0,NaN,NaN
13,0,18,21,39,1,0,NaN,NaN
14,0,72,200,272,1,0,NaN,NaN
15,0,15,38,53,1,0,NaN,NaN
16,0,26,93,119,1,0,NaN,NaN
17,0,35,156,191,1,0,NaN,NaN
18,0,5,37,42,1,0,NaN,NaN
19,0,19,47,66,1,0,NaN,NaN
20,0,57,87,144,1,0,NaN,NaN
21,0,67,60,127,1,0,NaN,NaN
22,0,45,69,114,1,0,NaN,NaN
23,0,62,100,162,1,0,NaN,NaN
24,0,57,85,142,1,0,NaN,NaN
25,0,15,69,84,1,0,NaN,NaN
26,0,20,72,92,1,0,NaN,NaN
27,0,93,193,286,1,0,NaN,NaN
28,0,198,258,456,1,0,NaN,NaN
29,0,38,94,132,1,0,NaN,NaN
30,0,164,245,409,1,0,NaN,NaN
31,0,113,140,253,1,0,NaN,NaN
32,0,104,173,277,1,0,NaN,NaN
33,0,62,111,173,1,0,NaN,NaN
34,0,17,84,101,1,0,NaN,NaN
35,0,10,31,41,1,0,NaN,NaN
36,0,28,329,357,1,0,NaN,NaN
37,0,15,131,146,1,0,NaN,NaN
38,0,15,249,264,1,0,NaN,NaN
39,0,62,175,237,1,0,NaN,NaN
40,0,29,176,205,1,0,NaN,NaN
41,0,66,91,157,1,0,NaN,NaN
42,0,43,64,107,1,0,NaN,NaN
43,0,27,47,74,1,0,NaN,NaN
44,0,30,19,49,1,0,NaN,NaN
45,0,55,66,121,1,0,NaN,NaN
46,0,4,11,15,1,0,NaN,NaN
47,0,21,35,56,1,0,NaN,NaN
48,0,8,56,64,1,0,NaN,NaN
49,0,20,16,36,1,0,NaN,NaN
50,0,8,22,30,1,0,NaN,NaN
51,0,14,27,41,1,0,NaN,NaN
52,0,113,190,303,1,0,NaN,NaN
53,0,54,82,136,1,0,NaN,NaN
54,0,78,177,255,1,0,NaN,NaN
55,0,40,77,117,1,0,NaN,NaN
56,0,29,46,75,1,0,NaN,NaN
57,0,34,54,88,1,0,NaN,NaN
58,0,62,105,167,1,0,NaN,NaN
59,0,5,66,71,1,0,NaN,NaN
60,0,68,86,154,1,0,NaN,NaN
61,0,28,78,106,1,0,NaN,NaN
62,0,35,57,92,1,0,NaN,NaN
63,0,46,63,109,1,0,NaN,NaN
64,0,105,161,266,1,0,NaN,NaN
65,0,50,84,134,1,0,NaN,NaN
66,0,34,37,71,1,0,NaN,NaN
67,0,24,49,73,1,0,NaN,NaN
68,0,20,27,47,1,0,NaN,NaN
69,0,14,52,66,1,0,NaN,NaN
70,0,31,44,75,1,0,NaN,NaN
71,0,1,27,28,1,0,NaN,NaN
72,0,62,84,146,1,0,NaN,NaN
73,0,7,34,41,1,0,NaN,NaN
74,0,70,169,239,1,0,NaN,NaN
75,0,26,46,72,1,0,NaN,NaN
76,0,89,134,223,1,0,NaN,NaN
77,0,4,15,19,1,0,NaN,NaN
78,0,10,29,39,1,0,NaN,NaN
79,0,6,29,35,1,0,NaN,NaN
80,0,4,18,22,1,0,NaN,NaN
81,0,36,80,116,1,0,NaN,NaN
82,0,7,33,40,1,0,NaN,NaN
83,0,12,34,46,1,0,NaN,NaN
84,0,4,21,25,1,0,NaN,NaN
85,0,5,24,29,1,0,NaN,NaN
86,0,24,33,57,1,0,NaN,NaN
87,0,24,57,81,1,0,NaN,NaN
88,0,17,28,45,1,0,NaN,NaN
89,0,5,35,40,1,0,NaN,NaN
90,0,9,51,60,1,0,NaN,NaN
91,0,18,39,57,1,0,NaN,NaN
92,0,13,27,40,1,0,NaN,NaN
93,0,65,87,152,1,0,NaN,NaN
94,0,5,35,40,1,0,NaN,NaN
95,0,21,54,75,1,0,NaN,NaN
96,0,24,59,83,1,0,NaN,NaN
97,0,9,78,87,1,0,NaN,NaN
98,0,13,43,56,1,0,NaN,NaN
99,0,45,89,134,1,0,NaN,NaN
100,0,34,78,112,1,0,NaN,NaN
101,0,6,29,35,1,0,NaN,NaN
102,0,25,67,92,1,0,NaN,NaN
103,0,13,39,52,1,0,NaN,NaN
104,0,0,22,22,1,0,NaN,NaN
105,0,28,41,69,1,0,NaN,NaN
106,0,21,39,60,1,0,NaN,NaN
107,0,27,44,71,1,0,NaN,NaN
108,0,17,30,47,1,0,NaN,NaN
109,0,14,11,25,1,0,NaN,NaN
110,0,20,20,40,1,0,NaN,NaN
111,0,17,33,50,1,0,NaN,NaN
112,0,16,34,50,1,0,NaN,NaN
113,0,20,40,60,1,0,NaN,NaN
114,0,7,16,23,1,0,NaN,NaN
115,0,15,42,57,1,0,NaN,NaN
116,0,40,78,118,1,0,NaN,NaN
117,0,46,82,128,1,0,NaN,NaN
118,0,62,117,179,1,0,NaN,NaN
119,0,16,26,42,1,0,NaN,NaN
120,0,16,41,57,1,0,NaN,NaN
121,0,16,94,110,1,0,NaN,NaN
122,0,40,59,99,1,0,NaN,NaN
123,0,89,88,177,1,0,NaN,NaN
124,0,19,71,90,1,0,NaN,NaN
125,0,6,5,11,1,0,NaN,NaN
126,0,13,23,36,1,0,NaN,NaN
127,0,3,9,12,1,0,NaN,NaN
128,0,5,15,20,1,0,NaN,NaN
129,0,2,8,10,1,0,NaN,NaN
130,0,0,2,2,1,0,NaN,NaN
131,0,5,10,15,1,0,NaN,NaN
132,0,5,8,13,1,0,NaN,NaN
133,0,4,46,50,1,0,NaN,NaN
134,0,7,19,26,1,0,NaN,NaN
135,0,52,61,113,1,0,NaN,NaN
136,0,3,14,17,1,0,NaN,NaN
137,0,11,41,52,1,0,NaN,NaN
138,0,12,24,36,1,0,NaN,NaN
139,0,44,90,134,1,0,NaN,NaN
140,0,8,89,97,1,0,NaN,NaN
141,0,19,69,88,1,0,NaN,NaN
142,0,12,18,30,1,0,NaN,NaN
143,0,21,24,45,1,0,NaN,NaN
144,0,21,27,48,1,0,NaN,NaN
145,0,13,11,24,1,0,NaN,NaN
146,0,35,80,115,1,0,NaN,NaN
147,0,49,75,124,1,0,NaN,NaN
148,0,12,26,38,1,0,NaN,NaN
149,0,3,14,17,1,0,NaN,NaN
150,0,15,40,55,1,0,NaN,NaN
151,0,14,37,51,1,0,NaN,NaN
152,0,30,220,250,1,0,NaN,NaN
153,0,35,73,108,1,0,NaN,NaN
154,0,37,173,210,1,0,NaN,NaN
155,0,79,191,270,1,0,NaN,NaN
156,0,28,57,85,1,0,NaN,NaN
157,0,37,27,64,1,0,NaN,NaN
158,0,121,214,335,1,0,NaN,NaN
159,0,10,22,32,1,0,NaN,NaN
160,0,31,65,96,1,0,NaN,NaN
161,0,16,31,47,1,0,NaN,NaN
162,0,11,14,25,1,0,NaN,NaN
163,0,8,16,24,1,0,NaN,NaN
164,0,60,175,235,1,0,NaN,NaN
165,0,40,74,114,1,0,NaN,NaN
166,0,21,70,91,1,0,NaN,NaN
167,0,213,119,332,1,0,NaN,NaN
168,0,40,98,138,1,0,NaN,NaN
169,0,13,89,102,1,0,NaN,NaN
170,0,61,130,191,1,0,NaN,NaN
171,0,72,185,257,1,0,NaN,NaN
172,0,45,111,156,1,0,NaN,NaN
173,0,24,52,76,1,0,NaN,NaN
174,0,35,68,103,1,0,NaN,NaN
175,0,10,52,62,1,0,NaN,NaN
176,0,12,67,79,1,0,NaN,NaN
177,0,100,152,252,1,0,NaN,NaN
178,0,31,129,160,1,0,NaN,NaN
179,0,14,36,50,1,0,NaN,NaN
180,0,89,192,281,1,0,NaN,NaN
181,0,54,80,134,1,0,NaN,NaN
182,0,27,87,114,1,0,NaN,NaN
183,0,3,16,19,1,0,NaN,NaN
184,0,39,80,119,1,0,NaN,NaN
185,0,149,259,408,1,0,NaN,NaN
186,0,147,270,417,1,0,NaN,NaN
187,0,70,298,368,1,0,NaN,NaN
188,0,51,198,249,1,0,NaN,NaN
189,0,36,83,119,1,0,NaN,NaN
190,0,24,146,170,1,0,NaN,NaN
191,0,89,169,258,1,0,NaN,NaN
192,0,94,250,344,1,0,NaN,NaN
193,0,72,132,204,1,0,NaN,NaN
194,0,89,321,410,1,0,NaN,NaN
195,0,55,149,204,1,0,NaN,NaN
196,0,24,77,101,1,0,NaN,NaN
197,0,70,213,283,1,0,NaN,NaN
198,0,75,222,297,1,0,NaN,NaN
199,0,44,109,153,1,0,NaN,NaN
200,0,18,150,168,1,0,NaN,NaN
201,0,46,91,137,1,0,NaN,NaN
202,0,86,264,350,1,0,NaN,NaN
203,0,27,72,99,1,0,NaN,NaN
204,0,73,143,216,1,0,NaN,NaN
205,0,29,62,91,1,0,NaN,NaN
206,0,20,65,85,1,0,NaN,NaN
207,0,39,86,125,1,0,NaN,NaN
208,0,61,135,196,1,0,NaN,NaN
209,0,15,45,60,1,0,NaN,NaN
210,0,17,30,47,1,0,NaN,NaN
211,0,7,50,57,1,0,NaN,NaN
212,0,5,21,26,1,0,NaN,NaN
213,0,48,92,140,1,0,NaN,NaN
214,0,32,45,77,1,0,NaN,NaN
215,0,17,38,55,1,0,NaN,NaN
216,0,159,126,285,1,0,NaN,NaN
217,0,52,88,140,1,0,NaN,NaN
218,0,33,49,82,1,0,NaN,NaN
219,0,45,119,164,1,0,NaN,NaN
220,0,39,119,158,1,0,NaN,NaN
221,15,36,73,109,1,0,5000,0
222,15,77,133,210,1,0,5000,0
223,15,43,58,101,1,0,5000,0
224,15,79,112,191,1,0,5000,0
225,15,15,46,61,1,0,5000,0
226,15,16,52,68,1,0,5000,0
227,15,4,9,13,1,0,5000,0
228,15,6,20,26,1,0,5000,0
229,15,56,161,217,1,0,5000,0
230,15,46,116,162,1,0,5000,0
231,15,67,124,191,1,0,5000,0
232,15,37,56,93,1,0,5000,0
233,15,59,180,239,1,0,5000,0
234,15,13,47,60,1,0,5000,0
235,15,26,57,83,1,0,5000,0
236,15,15,31,46,1,0,5000,0
237,15,12,41,53,1,0,5000,0
238,15,30,71,101,1,0,5000,0
239,15,6,26,32,1,0,5000,0
240,15,42,80,122,1,0,5000,0
241,15,4,21,25,1,0,5000,0
242,15,1,20,21,1,0,5000,0
243,15,2,10,12,1,0,5000,0
244,15,11,16,27,1,0,5000,0
245,15,2,36,38,1,0,5000,0
246,15,6,38,44,1,0,5000,0
247,15,9,37,46,1,0,5000,0
248,15,12,31,43,1,0,5000,0
249,15,12,52,64,1,0,5000,0
250,15,5,54,59,1,0,5000,0
251,15,1,19,20,1,0,5000,0
252,15,40,81,121,1,0,5000,0
253,15,25,38,63,1,0,5000,0
254,15,16,41,57,1,0,5000,0
255,15,19,39,58,1,0,5000,0
256,15,26,55,81,1,0,5000,0
257,15,28,59,87,1,0,5000,0
258,15,8,16,24,1,0,5000,0
259,15,39,106,145,1,0,5000,0
260,15,53,95,148,1,0,5000,0
261,15,6,24,30,1,0,5000,0
262,15,28,41,69,1,0,5000,0
263,15,30,53,83,1,0,5000,0
264,15,44,42,86,1,0,5000,0
265,15,12,64,76,1,0,5000,0
266,15,20,28,48,1,0,5000,0
267,15,5,11,16,1,0,5000,0
268,15,5,17,22,1,0,5000,0
269,15,23,45,68,1,0,5000,0
270,15,5,12,17,1,0,5000,0
271,15,17,29,46,1,0,5000,0
272,15,17,44,61,1,0,5000,0
273,15,16,49,65,1,0,5000,0
274,15,26,36,62,1,0,5000,0
275,15,8,26,34,1,0,5000,0
276,15,61,95,156,1,0,5000,0
277,15,10,16,26,1,0,5000,0
278,15,7,33,40,1,0,5000,0
279,15,18,4,22,1,0,5000,0
280,15,25,95,120,1,0,5000,0
281,15,16,64,80,1,0,5000,0
282,15,4,28,32,1,0,5000,0
283,15,8,49,57,1,0,5000,0
284,15,30,81,111,1,0,5000,0
285,15,6,33,39,1,0,5000,0
286,15,43,73,116,1,0,5000,0
287,15,2,29,31,1,0,5000,0
288,15,18,77,95,1,0,5000,0
289,15,12,27,39,1,0,5000,0
290,15,0,18,18,1,0,5000,0
291,15,12,38,50,1,0,5000,0
292,15,2,33,35,1,0,5000,0
293,15,35,71,106,1,0,5000,0
294,15,46,53,99,1,0,5000,0
295,15,11,24,35,1,0,5000,0
296,15,65,72,137,1,0,5000,0
297,15,4,14,18,1,0,5000,0
298,15,17,45,62,1,0,5000,0
299,15,2,5,7,1,0,5000,0
300,15,5,19,24,1,0,5000,0
301,15,5,53,58,1,0,5000,0
302,15,14,69,83,1,0,5000,0
303,15,6,35,41,1,0,5000,0
304,15,4,21,25,1,0,5000,0
305,15,4,42,46,1,0,5000,0
306,15,13,33,46,1,0,5000,0
307,15,12,25,37,1,0,5000,0
308,15,4,32,36,1,0,5000,0
309,15,5,27,32,1,0,5000,0
310,15,4,12,16,1,0,5000,0
311,15,9,35,44,1,0,5000,0
312,15,8,52,60,1,0,5000,0
313,15,12,83,95,1,0,5000,0
314,15,10,32,42,1,0,5000,0
315,15,5,52,57,1,0,5000,0
316,15,5,34,39,1,0,5000,0
317,15,5,17,22,1,0,5000,0
318,15,53,80,133,1,0,5000,0
319,15,21,40,61,1,0,5000,0
320,15,6,31,37,1,0,5000,0
321,15,4,45,49,1,0,5000,0
322,15,16,40,56,1,0,5000,0
323,15,7,25,32,1,0,5000,0
324,15,2,7,9,1,0,5000,0
325,15,6,12,18,1,0,5000,0
326,15,29,61,90,1,0,5000,0
327,15,11,39,50,1,0,5000,0
328,15,41,338,379,1,0,5000,0
329,15,109,228,337,1,0,5000,0
330,15,22,89,111,1,0,5000,0
331,15,48,130,178,1,0,5000,0
332,15,9,13,22,1,0,5000,0
333,15,114,151,265,1,0,5000,0
334,15,18,51,69,1,0,5000,0
335,15,60,107,167,1,0,5000,0
336,15,80,173,253,1,0,5000,0
337,15,13,18,31,1,0,5000,0
338,15,34,95,129,1,0,5000,0
339,15,51,56,107,1,0,5000,0
340,15,21,31,52,1,0,5000,0
341,15,21,91,112,1,0,5000,0
342,15,15,59,74,1,0,5000,0
343,15,7,18,25,1,0,5000,0
344,15,15,50,65,1,0,5000,0
345,15,46,100,146,1,0,5000,0
346,15,13,32,45,1,0,5000,0
347,15,8,27,35,1,0,5000,0
348,15,17,28,45,1,0,5000,0
349,15,17,39,56,1,0,5000,0
350,15,9,31,40,1,0,5000,0
351,15,182,230,412,1,0,5000,0
352,15,49,139,188,1,0,5000,0
353,15,61,184,245,1,0,5000,0
354,15,18,56,74,1,0,5000,0
355,15,9,43,52,1,0,5000,0
356,15,137,358,495,1,0,5000,0
357,15,176,445,621,1,0,5000,0
358,15,15,69,84,1,0,5000,0
359,15,28,76,104,1,0,5000,0
360,15,7,32,39,1,0,5000,0
361,15,21,30,51,1,0,5000,0
362,15,25,44,69,1,0,5000,0
363,15,33,53,86,1,0,5000,0
364,15,62,112,174,1,0,5000,0
365,15,32,39,71,1,0,5000,0
366,15,46,78,124,1,0,5000,0
367,15,3,9,12,1,0,5000,0
368,15,84,253,337,1,0,5000,0
369,15,31,51,82,1,0,5000,0
370,15,13,18,31,1,0,5000,0
371,15,3,12,15,1,0,5000,0
372,15,14,34,48,1,0,5000,0
373,15,20,18,38,1,0,5000,0
374,15,16,63,79,1,0,5000,0
375,15,4,18,22,1,0,5000,0
376,15,9,13,22,1,0,5000,0
377,15,7,22,29,1,0,5000,0
378,15,8,12,20,1,0,5000,0
379,15,4,5,9,1,0,5000,0
380,15,55,53,108,1,0,5000,0
381,15,25,47,72,1,0,5000,0
382,15,4,22,26,1,0,5000,0
383,15,54,97,151,1,0,5000,0
384,15,48,62,110,1,0,5000,0
385,15,13,29,42,1,0,5000,0
386,15,21,58,79,1,0,5000,0
387,15,55,132,187,1,0,5000,0
388,15,24,49,73,1,0,5000,0
389,15,59,102,161,1,0,5000,0
390,15,33,69,102,1,0,5000,0
391,15,36,77,113,1,0,5000,0
392,15,11,40,51,1,0,5000,0
393,15,17,26,43,1,0,5000,0
394,15,11,27,38,1,0,5000,0
395,15,38,42,80,1,0,5000,0
396,15,58,49,107,1,0,5000,0
397,15,74,100,174,1,0,5000,0
398,15,27,57,84,1,0,5000,0
399,15,92,131,223,1,0,5000,0
400,15,49,155,204,1,0,5000,0
401,15,36,71,107,1,0,5000,0
402,15,71,109,180,1,0,5000,0
403,15,42,113,155,1,0,5000,0
404,15,58,144,202,1,0,5000,0
405,15,20,31,51,1,0,5000,0
406,15,26,59,85,1,0,5000,0
407,15,4,11,15,1,0,5000,0
408,15,2,1,3,1,0,5000,0
409,15,14,75,89,1,0,5000,0
410,15,21,37,58,1,0,5000,0
411,15,76,95,171,1,0,5000,0
412,15,66,134,200,1,0,5000,0
413,15,26,73,99,1,0,5000,0
414,15,93,101,194,1,0,5000,0
415,15,46,74,120,1,0,5000,0
416,15,108,125,233,1,0,5000,0
417,15,79,103,182,1,0,5000,0
418,15,12,33,45,1,0,5000,0
419,15,19,29,48,1,0,5000,0
420,15,56,28,84,1,0,5000,0
421,15,8,30,38,1,0,5000,0
422,15,11,27,38,1,0,5000,0
423,15,4,8,12,1,0,5000,0
424,15,5,5,10,1,0,5000,0
425,15,0,25,25,1,0,5000,0
426,15,5,17,22,1,0,5000,0
427,15,22,44,66,1,0,5000,0
428,15,103,106,209,1,0,5000,0
429,15,74,120,194,1,0,5000,0
430,15,130,173,303,1,0,5000,0
431,15,51,97,148,1,0,5000,0
432,15,4,12,16,1,0,5000,0
433,15,34,27,61,1,0,5000,0
434,15,9,7,16,1,0,5000,0
435,15,42,56,98,1,0,5000,0
436,15,27,58,85,1,0,5000,0
437,15,37,66,103,1,0,5000,0
438,15,2,14,16,1,0,5000,0
439,15,7,17,24,1,0,5000,0
440,15,55,96,151,1,0,5000,0
441,15,18,49,67,1,0,5000,0
442,15,7,33,40,1,0,5000,0
443,15,9,22,31,1,0,5000,0
444,15,6,27,33,1,0,5000,0
445,15,4,6,10,1,0,5000,0
446,15,8,27,35,1,0,5000,0
447,15,3,12,15,1,0,5000,0
448,15,1,8,9,1,0,5000,0
449,15,5,27,32,1,0,5000,0
450,15,26,100,126,1,0,5000,0
451,15,51,76,127,1,0,5000,0
452,15,24,105,129,1,0,5000,0
453,15,28,88,116,1,0,5000,0
454,15,89,187,276,1,0,5000,0
455,15,22,103,125,1,0,5000,0
456,15,32,158,190,1,0,5000,0
457,15,79,226,305,1,0,5000,0
458,15,15,148,163,1,0,5000,0
459,15,7,7,14,1,0,5000,0
460,15,40,83,123,1,0,5000,0
461,15,37,31,68,1,0,5000,0
462,15,47,46,93,1,0,5000,0
463,15,34,89,123,1,0,5000,0
464,15,17,59,76,1,0,5000,0
465,15,14,45,59,1,0,5000,0
466,15,20,47,67,1,0,5000,0
467,15,4,27,31,1,0,5000,0
468,15,16,25,41,1,0,5000,0
469,15,5,18,23,1,0,5000,0
470,15,10,17,27,1,0,5000,0
471,15,21,61,82,1,0,5000,0
472,15,9,25,34,1,0,5000,0
473,15,37,51,88,1,0,5000,0
474,15,52,78,130,1,0,5000,0
475,15,24,92,116,1,0,5000,0
476,15,15,30,45,1,0,5000,0
477,15,16,90,106,1,0,5000,0
478,15,7,19,26,1,0,5000,0
479,30,10,30,40,1,0,5000,0
480,30,33,63,96,1,0,5000,0
481,30,1,22,23,1,0,5000,0
482,30,33,110,143,1,0,5000,0
483,30,26,49,75,1,0,5000,0
484,30,16,87,103,1,0,5000,0
485,30,30,38,68,1,0,5000,0
486,30,52,68,120,1,0,5000,0
487,30,33,106,139,1,0,5000,0
488,30,27,30,57,1,0,5000,0
489,30,22,70,92,1,0,5000,0
490,30,18,22,40,1,0,5000,0
491,30,23,39,62,1,0,5000,0
492,30,4,19,23,1,0,5000,0
493,30,19,73,92,1,0,5000,0
494,30,8,36,44,1,0,5000,0
495,30,13,69,82,1,0,5000,0
496,30,4,18,22,1,0,5000,0
497,30,9,33,42,1,0,5000,0
498,30,38,67,105,1,0,5000,0
499,30,13,85,98,1,0,5000,0
500,30,27,91,118,1,0,5000,0
501,30,23,66,89,1,0,5000,0
502,30,6,48,54,1,0,5000,0
503,30,6,20,26,1,0,5000,0
504,30,31,83,114,1,0,5000,0
505,30,22,76,98,1,0,5000,0
506,30,79,138,217,1,0,5000,0
507,30,37,61,98,1,0,5000,0
508,30,55,97,152,1,0,5000,0
509,30,58,89,147,1,0,5000,0
510,30,7,15,22,1,0,5000,0
511,30,19,49,68,1,0,5000,0
512,30,21,18,39,1,0,5000,0
513,30,22,26,48,1,0,5000,0
514,30,5,16,21,1,0,5000,0
515,30,11,21,32,1,0,5000,0
516,30,4,6,10,1,0,5000,0
517,30,19,33,52,1,0,5000,0
518,30,1,16,17,1,0,5000,0
519,30,21,55,76,1,0,5000,0
520,30,43,93,136,1,0,5000,0
521,30,37,106,143,1,0,5000,0
522,30,56,203,259,1,0,5000,0
523,30,52,127,179,1,0,5000,0
524,30,119,139,258,1,0,5000,0
525,30,17,59,76,1,0,5000,0
526,30,29,117,146,1,0,5000,0
527,30,10,36,46,1,0,5000,0
528,30,51,164,215,1,0,5000,0
529,30,15,89,104,1,0,5000,0
530,30,90,179,269,1,0,5000,0
531,30,19,62,81,1,0,5000,0
532,30,8,40,48,1,0,5000,0
533,30,1,25,26,1,0,5000,0
534,30,9,39,48,1,0,5000,0
535,30,14,20,34,1,0,5000,0
536,30,40,60,100,1,0,5000,0
537,30,40,87,127,1,0,5000,0
538,30,34,27,61,1,0,5000,0
539,30,9,29,38,1,0,5000,0
540,30,26,84,110,1,0,5000,0
541,30,24,46,70,1,0,5000,0
542,30,57,132,189,1,0,5000,0
543,30,39,82,121,1,0,5000,0
544,30,5,5,10,1,0,5000,0
545,30,7,66,73,1,0,5000,0
546,30,8,29,37,1,0,5000,0
547,30,44,78,122,1,0,5000,0
548,30,74,149,223,1,0,5000,0
549,30,26,62,88,1,0,5000,0
550,30,38,75,113,1,0,5000,0
551,30,16,18,34,1,0,5000,0
552,30,39,62,101,1,0,5000,0
553,30,49,36,85,1,0,5000,0
554,30,42,58,100,1,0,5000,0
555,30,14,21,35,1,0,5000,0
556,30,10,47,57,1,0,5000,0
557,30,16,30,46,1,0,5000,0
558,30,15,26,41,1,0,5000,0
559,30,11,36,47,1,0,5000,0
560,30,7,23,30,1,0,5000,0
561,30,9,48,57,1,0,5000,0
562,30,30,56,86,1,0,5000,0
563,30,25,86,111,1,0,5000,0
564,30,20,41,61,1,0,5000,0
565,30,53,197,250,1,0,5000,0
566,30,26,90,116,1,0,5000,0
567,30,28,42,70,1,0,5000,0
568,30,20,56,76,1,0,5000,0
569,30,18,33,51,1,0,5000,0
570,30,1,16,17,1,0,5000,0
571,30,5,22,27,1,0,5000,0
572,30,1,7,8,1,0,5000,0
573,30,8,49,57,1,0,5000,0
574,30,34,90,124,1,0,5000,0
575,30,46,134,180,1,0,5000,0
576,30,54,88,142,1,0,5000,0
577,30,15,33,48,1,0,5000,0
578,30,4,35,39,1,0,5000,0
579,30,23,207,230,1,0,5000,0
580,30,26,45,71,1,0,5000,0
581,30,27,65,92,1,0,5000,0
582,30,38,100,138,1,0,5000,0
583,30,17,36,53,1,0,5000,0
584,30,17,25,42,1,0,5000,0
585,30,20,80,100,1,0,5000,0
586,30,30,45,75,1,0,5000,0
587,30,35,142,177,1,0,5000,0
588,30,11,37,48,1,0,5000,0
589,30,7,42,49,1,0,5000,0
590,30,22,57,79,1,0,5000,0
591,30,32,115,147,1,0,5000,0
592,30,28,103,131,1,0,5000,0
593,30,12,37,49,1,0,5000,0
594,30,21,23,44,1,0,5000,0
595,30,4,28,32,1,0,5000,0
596,30,12,42,54,1,0,5000,0
597,30,15,32,47,1,0,5000,0
598,30,17,22,39,1,0,5000,0
599,30,10,58,68,1,0,5000,0
600,30,19,56,75,1,0,5000,0
601,30,18,29,47,1,0,5000,0
602,30,26,36,62,1,0,5000,0
603,30,19,73,92,1,0,5000,0
604,30,14,47,61,1,0,5000,0
605,30,54,56,110,1,0,5000,0
606,30,26,38,64,1,0,5000,0
607,30,38,106,144,1,0,5000,0
608,30,16,22,38,1,0,5000,0
609,30,27,49,76,1,0,5000,0
610,30,17,56,73,1,0,5000,0
611,30,4,19,23,1,0,5000,0
612,30,22,32,54,1,0,5000,0
613,30,5,21,26,1,0,5000,0
614,30,9,73,82,1,0,5000,0
615,30,2,16,18,1,0,5000,0
616,30,13,31,44,1,0,5000,0
617,30,97,125,222,1,0,5000,0
618,30,28,46,74,1,0,5000,0
619,30,49,33,82,1,0,5000,0
620,30,27,41,68,1,0,5000,0
621,30,15,30,45,1,0,5000,0
622,30,33,91,124,1,0,5000,0
623,30,40,42,82,1,0,5000,0
624,30,8,25,33,1,0,5000,0
625,30,23,42,65,1,0,5000,0
626,30,22,35,57,1,0,5000,0
627,30,7,13,20,1,0,5000,0
628,30,11,14,25,1,0,5000,0
629,30,15,74,89,1,0,5000,0
630,30,21,170,191,1,0,5000,0
631,30,17,179,196,1,0,5000,0
632,30,18,69,87,1,0,5000,0
633,30,20,67,87,1,0,5000,0
634,30,5,7,12,1,0,5000,0
635,30,5,18,23,1,0,5000,0
636,30,1,22,23,1,0,5000,0
637,30,27,31,58,1,0,5000,0
638,30,13,22,35,1,0,5000,0
639,30,24,72,96,1,0,5000,0
640,30,18,101,119,1,0,5000,0
641,30,11,28,39,1,0,5000,0
642,30,95,237,332,1,0,5000,0
643,30,5,16,21,1,0,5000,0
644,30,33,75,108,1,0,5000,0
645,30,30,51,81,1,0,5000,0
646,30,41,136,177,1,0,5000,0
647,30,26,37,63,1,0,5000,0
648,30,2,7,9,1,0,5000,0
649,30,19,38,57,1,0,5000,0
650,30,20,40,60,1,0,5000,0
651,30,8,16,24,1,0,5000,0
652,30,15,35,50,1,0,5000,0
653,30,10,18,28,1,0,5000,0
654,30,28,88,116,1,0,5000,0
655,30,21,51,72,1,0,5000,0
656,30,30,151,181,1,0,5000,0
657,30,10,36,46,1,0,5000,0
658,30,21,55,76,1,0,5000,0
659,30,7,32,39,1,0,5000,0
660,30,3,13,16,1,0,5000,0
661,30,13,22,35,1,0,5000,0
662,30,20,55,75,1,0,5000,0
663,30,27,36,63,1,0,5000,0
664,30,3,17,20,1,0,5000,0
665,30,14,66,80,1,0,5000,0
666,30,71,135,206,1,0,5000,0
667,30,3,8,11,1,0,5000,0
668,30,20,65,85,1,0,5000,0
669,30,1,8,9,1,0,5000,0
670,30,17,47,64,1,0,5000,0
671,30,15,18,33,1,0,5000,0
672,30,38,108,146,1,0,5000,0
673,30,32,49,81,1,0,5000,0
674,30,6,8,14,1,0,5000,0
675,30,9,17,26,1,0,5000,0
676,30,16,12,28,1,0,5000,0
677,30,12,5,17,1,0,5000,0
678,30,23,38,61,1,0,5000,0
679,30,28,30,58,1,0,5000,0
680,30,7,17,24,1,0,5000,0
681,30,11,15,26,1,0,5000,0
682,30,2,7,9,1,0,5000,0
683,30,13,31,44,1,0,5000,0
684,30,25,73,98,1,0,5000,0
685,30,33,56,89,1,0,5000,0
686,30,10,43,53,1,0,5000,0
687,30,11,32,43,1,0,5000,0
688,30,10,39,49,1,0,5000,0
689,30,2,31,33,1,0,5000,0
690,30,8,17,25,1,0,5000,0
691,30,5,10,15,1,0,5000,0
692,30,8,20,28,1,0,5000,0
693,30,19,45,64,1,0,5000,0
694,30,8,17,25,1,0,5000,0
695,30,26,35,61,1,0,5000,0
696,30,6,23,29,1,0,5000,0
697,30,12,24,36,1,0,5000,0
698,30,12,52,64,1,0,5000,0
699,30,10,18,28,1,0,5000,0
700,30,24,79,103,1,0,5000,0
701,30,10,42,52,1,0,5000,0
702,30,17,102,119,1,0,5000,0
703,30,12,39,51,1,0,5000,0
704,30,15,95,110,1,0,5000,0
705,30,7,27,34,1,0,5000,0
706,30,6,69,75,1,0,5000,0
707,30,47,132,179,1,0,5000,0
708,30,148,215,363,1,0,5000,0
709,30,120,382,502,1,0,5000,0
710,30,37,63,100,1,0,5000,0
711,30,13,43,56,1,0,5000,0
712,30,1,23,24,1,0,5000,0
713,30,9,48,57,1,0,5000,0
714,30,17,65,82,1,0,5000,0
715,30,22,39,61,1,0,5000,0
716,30,1,17,18,1,0,5000,0
717,30,16,65,81,1,0,5000,0
718,30,8,15,23,1,0,5000,0
719,30,28,62,90,1,0,5000,0
720,30,6,10,16,1,0,5000,0
721,30,32,109,141,1,0,5000,0
722,30,9,16,25,1,0,5000,0
723,30,6,25,31,1,0,5000,0
724,30,24,53,77,1,0,5000,0
725,30,4,37,41,1,0,5000,0
726,30,25,39,64,1,0,5000,0
727,30,10,21,31,1,0,5000,0
728,30,9,26,35,1,0,5000,0
729,30,4,14,18,1,0,5000,0
730,30,2,15,17,1,0,5000,0
731,30,1,2,3,1,0,5000,0
732,30,43,90,133,1,0,5000,0
733,30,10,64,74,1,0,5000,0
734,30,13,13,26,1,0,5000,0
735,30,7,49,56,1,0,5000,0
736,30,14,51,65,1,0,5000,0
737,30,19,74,93,1,0,5000,0
738,30,10,30,40,1,0,5000,0
739,30,9,52,61,1,0,5000,0
740,30,0,12,12,1,0,5000,0
741,60,2,0,2,1,0,5000,0
742,60,16,57,73,1,0,5000,0
743,60,10,39,49,1,0,5000,0
744,60,17,67,84,1,0,5000,0
745,60,13,26,39,1,0,5000,0
746,60,10,38,48,1,0,5000,0
747,60,8,18,26,1,0,5000,0
748,60,5,18,23,1,0,5000,0
749,60,25,66,91,1,0,5000,0
750,60,6,66,72,1,0,5000,0
751,60,2,20,22,1,0,5000,0
752,60,10,38,48,1,0,5000,0
753,60,6,41,47,1,0,5000,0
754,60,7,50,57,1,0,5000,0
755,60,13,49,62,1,0,5000,0
756,60,8,33,41,1,0,5000,0
757,60,7,34,41,1,0,5000,0
758,60,11,20,31,1,0,5000,0
759,60,8,17,25,1,0,5000,0
760,60,1,18,19,1,0,5000,0
761,60,5,16,21,1,0,5000,0
762,60,4,23,27,1,0,5000,0
763,60,6,14,20,1,0,5000,0
764,60,11,53,64,1,0,5000,0
765,60,5,47,52,1,0,5000,0
766,60,12,44,56,1,0,5000,0
767,60,6,40,46,1,0,5000,0
768,60,11,26,37,1,0,5000,0
769,60,8,47,55,1,0,5000,0
770,60,13,38,51,1,0,5000,0
771,60,8,40,48,1,0,5000,0
772,60,25,59,84,1,0,5000,0
773,60,6,25,31,1,0,5000,0
774,60,9,25,34,1,0,5000,0
775,60,0,16,16,1,0,5000,0
776,60,16,56,72,1,0,5000,0
777,60,6,12,18,1,0,5000,0
778,60,26,69,95,1,0,5000,0
779,60,12,41,53,1,0,5000,0
780,60,8,47,55,1,0,5000,0
781,60,5,22,27,1,0,5000,0
782,60,9,33,42,1,0,5000,0
783,60,23,61,84,1,0,5000,0
784,60,18,24,42,1,0,5000,0
785,60,39,43,82,1,0,5000,0
786,60,5,21,26,1,0,5000,0
787,60,20,64,84,1,0,5000,0
788,60,13,15,28,1,0,5000,0
789,60,20,24,44,1,0,5000,0
790,60,3,2,5,1,0,5000,0
791,60,9,21,30,1,0,5000,0
792,60,8,25,33,1,0,5000,0
793,60,7,10,17,1,0,5000,0
794,60,5,13,18,1,0,5000,0
795,60,1,5,6,1,0,5000,0
796,60,4,19,23,1,0,5000,0
797,60,3,20,23,1,0,5000,0
798,60,6,8,14,1,0,5000,0
799,60,10,28,38,1,0,5000,0
800,60,7,30,37,1,0,5000,0
801,60,16,27,43,1,0,5000,0
802,60,6,9,15,1,0,5000,0
803,60,10,21,31,1,0,5000,0
804,60,4,19,23,1,0,5000,0
805,60,7,32,39,1,0,5000,0
806,60,34,33,67,1,0,5000,0
807,60,35,96,131,1,0,5000,0
808,60,9,14,23,1,0,5000,0
809,60,22,30,52,1,0,5000,0
810,60,5,9,14,1,0,5000,0
811,60,13,20,33,1,0,5000,0
812,60,3,21,24,1,0,5000,0
813,60,12,18,30,1,0,5000,0
814,60,4,11,15,1,0,5000,0
815,60,5,16,21,1,0,5000,0
816,60,18,51,69,1,0,5000,0
817,60,7,24,31,1,0,5000,0
818,60,7,37,44,1,0,5000,0
819,60,0,11,11,1,0,5000,0
820,60,4,48,52,1,0,5000,0
821,60,4,76,80,1,0,5000,0
822,60,9,14,23,1,0,5000,0
823,60,7,41,48,1,0,5000,0
824,60,12,34,46,1,0,5000,0
825,60,7,18,25,1,0,5000,0
826,60,5,31,36,1,0,5000,0
827,60,13,16,29,1,0,5000,0
828,60,11,20,31,1,0,5000,0
829,60,22,43,65,1,0,5000,0
830,60,2,14,16,1,0,5000,0
831,60,3,6,9,1,0,5000,0
832,60,14,48,62,1,0,5000,0
833,60,15,44,59,1,0,5000,0
834,60,9,23,32,1,0,5000,0
835,60,9,10,19,1,0,5000,0
836,60,16,35,51,1,0,5000,0
837,60,12,16,28,1,0,5000,0
838,60,4,9,13,1,0,5000,0
839,60,8,11,19,1,0,5000,0
840,60,1,11,12,1,0,5000,0
841,60,2,4,6,1,0,5000,0
842,60,3,2,5,1,0,5000,0
843,60,5,16,21,1,0,5000,0
844,60,3,3,6,1,0,5000,0
845,60,24,58,82,1,0,5000,0
846,60,12,26,38,1,0,5000,0
847,60,19,38,57,1,0,5000,0
848,60,0,10,10,1,0,5000,0
849,60,13,21,34,1,0,5000,0
850,60,3,25,28,1,0,5000,0
851,60,2,11,13,1,0,5000,0
852,60,3,33,36,1,0,5000,0
853,60,14,27,41,1,0,5000,0
854,60,4,22,26,1,0,5000,0
855,60,4,14,18,1,0,5000,0
856,60,5,13,18,1,0,5000,0
857,60,6,36,42,1,0,5000,0
858,60,1,9,10,1,0,5000,0
859,60,9,38,47,1,0,5000,0
860,60,2,41,43,1,0,5000,0
861,60,20,27,47,1,0,5000,0
862,60,10,26,36,1,0,5000,0
863,60,5,9,14,1,0,5000,0
864,60,3,5,8,1,0,5000,0
865,60,2,17,19,1,0,5000,0
866,60,11,20,31,1,0,5000,0
867,60,3,12,15,1,0,5000,0
868,60,11,40,51,1,0,5000,0
869,60,6,36,42,1,0,5000,0
870,60,1,9,10,1,0,5000,0
871,60,8,27,35,1,0,5000,0
872,60,2,12,14,1,0,5000,0
873,60,5,11,16,1,0,5000,0
874,60,5,13,18,1,0,5000,0
875,60,8,16,24,1,0,5000,0
876,60,2,20,22,1,0,5000,0
877,60,1,7,8,1,0,5000,0
878,60,0,5,5,1,0,5000,0
879,60,12,26,38,1,0,5000,0
880,60,9,8,17,1,0,5000,0
881,60,5,17,22,1,0,5000,0
882,60,13,82,95,1,0,5000,0
883,60,2,18,20,1,0,5000,0
884,60,4,8,12,1,0,5000,0
885,60,9,16,25,1,0,5000,0
886,60,2,21,23,1,0,5000,0
887,60,7,14,21,1,0,5000,0
888,60,0,8,8,1,0,5000,0
889,60,10,21,31,1,0,5000,0
890,60,0,4,4,1,0,5000,0
891,60,7,12,19,1,0,5000,0
892,60,2,11,13,1,0,5000,0
893,60,3,17,20,1,0,5000,0
894,60,2,3,5,1,0,5000,0
895,60,5,1,6,1,0,5000,0
896,60,12,21,33,1,0,5000,0
897,60,1,6,7,1,0,5000,0
898,60,8,22,30,1,0,5000,0
899,60,8,25,33,1,0,5000,0
900,60,9,20,29,1,0,5000,0
901,60,9,26,35,1,0,5000,0
902,60,25,32,57,1,0,5000,0
903,60,7,11,18,1,0,5000,0
904,60,8,24,32,1,0,5000,0
905,60,4,11,15,1,0,5000,0
906,60,7,37,44,1,0,5000,0
907,60,2,20,22,1,0,5000,0
908,60,1,22,23,1,0,5000,0
909,60,21,35,56,1,0,5000,0
910,60,4,19,23,1,0,5000,0
911,60,7,20,27,1,0,5000,0
912,60,8,22,30,1,0,5000,0
913,60,2,36,38,1,0,5000,0
914,60,3,17,20,1,0,5000,0
915,60,3,11,14,1,0,5000,0
916,60,1,8,9,1,0,5000,0
917,60,14,34,48,1,0,5000,0
918,60,5,27,32,1,0,5000,0
919,60,8,21,29,1,0,5000,0
920,60,33,61,94,1,0,5000,0
921,60,19,36,55,1,0,5000,0
922,60,8,28,36,1,0,5000,0
923,60,14,32,46,1,0,5000,0
924,60,5,19,24,1,0,5000,0
925,60,1,7,8,1,0,5000,0
926,60,20,48,68,1,0,5000,0
927,60,11,15,26,1,0,5000,0
928,60,0,18,18,1,0,5000,0
929,60,7,20,27,1,0,5000,0
930,60,16,27,43,1,0,5000,0
931,60,6,21,27,1,0,5000,0
932,60,9,28,37,1,0,5000,0
933,60,6,6,12,1,0,5000,0
934,60,2,18,20,1,0,5000,0
935,60,9,13,22,1,0,5000,0
936,60,22,22,44,1,0,5000,0
937,60,6,6,12,1,0,5000,0
938,60,2,11,13,1,0,5000,0
939,60,4,5,9,1,0,5000,0
940,60,16,37,53,1,0,5000,0
941,60,4,8,12,1,0,5000,0
942,60,4,17,21,1,0,5000,0
943,60,2,6,8,1,0,5000,0
944,60,2,12,14,1,0,5000,0
945,60,2,2,4,1,0,5000,0
946,60,1,14,15,1,0,5000,0
947,60,2,17,19,1,0,5000,0
948,60,5,29,34,1,0,5000,0
949,60,4,25,29,1,0,5000,0
950,60,12,35,47,1,0,5000,0
951,60,10,15,25,1,0,5000,0
952,60,4,55,59,1,0,5000,0
953,60,4,18,22,1,0,5000,0
954,60,4,8,12,1,0,5000,0
955,60,6,37,43,1,0,5000,0
956,60,10,20,30,1,0,5000,0
957,60,7,44,51,1,0,5000,0
958,60,8,14,22,1,0,5000,0
959,60,11,35,46,1,0,5000,0
960,60,1,45,46,1,0,5000,0
961,60,2,26,28,1,0,5000,0
962,60,6,45,51,1,0,5000,0
963,60,1,33,34,1,0,5000,0
964,60,6,18,24,1,0,5000,0
965,60,5,19,24,1,0,5000,0
966,60,7,10,17,1,0,5000,0
967,60,11,8,19,1,0,5000,0
968,60,10,31,41,1,0,5000,0
969,60,12,23,35,1,0,5000,0
970,60,5,24,29,1,0,5000,0
971,60,2,44,46,1,0,5000,0
972,60,3,37,40,1,0,5000,0
973,60,3,6,9,1,0,5000,0
974,60,4,25,29,1,0,5000,0
975,60,12,18,30,1,0,5000,0
976,60,19,42,61,1,0,5000,0
977,60,12,50,62,1,0,5000,0
978,60,9,33,42,1,0,5000,0
979,60,12,52,64,1,0,5000,0
980,60,8,47,55,1,0,5000,0
981,60,4,34,38,1,0,5000,0
982,60,12,12,24,1,0,5000,0
983,60,7,26,33,1,0,5000,0
984,60,16,70,86,1,0,5000,0
985,60,6,38,44,1,0,5000,0
986,60,11,30,41,1,0,5000,0
987,60,6,19,25,1,0,5000,0
988,60,2,3,5,1,0,5000,0
989,60,8,9,17,1,0,5000,0
990,60,7,22,29,1,0,5000,0
991,60,0,19,19,1,0,5000,0
992,60,4,19,23,1,0,5000,0
993,60,8,15,23,1,0,5000,0
994,60,4,28,32,1,0,5000,0
995,60,9,22,31,1,0,5000,0
996,60,14,76,90,1,0,5000,0
997,60,12,37,49,1,0,5000,0
998,60,5,12,17,1,0,5000,0
999,60,5,31,36,1,0,5000,0
1000,60,2,8,10,1,0,5000,0
1001,60,7,36,43,1,0,5000,0
1002,60,9,12,21,1,0,5000,0
1003,60,12,20,32,1,0,5000,0
1004,60,40,101,141,1,0,5000,0
1005,60,4,8,12,1,0,5000,0
1006,60,6,5,11,1,0,5000,0
1007,60,6,18,24,1,0,5000,0
1008,60,11,19,30,1,0,5000,0
1009,60,0,12,12,1,0,5000,0
1010,60,6,16,22,1,0,5000,0
1011,60,12,40,52,1,0,5000,0
1012,60,5,15,20,1,0,5000,0
1013,60,2,11,13,1,0,5000,0
1014,60,4,33,37,1,0,5000,0
1015,60,3,10,13,1,0,5000,0
1016,60,1,15,16,1,0,5000,0
1017,60,4,4,8,1,0,5000,0
1018,20,55,60,115,1,100,NaN,NaN
1019,20,63,66,129,1,100,NaN,NaN
1020,20,66,48,114,1,100,NaN,NaN
1021,20,77,41,118,1,100,NaN,NaN
1022,20,60,91,151,1,100,NaN,NaN
1023,20,28,35,63,1,100,NaN,NaN
1024,20,81,68,149,1,100,NaN,NaN
1025,20,64,50,114,1,100,NaN,NaN
1026,20,57,45,102,1,100,NaN,NaN
1027,20,11,15,26,1,100,NaN,NaN
1028,20,19,34,53,1,100,NaN,NaN
1029,20,31,50,81,1,100,NaN,NaN
1030,20,11,5,16,1,100,NaN,NaN
1031,20,5,3,8,1,100,NaN,NaN
1032,20,40,17,57,1,100,NaN,NaN
1033,20,49,52,101,1,100,NaN,NaN
1034,20,20,40,60,1,100,NaN,NaN
1035,20,47,155,202,1,100,NaN,NaN
1036,20,59,110,169,1,100,NaN,NaN
1037,20,46,52,98,1,100,NaN,NaN
1038,20,72,78,150,1,100,NaN,NaN
1039,20,43,61,104,1,100,NaN,NaN
1040,20,36,24,60,1,100,NaN,NaN
1041,20,18,17,35,1,100,NaN,NaN
1042,20,50,58,108,1,100,NaN,NaN
1043,20,12,5,17,1,100,NaN,NaN
1044,20,72,52,124,1,100,NaN,NaN
1045,20,6,4,10,1,100,NaN,NaN
1046,20,81,88,169,1,100,NaN,NaN
1047,20,59,66,125,1,100,NaN,NaN
1048,20,27,44,71,1,100,NaN,NaN
1049,20,42,29,71,1,100,NaN,NaN
1050,20,7,24,31,1,100,NaN,NaN
1051,20,70,105,175,1,100,NaN,NaN
1052,20,70,87,157,1,100,NaN,NaN
1053,20,30,30,60,1,100,NaN,NaN
1054,20,58,62,120,1,100,NaN,NaN
1055,20,12,27,39,1,100,NaN,NaN
1056,20,33,37,70,1,100,NaN,NaN
1057,20,8,16,24,1,100,NaN,NaN
1058,20,15,19,34,1,100,NaN,NaN
1059,20,12,40,52,1,100,NaN,NaN
1060,20,29,27,56,1,100,NaN,NaN
1061,20,17,30,47,1,100,NaN,NaN
1062,20,25,43,68,1,100,NaN,NaN
1063,20,32,13,45,1,100,NaN,NaN
1064,20,120,252,372,1,100,NaN,NaN
1065,20,16,25,41,1,100,NaN,NaN
1066,20,53,110,163,1,100,NaN,NaN
1067,20,55,44,99,1,100,NaN,NaN
1068,20,33,42,75,1,100,NaN,NaN
1069,20,5,45,50,1,100,NaN,NaN
1070,20,6,5,11,1,100,NaN,NaN
1071,20,44,33,77,1,100,NaN,NaN
1072,20,15,30,45,1,100,NaN,NaN
1073,20,26,30,56,1,100,NaN,NaN
1074,20,45,25,70,1,100,NaN,NaN
1075,20,76,94,170,1,100,NaN,NaN
1076,20,34,19,53,1,100,NaN,NaN
1077,20,37,32,69,1,100,NaN,NaN
1078,20,27,32,59,1,100,NaN,NaN
1079,20,36,41,77,1,100,NaN,NaN
1080,20,11,10,21,1,100,NaN,NaN
1081,20,50,80,130,1,100,NaN,NaN
1082,20,40,71,111,1,100,NaN,NaN
1083,20,43,73,116,1,100,NaN,NaN
1084,20,31,34,65,1,100,NaN,NaN
1085,20,30,50,80,1,100,NaN,NaN
1086,20,30,63,93,1,100,NaN,NaN
1087,20,33,30,63,1,100,NaN,NaN
1088,20,25,33,58,1,100,NaN,NaN
1089,20,29,32,61,1,100,NaN,NaN
1090,20,10,27,37,1,100,NaN,NaN
1091,20,47,127,174,1,100,NaN,NaN
1092,20,64,139,203,1,100,NaN,NaN
1093,20,87,221,308,1,100,NaN,NaN
1094,20,71,61,132,1,100,NaN,NaN
1095,20,41,25,66,1,100,NaN,NaN
1096,20,61,83,144,1,100,NaN,NaN
1097,20,89,94,183,1,100,NaN,NaN
1098,20,72,119,191,1,100,NaN,NaN
1099,20,6,58,64,1,100,NaN,NaN
1100,20,74,61,135,1,100,NaN,NaN
1101,20,71,153,224,1,100,NaN,NaN
1102,20,41,43,84,1,100,NaN,NaN
1103,20,24,27,51,1,100,NaN,NaN
1104,20,73,62,135,1,100,NaN,NaN
1105,20,36,38,74,1,100,NaN,NaN
1106,20,25,31,56,1,100,NaN,NaN
1107,20,35,42,77,1,100,NaN,NaN
1108,20,23,34,57,1,100,NaN,NaN
1109,20,109,134,243,1,100,NaN,NaN
1110,20,53,98,151,1,100,NaN,NaN
1111,20,26,41,67,1,100,NaN,NaN
1112,20,36,68,104,1,100,NaN,NaN
1113,20,52,47,99,1,100,NaN,NaN
1114,20,33,68,101,1,100,NaN,NaN
1115,20,19,39,58,1,100,NaN,NaN
1116,20,40,49,89,1,100,NaN,NaN
1117,20,37,69,106,1,100,NaN,NaN
1118,20,12,29,41,1,100,NaN,NaN
1119,20,15,22,37,1,100,NaN,NaN
1120,20,18,35,53,1,100,NaN,NaN
1121,20,29,45,74,1,100,NaN,NaN
1122,20,42,56,98,1,100,NaN,NaN
1123,20,43,35,78,1,100,NaN,NaN
1124,20,21,36,57,1,100,NaN,NaN
1125,20,14,24,38,1,100,NaN,NaN
1126,20,59,54,113,1,100,NaN,NaN
1127,20,36,81,117,1,100,NaN,NaN
1128,20,38,66,104,1,100,NaN,NaN
1129,20,44,140,184,1,100,NaN,NaN
1130,20,28,39,67,1,100,NaN,NaN
1131,20,45,50,95,1,100,NaN,NaN
1132,20,87,54,141,1,100,NaN,NaN
1133,20,37,27,64,1,100,NaN,NaN
1134,20,22,67,89,1,100,NaN,NaN
1135,20,34,35,69,1,100,NaN,NaN
1136,20,78,24,102,1,100,NaN,NaN
1137,20,38,125,163,1,100,NaN,NaN
1138,20,27,32,59,1,100,NaN,NaN
1139,20,16,46,62,1,100,NaN,NaN
1140,20,89,91,180,1,100,NaN,NaN
1141,20,51,58,109,1,100,NaN,NaN
1142,20,81,88,169,1,100,NaN,NaN
1143,20,57,71,128,1,100,NaN,NaN
1144,20,14,45,59,1,100,NaN,NaN
1145,20,47,54,101,1,100,NaN,NaN
1146,20,13,67,80,1,100,NaN,NaN
1147,20,33,44,77,1,100,NaN,NaN
1148,20,44,32,76,1,100,NaN,NaN
1149,20,10,32,42,1,100,NaN,NaN
1150,20,36,86,122,1,100,NaN,NaN
1151,20,78,128,206,1,100,NaN,NaN
1152,20,101,102,203,1,100,NaN,NaN
1153,20,91,92,183,1,100,NaN,NaN
1154,20,98,123,221,1,100,NaN,NaN
1155,20,36,76,112,1,100,NaN,NaN
1156,20,56,44,100,1,100,NaN,NaN
1157,20,42,97,139,1,100,NaN,NaN
1158,20,61,57,118,1,100,NaN,NaN
1159,20,14,21,35,1,100,NaN,NaN
1160,20,28,23,51,1,100,NaN,NaN
1161,20,3,5,8,1,100,NaN,NaN
1162,20,7,11,18,1,100,NaN,NaN
1163,20,66,55,121,1,100,NaN,NaN
1164,20,32,40,72,1,100,NaN,NaN
1165,20,38,30,68,1,100,NaN,NaN
1166,20,47,86,133,1,100,NaN,NaN
1167,20,49,103,152,1,100,NaN,NaN
1168,20,58,85,143,1,100,NaN,NaN
1169,20,73,81,154,1,100,NaN,NaN
1170,20,95,110,205,1,100,NaN,NaN
1171,20,14,36,50,1,100,NaN,NaN
1172,20,33,37,70,1,100,NaN,NaN
1173,20,51,55,106,1,100,NaN,NaN
1174,20,83,62,145,1,100,NaN,NaN
1175,20,35,87,122,1,100,NaN,NaN
1176,20,115,115,230,1,100,NaN,NaN
1177,20,23,26,49,1,100,NaN,NaN
1178,20,70,90,160,1,100,NaN,NaN
1179,20,8,17,25,1,100,NaN,NaN
1180,20,34,48,82,1,100,NaN,NaN
1181,20,11,13,24,1,100,NaN,NaN
1182,20,6,33,39,1,100,NaN,NaN
1183,20,46,69,115,1,100,NaN,NaN
1184,20,44,55,99,1,100,NaN,NaN
1185,20,55,135,190,1,100,NaN,NaN
1186,20,58,93,151,1,100,NaN,NaN
1187,20,99,99,198,1,100,NaN,NaN
1188,20,42,117,159,1,100,NaN,NaN
1189,20,57,120,177,1,100,NaN,NaN
1190,20,19,12,31,1,100,NaN,NaN
1191,20,10,45,55,1,100,NaN,NaN
1192,20,33,39,72,1,100,NaN,NaN
1193,20,108,93,201,1,100,NaN,NaN
1194,20,65,86,151,1,100,NaN,NaN
1195,20,39,46,85,1,100,NaN,NaN
1196,20,35,71,106,1,100,NaN,NaN
1197,20,64,60,124,1,100,NaN,NaN
1198,20,9,12,21,1,100,NaN,NaN
1199,20,16,55,71,1,100,NaN,NaN
1200,20,26,63,89,1,100,NaN,NaN
1201,20,18,16,34,1,100,NaN,NaN
1202,20,56,61,117,1,100,NaN,NaN
1203,20,32,61,93,1,100,NaN,NaN
1204,20,6,13,19,1,100,NaN,NaN
1205,20,55,68,123,1,100,NaN,NaN
1206,20,29,24,53,1,100,NaN,NaN
1207,20,30,37,67,1,100,NaN,NaN
1208,20,40,67,107,1,100,NaN,NaN
1209,20,54,38,92,1,100,NaN,NaN
1210,20,13,28,41,1,100,NaN,NaN
1211,20,12,15,27,1,100,NaN,NaN
1212,20,19,42,61,1,100,NaN,NaN
1213,20,13,68,81,1,100,NaN,NaN
1214,20,12,14,26,1,100,NaN,NaN
1215,20,73,109,182,1,100,NaN,NaN
1216,20,118,146,264,1,100,NaN,NaN
1217,20,33,33,66,1,100,NaN,NaN
1218,20,125,114,239,1,100,NaN,NaN
1219,20,74,26,100,1,100,NaN,NaN
1220,20,27,28,55,1,100,NaN,NaN
1221,20,64,15,79,1,100,NaN,NaN
1222,20,41,13,54,1,100,NaN,NaN
1223,20,22,24,46,1,100,NaN,NaN
1224,20,29,28,57,1,100,NaN,NaN
1225,20,40,29,69,1,100,NaN,NaN
1226,20,22,24,46,1,100,NaN,NaN
1227,20,10,35,45,1,100,NaN,NaN
1228,20,39,30,69,1,100,NaN,NaN
1229,20,25,79,104,1,100,NaN,NaN
1230,20,10,33,43,1,100,NaN,NaN
1231,20,27,58,85,1,100,NaN,NaN
1232,20,7,32,39,1,100,NaN,NaN
1233,20,37,42,79,1,100,NaN,NaN
1234,20,7,28,35,1,100,NaN,NaN
1235,20,8,26,34,1,100,NaN,NaN
1236,20,27,85,112,1,100,NaN,NaN
1237,20,16,37,53,1,100,NaN,NaN
1238,20,21,44,65,1,100,NaN,NaN
1239,20,7,47,54,1,100,NaN,NaN
1240,20,46,96,142,1,100,NaN,NaN
1241,20,35,56,91,1,100,NaN,NaN
1242,20,35,80,115,1,100,NaN,NaN
1243,20,8,18,26,1,100,NaN,NaN
1244,20,23,46,69,1,100,NaN,NaN
1245,20,16,80,96,1,100,NaN,NaN
1246,20,45,113,158,1,100,NaN,NaN
1247,20,49,110,159,1,100,NaN,NaN
1248,20,30,47,77,1,100,NaN,NaN
1249,20,51,68,119,1,100,NaN,NaN
1250,20,35,89,124,1,100,NaN,NaN
1251,20,13,73,86,1,100,NaN,NaN
1252,20,34,64,98,1,100,NaN,NaN
1253,20,34,77,111,1,100,NaN,NaN
1254,20,38,49,87,1,100,NaN,NaN
1255,20,13,23,36,1,100,NaN,NaN
1256,20,36,65,101,1,100,NaN,NaN
1257,20,10,20,30,1,100,NaN,NaN
1258,20,38,35,73,1,100,NaN,NaN
1259,20,20,48,68,1,100,NaN,NaN
1260,20,13,20,33,1,100,NaN,NaN
1261,20,151,108,259,1,100,NaN,NaN
1262,20,67,26,93,1,100,NaN,NaN
1263,20,46,58,104,1,100,NaN,NaN
1264,20,60,46,106,1,100,NaN,NaN
1265,20,41,33,74,1,100,NaN,NaN
1266,20,130,135,265,1,100,NaN,NaN
1267,20,93,55,148,1,100,NaN,NaN
1268,20,48,62,110,1,100,NaN,NaN
1269,20,11,41,52,1,100,NaN,NaN
1270,20,26,23,49,1,100,NaN,NaN
1271,20,11,22,33,1,100,NaN,NaN
1272,20,18,24,42,1,100,NaN,NaN
1273,20,5,29,34,1,100,NaN,NaN
1274,20,11,22,33,1,100,NaN,NaN
1275,20,13,47,60,1,100,NaN,NaN
1276,20,16,24,40,1,100,NaN,NaN
1277,20,9,7,16,1,100,NaN,NaN
1278,20,8,16,24,1,100,NaN,NaN
1279,20,5,18,23,1,100,NaN,NaN
1280,20,71,77,148,1,100,NaN,NaN
1281,20,31,51,82,1,100,NaN,NaN
1282,20,148,146,294,1,100,NaN,NaN
1283,20,56,87,143,1,100,NaN,NaN
1284,20,10,28,38,1,100,NaN,NaN
1285,20,126,132,258,1,100,NaN,NaN
1286,20,47,73,120,1,100,NaN,NaN
1287,20,21,10,31,1,100,NaN,NaN
1288,20,57,89,146,1,100,NaN,NaN
1289,20,18,13,31,1,100,NaN,NaN
1290,20,3,8,11,1,100,NaN,NaN
1291,20,52,24,76,1,100,NaN,NaN
1292,20,39,28,67,1,100,NaN,NaN
1293,20,62,47,109,1,100,NaN,NaN
1294,20,175,136,311,1,100,NaN,NaN
1295,20,98,90,188,1,100,NaN,NaN
1296,20,77,85,162,1,100,NaN,NaN
1297,20,28,44,72,1,100,NaN,NaN
1298,20,42,40,82,1,100,NaN,NaN
1299,20,69,60,129,1,100,NaN,NaN
1300,20,66,96,162,1,100,NaN,NaN
1301,20,8,25,33,1,100,NaN,NaN
1302,20,32,39,71,1,100,NaN,NaN
1303,20,25,26,51,1,100,NaN,NaN
1304,20,4,32,36,1,100,NaN,NaN
1305,20,39,69,108,1,100,NaN,NaN
1306,20,10,40,50,1,100,NaN,NaN
1307,20,19,40,59,1,100,NaN,NaN
1308,20,31,70,101,1,100,NaN,NaN
1309,20,62,93,155,1,100,NaN,NaN
1310,20,25,47,72,1,100,NaN,NaN
1311,20,15,63,78,1,100,NaN,NaN
1312,20,44,102,146,1,100,NaN,NaN
1313,20,24,71,95,1,100,NaN,NaN
1314,20,18,121,139,1,100,NaN,NaN
1315,20,8,58,66,1,100,NaN,NaN
1316,20,37,88,125,1,100,NaN,NaN
1317,20,6,10,16,1,100,NaN,NaN
1318,20,40,80,120,1,100,NaN,NaN
1319,20,13,74,87,1,100,NaN,NaN
1320,20,24,71,95,1,100,NaN,NaN
1321,20,32,45,77,1,100,NaN,NaN
1322,20,18,26,44,1,100,NaN,NaN
1323,20,32,43,75,1,100,NaN,NaN
1324,20,43,66,109,1,100,NaN,NaN
1325,20,20,50,70,1,100,NaN,NaN
1326,20,56,61,117,1,100,NaN,NaN
1327,20,43,67,110,1,100,NaN,NaN
1328,20,35,70,105,1,100,NaN,NaN
1329,20,56,151,207,1,100,NaN,NaN
1330,20,41,82,123,1,100,NaN,NaN
1331,20,14,34,48,1,100,NaN,NaN
1332,20,22,57,79,1,100,NaN,NaN
1333,20,39,58,97,1,100,NaN,NaN
1334,20,50,65,115,1,100,NaN,NaN
1335,20,12,20,32,1,100,NaN,NaN
1336,20,26,35,61,1,100,NaN,NaN
1337,20,7,22,29,1,100,NaN,NaN
1338,20,12,85,97,1,100,NaN,NaN
1339,20,28,53,81,1,100,NaN,NaN
1340,20,11,50,61,1,100,NaN,NaN
1341,20,19,48,67,1,100,NaN,NaN
1342,20,88,65,153,1,100,NaN,NaN
1343,20,176,212,388,1,100,NaN,NaN
1344,20,155,127,282,1,100,NaN,NaN
1345,20,127,159,286,1,100,NaN,NaN
1346,20,106,152,258,1,100,NaN,NaN
1347,20,46,34,80,1,100,NaN,NaN
1348,20,40,63,103,1,100,NaN,NaN
1349,20,63,50,113,1,100,NaN,NaN
1350,20,46,54,100,1,100,NaN,NaN
1351,20,21,34,55,1,100,NaN,NaN
1352,20,21,43,64,1,100,NaN,NaN
1353,20,25,30,55,1,100,NaN,NaN
1354,20,28,52,80,1,100,NaN,NaN
1355,20,36,35,71,1,100,NaN,NaN
1356,20,1,8,9,1,100,NaN,NaN
1357,20,6,16,22,1,100,NaN,NaN
1358,35,57,92,149,1,100,5000,20
1359,35,73,161,234,1,100,5000,20
1360,35,81,105,186,1,100,5000,20
1361,35,59,63,122,1,100,5000,20
1362,35,111,108,219,1,100,5000,20
1363,35,72,123,195,1,100,5000,20
1364,35,94,127,221,1,100,5000,20
1365,35,70,96,166,1,100,5000,20
1366,35,47,37,84,1,100,5000,20
1367,35,45,26,71,1,100,5000,20
1368,35,21,12,33,1,100,5000,20
1369,35,83,125,208,1,100,5000,20
1370,35,5,19,24,1,100,5000,20
1371,35,76,136,212,1,100,5000,20
1372,35,121,156,277,1,100,5000,20
1373,35,39,37,76,1,100,5000,20
1374,35,67,128,195,1,100,5000,20
1375,35,175,215,390,1,100,5000,20
1376,35,51,57,108,1,100,5000,20
1377,35,64,116,180,1,100,5000,20
1378,35,78,84,162,1,100,5000,20
1379,35,38,60,98,1,100,5000,20
1380,35,66,79,145,1,100,5000,20
1381,35,20,50,70,1,100,5000,20
1382,35,110,180,290,1,100,5000,20
1383,35,86,149,235,1,100,5000,20
1384,35,77,101,178,1,100,5000,20
1385,35,30,81,111,1,100,5000,20
1386,35,70,75,145,1,100,5000,20
1387,35,4,28,32,1,100,5000,20
1388,35,2,16,18,1,100,5000,20
1389,35,93,147,240,1,100,5000,20
1390,35,81,110,191,1,100,5000,20
1391,35,78,118,196,1,100,5000,20
1392,35,48,111,159,1,100,5000,20
1393,35,46,98,144,1,100,5000,20
1394,35,35,55,90,1,100,5000,20
1395,35,29,112,141,1,100,5000,20
1396,35,2,24,26,1,100,5000,20
1397,35,41,92,133,1,100,5000,20
1398,35,250,342,592,1,100,5000,20
1399,35,40,57,97,1,100,5000,20
1400,35,64,72,136,1,100,5000,20
1401,35,48,196,244,1,100,5000,20
1402,35,123,124,247,1,100,5000,20
1403,35,53,128,181,1,100,5000,20
1404,35,13,34,47,1,100,5000,20
1405,35,83,100,183,1,100,5000,20
1406,35,13,33,46,1,100,5000,20
1407,35,19,87,106,1,100,5000,20
1408,35,125,271,396,1,100,5000,20
1409,35,74,347,421,1,100,5000,20
1410,35,53,169,222,1,100,5000,20
1411,35,137,159,296,1,100,5000,20
1412,35,128,126,254,1,100,5000,20
1413,35,85,91,176,1,100,5000,20
1414,35,115,186,301,1,100,5000,20
1415,35,5,29,34,1,100,5000,20
1416,35,71,95,166,1,100,5000,20
1417,35,22,115,137,1,100,5000,20
1418,35,76,267,343,1,100,5000,20
1419,35,33,222,255,1,100,5000,20
1420,35,41,122,163,1,100,5000,20
1421,35,8,42,50,1,100,5000,20
1422,35,56,170,226,1,100,5000,20
1423,35,154,217,371,1,100,5000,20
1424,35,15,83,98,1,100,5000,20
1425,35,90,113,203,1,100,5000,20
1426,35,67,111,178,1,100,5000,20
1427,35,23,27,50,1,100,5000,20
1428,35,28,63,91,1,100,5000,20
1429,35,1,25,26,1,100,5000,20
1430,35,26,36,62,1,100,5000,20
1431,35,61,61,122,1,100,5000,20
1432,35,76,136,212,1,100,5000,20
1433,35,30,81,111,1,100,5000,20
1434,35,49,81,130,1,100,5000,20
1435,35,53,51,104,1,100,5000,20
1436,35,42,59,101,1,100,5000,20
1437,35,11,18,29,1,100,5000,20
1438,35,11,18,29,1,100,5000,20
1439,35,90,116,206,1,100,5000,20
1440,35,38,33,71,1,100,5000,20
1441,35,60,30,90,1,100,5000,20
1442,35,22,26,48,1,100,5000,20
1443,35,28,58,86,1,100,5000,20
1444,35,27,156,183,1,100,5000,20
1445,35,12,46,58,1,100,5000,20
1446,35,41,64,105,1,100,5000,20
1447,35,108,112,220,1,100,5000,20
1448,35,52,159,211,1,100,5000,20
1449,35,69,75,144,1,100,5000,20
1450,35,17,29,46,1,100,5000,20
1451,35,8,41,49,1,100,5000,20
1452,35,18,37,55,1,100,5000,20
1453,35,8,34,42,1,100,5000,20
1454,35,4,30,34,1,100,5000,20
1455,35,93,173,266,1,100,5000,20
1456,35,10,30,40,1,100,5000,20
1457,35,58,123,181,1,100,5000,20
1458,35,146,245,391,1,100,5000,20
1459,35,90,116,206,1,100,5000,20
1460,35,93,98,191,1,100,5000,20
1461,35,91,146,237,1,100,5000,20
1462,35,23,43,66,1,100,5000,20
1463,35,45,134,179,1,100,5000,20
1464,35,9,42,51,1,100,5000,20
1465,35,71,120,191,1,100,5000,20
1466,35,108,105,213,1,100,5000,20
1467,35,100,85,185,1,100,5000,20
1468,35,44,78,122,1,100,5000,20
1469,35,59,90,149,1,100,5000,20
1470,35,93,306,399,1,100,5000,20
1471,35,14,33,47,1,100,5000,20
1472,35,36,76,112,1,100,5000,20
1473,35,31,58,89,1,100,5000,20
1474,35,32,62,94,1,100,5000,20
1475,35,82,61,143,1,100,5000,20
1476,35,99,88,187,1,100,5000,20
1477,35,32,48,80,1,100,5000,20
1478,35,86,132,218,1,100,5000,20
1479,35,48,95,143,1,100,5000,20
1480,35,51,63,114,1,100,5000,20
1481,35,20,30,50,1,100,5000,20
1482,35,56,70,126,1,100,5000,20
1483,35,32,52,84,1,100,5000,20
1484,35,14,27,41,1,100,5000,20
1485,35,75,143,218,1,100,5000,20
1486,35,45,68,113,1,100,5000,20
1487,35,68,148,216,1,100,5000,20
1488,35,64,103,167,1,100,5000,20
1489,35,112,184,296,1,100,5000,20
1490,35,27,97,124,1,100,5000,20
1491,35,80,139,219,1,100,5000,20
1492,35,63,159,222,1,100,5000,20
1493,35,44,132,176,1,100,5000,20
1494,35,55,201,256,1,100,5000,20
1495,35,41,53,94,1,100,5000,20
1496,35,51,70,121,1,100,5000,20
1497,35,68,140,208,1,100,5000,20
1498,35,31,50,81,1,100,5000,20
1499,35,22,31,53,1,100,5000,20
1500,35,60,85,145,1,100,5000,20
1501,35,27,58,85,1,100,5000,20
1502,35,19,24,43,1,100,5000,20
1503,35,46,80,126,1,100,5000,20
1504,35,24,42,66,1,100,5000,20
1505,35,6,4,10,1,100,5000,20
1506,35,66,95,161,1,100,5000,20
1507,35,39,55,94,1,100,5000,20
1508,35,12,39,51,1,100,5000,20
1509,35,57,97,154,1,100,5000,20
1510,35,36,89,125,1,100,5000,20
1511,35,79,174,253,1,100,5000,20
1512,35,68,85,153,1,100,5000,20
1513,35,137,174,311,1,100,5000,20
1514,35,72,74,146,1,100,5000,20
1515,35,24,65,89,1,100,5000,20
1516,35,12,44,56,1,100,5000,20
1517,35,32,71,103,1,100,5000,20
1518,35,1,9,10,1,100,5000,20
1519,35,1,2,3,1,100,5000,20
1520,35,39,116,155,1,100,5000,20
1521,35,28,70,98,1,100,5000,20
1522,35,16,77,93,1,100,5000,20
1523,35,72,141,213,1,100,5000,20
1524,35,30,29,59,1,100,5000,20
1525,35,24,42,66,1,100,5000,20
1526,35,40,54,94,1,100,5000,20
1527,35,44,41,85,1,100,5000,20
1528,35,43,85,128,1,100,5000,20
1529,35,63,55,118,1,100,5000,20
1530,35,105,101,206,1,100,5000,20
1531,35,91,105,196,1,100,5000,20
1532,35,56,74,130,1,100,5000,20
1533,35,71,98,169,1,100,5000,20
1534,35,194,148,342,1,100,5000,20
1535,35,155,190,345,1,100,5000,20
1536,35,57,84,141,1,100,5000,20
1537,35,97,99,196,1,100,5000,20
1538,35,11,18,29,1,100,5000,20
1539,35,63,86,149,1,100,5000,20
1540,35,76,78,154,1,100,5000,20
1541,35,47,79,126,1,100,5000,20
1542,35,9,18,27,1,100,5000,20
1543,35,36,63,99,1,100,5000,20
1544,35,44,73,117,1,100,5000,20
1545,35,88,139,227,1,100,5000,20
1546,35,31,21,52,1,100,5000,20
1547,35,62,61,123,1,100,5000,20
1548,35,121,119,240,1,100,5000,20
1549,35,73,113,186,1,100,5000,20
1550,35,85,79,164,1,100,5000,20
1551,35,32,122,154,1,100,5000,20
1552,35,29,59,88,1,100,5000,20
1553,35,62,47,109,1,100,5000,20
1554,35,28,57,85,1,100,5000,20
1555,35,48,67,115,1,100,5000,20
1556,35,39,30,69,1,100,5000,20
1557,35,63,102,165,1,100,5000,20
1558,35,24,47,71,1,100,5000,20
1559,35,24,17,41,1,100,5000,20
1560,35,85,137,222,1,100,5000,20
1561,35,6,6,12,1,100,5000,20
1562,35,24,40,64,1,100,5000,20
1563,35,42,53,95,1,100,5000,20
1564,35,18,13,31,1,100,5000,20
1565,35,28,34,62,1,100,5000,20
1566,35,13,32,45,1,100,5000,20
1567,35,35,57,92,1,100,5000,20
1568,35,9,27,36,1,100,5000,20
1569,35,69,72,141,1,100,5000,20
1570,35,31,42,73,1,100,5000,20
1571,35,47,60,107,1,100,5000,20
1572,35,88,68,156,1,100,5000,20
1573,35,79,77,156,1,100,5000,20
1574,35,106,149,255,1,100,5000,20
1575,35,71,98,169,1,100,5000,20
1576,35,172,116,288,1,100,5000,20
1577,35,53,50,103,1,100,5000,20
1578,35,66,93,159,1,100,5000,20
1579,35,80,75,155,1,100,5000,20
1580,35,21,37,58,1,100,5000,20
1581,35,4,31,35,1,100,5000,20
1582,35,98,125,223,1,100,5000,20
1583,35,2,14,16,1,100,5000,20
1584,35,30,17,47,1,100,5000,20
1585,35,49,20,69,1,100,5000,20
1586,35,60,85,145,1,100,5000,20
1587,35,69,115,184,1,100,5000,20
1588,35,57,162,219,1,100,5000,20
1589,35,55,93,148,1,100,5000,20
1590,35,87,160,247,1,100,5000,20
1591,35,102,106,208,1,100,5000,20
1592,35,46,59,105,1,100,5000,20
1593,35,43,97,140,1,100,5000,20
1594,35,16,51,67,1,100,5000,20
1595,35,45,57,102,1,100,5000,20
1596,35,35,51,86,1,100,5000,20
1597,35,36,27,63,1,100,5000,20
1598,35,49,80,129,1,100,5000,20
1599,35,79,89,168,1,100,5000,20
1600,35,71,108,179,1,100,5000,20
1601,35,126,257,383,1,100,5000,20
1602,35,43,32,75,1,100,5000,20
1603,35,83,113,196,1,100,5000,20
1604,35,93,104,197,1,100,5000,20
1605,35,48,78,126,1,100,5000,20
1606,35,77,84,161,1,100,5000,20
1607,35,17,34,51,1,100,5000,20
1608,35,4,16,20,1,100,5000,20
1609,35,22,47,69,1,100,5000,20
1610,35,4,3,7,1,100,5000,20
1611,35,58,150,208,1,100,5000,20
1612,35,41,247,288,1,100,5000,20
1613,35,135,195,330,1,100,5000,20
1614,35,104,191,295,1,100,5000,20
1615,35,16,53,69,1,100,5000,20
1616,35,9,24,33,1,100,5000,20
1617,35,35,87,122,1,100,5000,20
1618,35,13,123,136,1,100,5000,20
1619,35,71,91,162,1,100,5000,20
1620,35,38,34,72,1,100,5000,20
1621,35,81,145,226,1,100,5000,20
1622,35,15,24,39,1,100,5000,20
1623,35,65,156,221,1,100,5000,20
1624,35,18,114,132,1,100,5000,20
1625,35,30,31,61,1,100,5000,20
1626,35,35,87,122,1,100,5000,20
1627,35,32,76,108,1,100,5000,20
1628,35,60,134,194,1,100,5000,20
1629,35,68,107,175,1,100,5000,20
1630,35,63,48,111,1,100,5000,20
1631,35,7,32,39,1,100,5000,20
1632,35,33,51,84,1,100,5000,20
1633,35,42,103,145,1,100,5000,20
1634,35,35,97,132,1,100,5000,20
1635,35,4,44,48,1,100,5000,20
1636,35,2,13,15,1,100,5000,20
1637,35,42,64,106,1,100,5000,20
1638,35,35,16,51,1,100,5000,20
1639,35,71,105,176,1,100,5000,20
1640,35,61,67,128,1,100,5000,20
1641,35,44,35,79,1,100,5000,20
1642,35,102,151,253,1,100,5000,20
1643,35,213,235,448,1,100,5000,20
1644,35,23,60,83,1,100,5000,20
1645,35,59,87,146,1,100,5000,20
1646,35,56,139,195,1,100,5000,20
1647,35,59,107,166,1,100,5000,20
1648,35,56,99,155,1,100,5000,20
1649,35,65,106,171,1,100,5000,20
1650,35,54,71,125,1,100,5000,20
1651,35,55,68,123,1,100,5000,20
1652,35,24,167,191,1,100,5000,20
1653,35,52,56,108,1,100,5000,20
1654,35,22,60,82,1,100,5000,20
1655,35,15,60,75,1,100,5000,20
1656,35,22,73,95,1,100,5000,20
1657,35,18,30,48,1,100,5000,20
1658,35,2,30,32,1,100,5000,20
1659,35,15,36,51,1,100,5000,20
1660,35,21,27,48,1,100,5000,20
1661,35,46,89,135,1,100,5000,20
1662,35,13,22,35,1,100,5000,20
1663,35,44,107,151,1,100,5000,20
1664,35,26,46,72,1,100,5000,20
1665,35,34,67,101,1,100,5000,20
1666,35,35,38,73,1,100,5000,20
1667,35,29,64,93,1,100,5000,20
1668,35,37,85,122,1,100,5000,20
1669,35,40,134,174,1,100,5000,20
1670,35,16,31,47,1,100,5000,20
1671,35,51,110,161,1,100,5000,20
1672,35,8,54,62,1,100,5000,20
1673,35,40,66,106,1,100,5000,20
1674,35,41,36,77,1,100,5000,20
1675,35,41,62,103,1,100,5000,20
1676,35,18,68,86,1,100,5000,20
1677,35,12,13,25,1,100,5000,20
1678,35,2,15,17,1,100,5000,20
1679,35,76,125,201,1,100,5000,20
1680,35,6,75,81,1,100,5000,20
1681,35,6,37,43,1,100,5000,20
1682,35,2,11,13,1,100,5000,20
1683,35,67,113,180,1,100,5000,20
1684,35,66,143,209,1,100,5000,20
1685,35,65,100,165,1,100,5000,20
1686,35,58,103,161,1,100,5000,20
1687,35,70,113,183,1,100,5000,20
1688,35,48,74,122,1,100,5000,20
1689,35,41,89,130,1,100,5000,20
1690,35,37,170,207,1,100,5000,20
1691,35,52,67,119,1,100,5000,20
1692,35,20,62,82,1,100,5000,20
1693,35,16,64,80,1,100,5000,20
1694,35,20,78,98,1,100,5000,20
1695,35,27,21,48,1,100,5000,20
1696,35,4,31,35,1,100,5000,20
1697,35,16,34,50,1,100,5000,20
1698,50,52,88,140,1,100,5000,20
1699,50,60,173,233,1,100,5000,20
1700,50,28,126,154,1,100,5000,20
1701,50,57,175,232,1,100,5000,20
1702,50,7,22,29,1,100,5000,20
1703,50,23,46,69,1,100,5000,20
1704,50,44,169,213,1,100,5000,20
1705,50,147,180,327,1,100,5000,20
1706,50,8,41,49,1,100,5000,20
1707,50,28,97,125,1,100,5000,20
1708,50,84,129,213,1,100,5000,20
1709,50,109,171,280,1,100,5000,20
1710,50,16,32,48,1,100,5000,20
1711,50,63,128,191,1,100,5000,20
1712,50,45,110,155,1,100,5000,20
1713,50,51,114,165,1,100,5000,20
1714,50,73,169,242,1,100,5000,20
1715,50,45,97,142,1,100,5000,20
1716,50,33,65,98,1,100,5000,20
1717,50,55,97,152,1,100,5000,20
1718,50,26,101,127,1,100,5000,20
1719,50,56,155,211,1,100,5000,20
1720,50,95,408,503,1,100,5000,20
1721,50,89,244,333,1,100,5000,20
1722,50,76,134,210,1,100,5000,20
1723,50,82,210,292,1,100,5000,20
1724,50,32,160,192,1,100,5000,20
1725,50,9,21,30,1,100,5000,20
1726,50,54,194,248,1,100,5000,20
1727,50,27,46,73,1,100,5000,20
1728,50,21,102,123,1,100,5000,20
1729,50,13,105,118,1,100,5000,20
1730,50,29,73,102,1,100,5000,20
1731,50,29,65,94,1,100,5000,20
1732,50,38,153,191,1,100,5000,20
1733,50,26,21,47,1,100,5000,20
1734,50,18,119,137,1,100,5000,20
1735,50,13,92,105,1,100,5000,20
1736,50,55,131,186,1,100,5000,20
1737,50,78,165,243,1,100,5000,20
1738,50,41,92,133,1,100,5000,20
1739,50,3,39,42,1,100,5000,20
1740,50,28,48,76,1,100,5000,20
1741,50,29,150,179,1,100,5000,20
1742,50,62,131,193,1,100,5000,20
1743,50,46,160,206,1,100,5000,20
1744,50,23,107,130,1,100,5000,20
1745,50,78,245,323,1,100,5000,20
1746,50,12,62,74,1,100,5000,20
1747,50,24,114,138,1,100,5000,20
1748,50,47,144,191,1,100,5000,20
1749,50,24,88,112,1,100,5000,20
1750,50,105,185,290,1,100,5000,20
1751,50,36,63,99,1,100,5000,20
1752,50,37,84,121,1,100,5000,20
1753,50,81,226,307,1,100,5000,20
1754,50,29,184,213,1,100,5000,20
1755,50,14,31,45,1,100,5000,20
1756,50,22,38,60,1,100,5000,20
1757,50,6,49,55,1,100,5000,20
1758,50,65,235,300,1,100,5000,20
1759,50,16,155,171,1,100,5000,20
1760,50,4,15,19,1,100,5000,20
1761,50,57,107,164,1,100,5000,20
1762,50,65,178,243,1,100,5000,20
1763,50,47,109,156,1,100,5000,20
1764,50,21,53,74,1,100,5000,20
1765,50,27,193,220,1,100,5000,20
1766,50,24,90,114,1,100,5000,20
1767,50,14,44,58,1,100,5000,20
1768,50,5,30,35,1,100,5000,20
1769,50,43,114,157,1,100,5000,20
1770,50,23,56,79,1,100,5000,20
1771,50,13,20,33,1,100,5000,20
1772,50,30,57,87,1,100,5000,20
1773,50,35,108,143,1,100,5000,20
1774,50,16,135,151,1,100,5000,20
1775,50,68,131,199,1,100,5000,20
1776,50,69,104,173,1,100,5000,20
1777,50,25,41,66,1,100,5000,20
1778,50,67,88,155,1,100,5000,20
1779,50,92,215,307,1,100,5000,20
1780,50,95,185,280,1,100,5000,20
1781,50,40,91,131,1,100,5000,20
1782,50,14,40,54,1,100,5000,20
1783,50,23,85,108,1,100,5000,20
1784,50,69,122,191,1,100,5000,20
1785,50,34,90,124,1,100,5000,20
1786,50,21,58,79,1,100,5000,20
1787,50,48,79,127,1,100,5000,20
1788,50,33,54,87,1,100,5000,20
1789,50,8,18,26,1,100,5000,20
1790,50,62,133,195,1,100,5000,20
1791,50,58,133,191,1,100,5000,20
1792,50,56,91,147,1,100,5000,20
1793,50,102,129,231,1,100,5000,20
1794,50,21,60,81,1,100,5000,20
1795,50,22,43,65,1,100,5000,20
1796,50,51,84,135,1,100,5000,20
1797,50,19,46,65,1,100,5000,20
1798,50,11,32,43,1,100,5000,20
1799,50,44,86,130,1,100,5000,20
1800,50,76,217,293,1,100,5000,20
1801,50,17,42,59,1,100,5000,20
1802,50,35,15,50,1,100,5000,20
1803,50,30,126,156,1,100,5000,20
1804,50,47,63,110,1,100,5000,20
1805,50,14,99,113,1,100,5000,20
1806,50,64,166,230,1,100,5000,20
1807,50,11,23,34,1,100,5000,20
1808,50,22,31,53,1,100,5000,20
1809,50,37,171,208,1,100,5000,20
1810,50,75,149,224,1,100,5000,20
1811,50,72,96,168,1,100,5000,20
1812,50,35,69,104,1,100,5000,20
1813,50,30,65,95,1,100,5000,20
1814,50,93,106,199,1,100,5000,20
1815,50,43,83,126,1,100,5000,20
1816,50,38,48,86,1,100,5000,20
1817,50,19,227,246,1,100,5000,20
1818,50,69,131,200,1,100,5000,20
1819,50,9,45,54,1,100,5000,20
1820,50,6,17,23,1,100,5000,20
1821,50,78,147,225,1,100,5000,20
1822,50,83,165,248,1,100,5000,20
1823,50,60,71,131,1,100,5000,20
1824,50,26,193,219,1,100,5000,20
1825,50,37,67,104,1,100,5000,20
1826,50,19,15,34,1,100,5000,20
1827,50,22,44,66,1,100,5000,20
1828,50,137,251,388,1,100,5000,20
1829,50,13,23,36,1,100,5000,20
1830,50,60,86,146,1,100,5000,20
1831,50,62,98,160,1,100,5000,20
1832,50,63,85,148,1,100,5000,20
1833,50,31,64,95,1,100,5000,20
1834,50,45,99,144,1,100,5000,20
1835,50,30,22,52,1,100,5000,20
1836,50,33,164,197,1,100,5000,20
1837,50,26,59,85,1,100,5000,20
1838,50,40,139,179,1,100,5000,20
1839,50,25,123,148,1,100,5000,20
1840,50,13,21,34,1,100,5000,20
1841,50,26,91,117,1,100,5000,20
1842,50,12,21,33,1,100,5000,20
1843,50,65,162,227,1,100,5000,20
1844,50,32,71,103,1,100,5000,20
1845,50,51,110,161,1,100,5000,20
1846,50,5,32,37,1,100,5000,20
1847,50,12,39,51,1,100,5000,20
1848,50,45,85,130,1,100,5000,20
1849,50,10,56,66,1,100,5000,20
1850,50,45,91,136,1,100,5000,20
1851,50,17,69,86,1,100,5000,20
1852,50,8,26,34,1,100,5000,20
1853,50,51,115,166,1,100,5000,20
1854,50,25,42,67,1,100,5000,20
1855,50,22,144,166,1,100,5000,20
1856,50,13,73,86,1,100,5000,20
1857,50,51,144,195,1,100,5000,20
1858,50,9,53,62,1,100,5000,20
1859,50,48,152,200,1,100,5000,20
1860,50,47,115,162,1,100,5000,20
1861,50,20,45,65,1,100,5000,20
1862,50,67,186,253,1,100,5000,20
1863,50,67,180,247,1,100,5000,20
1864,50,20,121,141,1,100,5000,20
1865,50,12,11,23,1,100,5000,20
1866,50,54,142,196,1,100,5000,20
1867,50,71,120,191,1,100,5000,20
1868,50,35,51,86,1,100,5000,20
1869,50,65,135,200,1,100,5000,20
1870,50,52,124,176,1,100,5000,20
1871,50,26,127,153,1,100,5000,20
1872,50,12,57,69,1,100,5000,20
1873,50,31,56,87,1,100,5000,20
1874,50,13,55,68,1,100,5000,20
1875,50,21,63,84,1,100,5000,20
1876,50,20,72,92,1,100,5000,20
1877,50,4,23,27,1,100,5000,20
1878,50,1,58,59,1,100,5000,20
1879,50,16,44,60,1,100,5000,20
1880,50,20,36,56,1,100,5000,20
1881,50,123,125,248,1,100,5000,20
1882,50,57,105,162,1,100,5000,20
1883,50,40,50,90,1,100,5000,20
1884,50,51,141,192,1,100,5000,20
1885,50,65,149,214,1,100,5000,20
1886,50,45,87,132,1,100,5000,20
1887,50,27,49,76,1,100,5000,20
1888,50,32,107,139,1,100,5000,20
1889,50,25,89,114,1,100,5000,20
1890,50,13,53,66,1,100,5000,20
1891,50,26,65,91,1,100,5000,20
1892,50,14,45,59,1,100,5000,20
1893,50,48,144,192,1,100,5000,20
1894,50,12,81,93,1,100,5000,20
1895,50,28,66,94,1,100,5000,20
1896,50,44,96,140,1,100,5000,20
1897,50,10,13,23,1,100,5000,20
1898,50,11,76,87,1,100,5000,20
1899,50,11,98,109,1,100,5000,20
1900,50,42,160,202,1,100,5000,20
1901,50,39,202,241,1,100,5000,20
1902,50,23,71,94,1,100,5000,20
1903,50,37,120,157,1,100,5000,20
1904,50,32,68,100,1,100,5000,20
1905,50,66,233,299,1,100,5000,20
1906,50,110,201,311,1,100,5000,20
1907,50,19,79,98,1,100,5000,20
1908,50,46,100,146,1,100,5000,20
1909,50,42,218,260,1,100,5000,20
1910,50,33,151,184,1,100,5000,20
1911,50,48,124,172,1,100,5000,20
1912,50,33,114,147,1,100,5000,20
1913,50,46,46,92,1,100,5000,20
1914,50,28,35,63,1,100,5000,20
1915,50,50,144,194,1,100,5000,20
1916,50,26,59,85,1,100,5000,20
1917,50,47,56,103,1,100,5000,20
1918,50,53,93,146,1,100,5000,20
1919,50,29,57,86,1,100,5000,20
1920,50,14,51,65,1,100,5000,20
1921,50,24,108,132,1,100,5000,20
1922,50,5,39,44,1,100,5000,20
1923,50,16,86,102,1,100,5000,20
1924,50,27,58,85,1,100,5000,20
1925,50,15,26,41,1,100,5000,20
1926,50,15,21,36,1,100,5000,20
1927,50,97,174,271,1,100,5000,20
1928,50,53,118,171,1,100,5000,20
1929,50,97,203,300,1,100,5000,20
1930,50,38,76,114,1,100,5000,20
1931,50,50,53,103,1,100,5000,20
1932,50,32,67,99,1,100,5000,20
1933,50,2,6,8,1,100,5000,20
1934,50,23,85,108,1,100,5000,20
1935,50,7,22,29,1,100,5000,20
1936,50,16,38,54,1,100,5000,20
1937,50,39,73,112,1,100,5000,20
1938,50,100,107,207,1,100,5000,20
1939,50,56,115,171,1,100,5000,20
1940,50,37,45,82,1,100,5000,20
1941,50,85,256,341,1,100,5000,20
1942,50,32,46,78,1,100,5000,20
1943,50,112,139,251,1,100,5000,20
1944,50,12,15,27,1,100,5000,20
1945,50,50,137,187,1,100,5000,20
1946,50,83,151,234,1,100,5000,20
1947,50,66,63,129,1,100,5000,20
1948,50,24,82,106,1,100,5000,20
1949,50,9,24,33,1,100,5000,20
1950,50,20,62,82,1,100,5000,20
1951,50,70,92,162,1,100,5000,20
1952,50,33,92,125,1,100,5000,20
1953,50,79,198,277,1,100,5000,20
1954,50,48,54,102,1,100,5000,20
1955,50,22,79,101,1,100,5000,20
1956,50,26,34,60,1,100,5000,20
1957,50,28,59,87,1,100,5000,20
1958,50,48,116,164,1,100,5000,20
1959,50,27,53,80,1,100,5000,20
1960,50,37,81,118,1,100,5000,20
1961,50,8,36,44,1,100,5000,20
1962,50,42,67,109,1,100,5000,20
1963,50,7,32,39,1,100,5000,20
1964,50,53,113,166,1,100,5000,20
1965,50,28,59,87,1,100,5000,20
1966,50,27,74,101,1,100,5000,20
1967,50,39,133,172,1,100,5000,20
1968,50,90,160,250,1,100,5000,20
1969,50,31,58,89,1,100,5000,20
1970,50,21,49,70,1,100,5000,20
1971,50,29,59,88,1,100,5000,20
1972,50,24,88,112,1,100,5000,20
1973,50,40,89,129,1,100,5000,20
1974,50,10,39,49,1,100,5000,20
1975,50,8,12,20,1,100,5000,20
1976,50,17,68,85,1,100,5000,20
1977,50,17,21,38,1,100,5000,20
1978,50,17,31,48,1,100,5000,20
1979,50,14,61,75,1,100,5000,20
1980,50,18,84,102,1,100,5000,20
1981,50,3,39,42,1,100,5000,20
1982,50,14,54,68,1,100,5000,20
1983,50,48,41,89,1,100,5000,20
1984,50,66,257,323,1,100,5000,20
1985,50,28,60,88,1,100,5000,20
1986,50,35,115,150,1,100,5000,20
1987,50,12,93,105,1,100,5000,20
1988,80,6,9,15,1,100,5000,20
1989,80,3,33,36,1,100,5000,20
1990,80,8,34,42,1,100,5000,20
1991,80,5,8,13,1,100,5000,20
1992,80,19,16,35,1,100,5000,20
1993,80,3,26,29,1,100,5000,20
1994,80,14,67,81,1,100,5000,20
1995,80,21,39,60,1,100,5000,20
1996,80,5,24,29,1,100,5000,20
1997,80,12,39,51,1,100,5000,20
1998,80,14,73,87,1,100,5000,20
1999,80,3,52,55,1,100,5000,20
2000,80,12,83,95,1,100,5000,20
2001,80,7,11,18,1,100,5000,20
2002,80,14,18,32,1,100,5000,20
2003,80,5,48,53,1,100,5000,20
2004,80,1,20,21,1,100,5000,20
2005,80,12,25,37,1,100,5000,20
2006,80,6,8,14,1,100,5000,20
2007,80,34,78,112,1,100,5000,20
2008,80,13,54,67,1,100,5000,20
2009,80,4,33,37,1,100,5000,20
2010,80,4,34,38,1,100,5000,20
2011,80,8,28,36,1,100,5000,20
2012,80,18,56,74,1,100,5000,20
2013,80,18,109,127,1,100,5000,20
2014,80,11,14,25,1,100,5000,20
2015,80,5,65,70,1,100,5000,20
2016,80,4,10,14,1,100,5000,20
2017,80,3,15,18,1,100,5000,20
2018,80,3,16,19,1,100,5000,20
2019,80,8,46,54,1,100,5000,20
2020,80,14,40,54,1,100,5000,20
2021,80,3,19,22,1,100,5000,20
2022,80,44,55,99,1,100,5000,20
2023,80,12,22,34,1,100,5000,20
2024,80,28,140,168,1,100,5000,20
2025,80,12,62,74,1,100,5000,20
2026,80,10,46,56,1,100,5000,20
2027,80,8,84,92,1,100,5000,20
2028,80,8,49,57,1,100,5000,20
2029,80,4,36,40,1,100,5000,20
2030,80,21,92,113,1,100,5000,20
2031,80,40,93,133,1,100,5000,20
2032,80,10,178,188,1,100,5000,20
2033,80,23,117,140,1,100,5000,20
2034,80,22,160,182,1,100,5000,20
2035,80,7,55,62,1,100,5000,20
2036,80,5,47,52,1,100,5000,20
2037,80,8,43,51,1,100,5000,20
2038,80,6,40,46,1,100,5000,20
2039,80,10,27,37,1,100,5000,20
2040,80,30,58,88,1,100,5000,20
2041,80,48,108,156,1,100,5000,20
2042,80,12,75,87,1,100,5000,20
2043,80,7,28,35,1,100,5000,20
2044,80,6,48,54,1,100,5000,20
2045,80,10,48,58,1,100,5000,20
2046,80,5,40,45,1,100,5000,20
2047,80,2,21,23,1,100,5000,20
2048,80,14,117,131,1,100,5000,20
2049,80,1,12,13,1,100,5000,20
2050,80,1,108,109,1,100,5000,20
2051,80,5,19,24,1,100,5000,20
2052,80,16,22,38,1,100,5000,20
2053,80,0,61,61,1,100,5000,20
2054,80,1,7,8,1,100,5000,20
2055,80,3,32,35,1,100,5000,20
2056,80,1,26,27,1,100,5000,20
2057,80,10,68,78,1,100,5000,20
2058,80,11,25,36,1,100,5000,20
2059,80,14,47,61,1,100,5000,20
2060,80,11,24,35,1,100,5000,20
2061,80,5,28,33,1,100,5000,20
2062,80,7,38,45,1,100,5000,20
2063,80,9,14,23,1,100,5000,20
2064,80,7,23,30,1,100,5000,20
2065,80,6,18,24,1,100,5000,20
2066,80,10,10,20,1,100,5000,20
2067,80,1,5,6,1,100,5000,20
2068,80,5,9,14,1,100,5000,20
2069,80,15,45,60,1,100,5000,20
2070,80,9,31,40,1,100,5000,20
2071,80,15,55,70,1,100,5000,20
2072,80,0,3,3,1,100,5000,20
2073,80,9,42,51,1,100,5000,20
2074,80,0,0,0,1,100,5000,20
2075,80,7,18,25,1,100,5000,20
2076,80,0,0,0,1,100,5000,20
2077,80,1,22,23,1,100,5000,20
2078,80,7,11,18,1,100,5000,20
2079,80,14,16,30,1,100,5000,20
2080,80,14,23,37,1,100,5000,20
2081,80,13,26,39,1,100,5000,20
2082,80,26,64,90,1,100,5000,20
2083,80,17,49,66,1,100,5000,20
2084,80,4,11,15,1,100,5000,20
2085,80,11,15,26,1,100,5000,20
2086,80,12,58,70,1,100,5000,20
2087,80,5,40,45,1,100,5000,20
2088,80,4,14,18,1,100,5000,20
2089,80,7,39,46,1,100,5000,20
2090,80,12,23,35,1,100,5000,20
2091,80,28,90,118,1,100,5000,20
2092,80,25,145,170,1,100,5000,20
2093,80,5,37,42,1,100,5000,20
2094,80,3,17,20,1,100,5000,20
2095,80,7,46,53,1,100,5000,20
2096,80,5,16,21,1,100,5000,20
2097,80,19,79,98,1,100,5000,20
2098,80,23,34,57,1,100,5000,20
2099,80,17,43,60,1,100,5000,20
2100,80,11,21,32,1,100,5000,20
2101,80,15,71,86,1,100,5000,20
2102,80,12,68,80,1,100,5000,20
2103,80,21,70,91,1,100,5000,20
2104,80,15,47,62,1,100,5000,20
2105,80,0,15,15,1,100,5000,20
2106,80,3,21,24,1,100,5000,20
2107,80,3,8,11,1,100,5000,20
2108,80,11,11,22,1,100,5000,20
2109,80,9,12,21,1,100,5000,20
2110,80,8,28,36,1,100,5000,20
2111,80,11,32,43,1,100,5000,20
2112,80,31,48,79,1,100,5000,20
2113,80,12,42,54,1,100,5000,20
2114,80,9,16,25,1,100,5000,20
2115,80,22,7,29,1,100,5000,20
2116,80,5,7,12,1,100,5000,20
2117,80,7,11,18,1,100,5000,20
2118,80,29,39,68,1,100,5000,20
2119,80,18,38,56,1,100,5000,20
2120,80,9,49,58,1,100,5000,20
2121,80,17,58,75,1,100,5000,20
2122,80,6,39,45,1,100,5000,20
2123,80,5,19,24,1,100,5000,20
2124,80,6,19,25,1,100,5000,20
2125,80,17,26,43,1,100,5000,20
2126,80,4,17,21,1,100,5000,20
2127,80,2,8,10,1,100,5000,20
2128,80,1,5,6,1,100,5000,20
2129,80,9,40,49,1,100,5000,20
2130,80,7,61,68,1,100,5000,20
2131,80,25,135,160,1,100,5000,20
2132,80,3,19,22,1,100,5000,20
2133,80,8,17,25,1,100,5000,20
2134,80,2,23,25,1,100,5000,20
2135,80,0,59,59,1,100,5000,20
2136,80,1,20,21,1,100,5000,20
2137,80,5,36,41,1,100,5000,20
2138,80,17,78,95,1,100,5000,20
2139,80,6,33,39,1,100,5000,20
2140,80,2,30,32,1,100,5000,20
2141,80,9,47,56,1,100,5000,20
2142,80,6,34,40,1,100,5000,20
2143,80,15,69,84,1,100,5000,20
2144,80,45,248,293,1,100,5000,20
2145,80,7,21,28,1,100,5000,20
2146,80,9,55,64,1,100,5000,20
2147,80,19,48,67,1,100,5000,20
2148,80,0,16,16,1,100,5000,20
2149,80,22,220,242,1,100,5000,20
2150,80,7,14,21,1,100,5000,20
2151,80,26,62,88,1,100,5000,20
2152,80,17,73,90,1,100,5000,20
2153,80,8,22,30,1,100,5000,20
2154,80,6,37,43,1,100,5000,20
2155,80,3,27,30,1,100,5000,20
2156,80,22,83,105,1,100,5000,20
2157,80,20,59,79,1,100,5000,20
2158,80,24,82,106,1,100,5000,20
2159,80,28,109,137,1,100,5000,20
2160,80,17,36,53,1,100,5000,20
2161,80,22,70,92,1,100,5000,20
2162,80,17,80,97,1,100,5000,20
2163,80,43,46,89,1,100,5000,20
2164,80,30,63,93,1,100,5000,20
2165,80,0,22,22,1,100,5000,20
2166,80,11,91,102,1,100,5000,20
2167,80,14,85,99,1,100,5000,20
2168,80,15,110,125,1,100,5000,20
2169,80,28,101,129,1,100,5000,20
2170,80,24,98,122,1,100,5000,20
2171,80,3,30,33,1,100,5000,20
2172,80,29,58,87,1,100,5000,20
2173,80,5,22,27,1,100,5000,20
2174,80,18,37,55,1,100,5000,20
2175,80,24,44,68,1,100,5000,20
2176,80,14,48,62,1,100,5000,20
2177,80,33,157,190,1,100,5000,20
2178,80,9,130,139,1,100,5000,20
2179,80,4,10,14,1,100,5000,20
2180,80,8,45,53,1,100,5000,20
2181,80,4,38,42,1,100,5000,20
2182,80,32,57,89,1,100,5000,20
2183,80,4,31,35,1,100,5000,20
2184,80,51,116,167,1,100,5000,20
2185,80,54,136,190,1,100,5000,20
2186,80,31,80,111,1,100,5000,20
2187,80,7,58,65,1,100,5000,20
2188,80,41,152,193,1,100,5000,20
2189,80,24,136,160,1,100,5000,20
2190,80,9,78,87,1,100,5000,20
2191,80,3,15,18,1,100,5000,20
2192,80,14,85,99,1,100,5000,20
2193,80,16,168,184,1,100,5000,20
2194,80,27,80,107,1,100,5000,20
2195,80,10,25,35,1,100,5000,20
2196,80,31,72,103,1,100,5000,20
2197,80,12,33,45,1,100,5000,20
2198,80,9,23,32,1,100,5000,20
2199,80,12,63,75,1,100,5000,20
2200,80,2,6,8,1,100,5000,20
2201,80,3,14,17,1,100,5000,20
2202,80,9,29,38,1,100,5000,20
2203,80,20,46,66,1,100,5000,20
2204,80,25,44,69,1,100,5000,20
2205,80,10,16,26,1,100,5000,20
2206,80,8,24,32,1,100,5000,20
2207,80,20,76,96,1,100,5000,20
2208,80,6,37,43,1,100,5000,20
2209,80,10,34,44,1,100,5000,20
2210,80,9,123,132,1,100,5000,20
2211,80,2,5,7,1,100,5000,20
2212,80,11,71,82,1,100,5000,20
2213,80,2,73,75,1,100,5000,20
2214,80,13,64,77,1,100,5000,20
2215,80,10,82,92,1,100,5000,20
2216,80,4,21,25,1,100,5000,20
2217,80,3,36,39,1,100,5000,20
2218,80,11,51,62,1,100,5000,20
2219,80,10,71,81,1,100,5000,20
2220,80,23,86,109,1,100,5000,20
2221,80,4,55,59,1,100,5000,20
2222,80,6,49,55,1,100,5000,20
2223,80,7,43,50,1,100,5000,20
2224,80,14,87,101,1,100,5000,20
2225,80,12,34,46,1,100,5000,20
2226,80,9,62,71,1,100,5000,20
2227,80,0,26,26,1,100,5000,20
2228,80,6,9,15,1,100,5000,20
2229,80,16,67,83,1,100,5000,20
2230,80,5,28,33,1,100,5000,20
2231,80,26,31,57,1,100,5000,20
2232,80,34,51,85,1,100,5000,20
2233,80,11,33,44,1,100,5000,20
2234,80,16,23,39,1,100,5000,20
2235,80,7,7,14,1,100,5000,20
2236,80,7,25,32,1,100,5000,20
2237,80,11,58,69,1,100,5000,20
2238,80,0,0,0,1,100,5000,20
2239,80,2,7,9,1,100,5000,20
2240,80,6,11,17,1,100,5000,20
2241,80,3,5,8,1,100,5000,20
2242,80,8,39,47,1,100,5000,20
2243,80,12,24,36,1,100,5000,20
2244,80,18,29,47,1,100,5000,20
2245,80,9,25,34,1,100,5000,20
2246,80,16,27,43,1,100,5000,20
2247,80,15,15,30,1,100,5000,20
2248,80,17,16,33,1,100,5000,20
2249,80,12,46,58,1,100,5000,20
2250,80,20,60,80,1,100,5000,20
2251,80,10,50,60,1,100,5000,20
2252,80,15,33,48,1,100,5000,20
2253,80,7,39,46,1,100,5000,20
2254,80,18,48,66,1,100,5000,20
2255,80,5,45,50,1,100,5000,20
2256,80,3,22,25,1,100,5000,20
2257,80,13,15,28,1,100,5000,20
2258,80,8,29,37,1,100,5000,20
2259,80,21,52,73,1,100,5000,20
2260,80,14,23,37,1,100,5000,20
2261,80,25,47,72,1,100,5000,20
2262,80,24,87,111,1,100,5000,20
2263,80,12,33,45,1,100,5000,20
2264,80,4,17,21,1,100,5000,20
2265,80,4,4,8,1,100,5000,20
2266,80,19,38,57,1,100,5000,20
2267,80,8,16,24,1,100,5000,20
2268,80,11,28,39,1,100,5000,20
2269,80,5,29,34,1,100,5000,20
2270,80,13,13,26,1,100,5000,20
2271,80,11,18,29,1,100,5000,20
2272,80,21,33,54,1,100,5000,20
2273,80,25,72,97,1,100,5000,20
2274,80,9,28,37,1,100,5000,20
2275,80,13,19,32,1,100,5000,20
2276,80,23,83,106,1,100,5000,20
2277,80,9,37,46,1,100,5000,20
2278,80,2,15,17,1,100,5000,20
2279,80,10,34,44,1,100,5000,20
2280,80,21,45,66,1,100,5000,20
2281,80,7,26,33,1,100,5000,20
2282,80,32,119,151,1,100,5000,20
2283,80,3,7,10,1,100,5000,20
2284,80,4,20,24,1,100,5000,20
2285,75,86,78,164,1,100,NaN,NaN
2286,75,89,97,186,1,100,NaN,NaN
2287,75,80,404,484,1,100,NaN,NaN
2288,75,20,52,72,1,100,NaN,NaN
2289,75,65,112,177,1,100,NaN,NaN
2290,75,73,85,158,1,100,NaN,NaN
2291,75,41,198,239,1,100,NaN,NaN
2292,75,96,118,214,1,100,NaN,NaN
2293,75,42,161,203,1,100,NaN,NaN
2294,75,72,203,275,1,100,NaN,NaN
2295,75,20,72,92,1,100,NaN,NaN
2296,75,34,84,118,1,100,NaN,NaN
2297,75,70,197,267,1,100,NaN,NaN
2298,75,110,114,224,1,100,NaN,NaN
2299,75,123,136,259,1,100,NaN,NaN
2300,75,90,224,314,1,100,NaN,NaN
2301,75,26,153,179,1,100,NaN,NaN
2302,75,23,69,92,1,100,NaN,NaN
2303,75,32,166,198,1,100,NaN,NaN
2304,75,144,363,507,1,100,NaN,NaN
2305,75,120,253,373,1,100,NaN,NaN
2306,75,141,179,320,1,100,NaN,NaN
2307,75,60,98,158,1,100,NaN,NaN
2308,75,92,147,239,1,100,NaN,NaN
2309,75,64,205,269,1,100,NaN,NaN
2310,75,194,148,342,1,100,NaN,NaN
2311,75,295,273,568,1,100,NaN,NaN
2312,75,89,118,207,1,100,NaN,NaN
2313,75,261,260,521,1,100,NaN,NaN
2314,75,52,51,103,1,100,NaN,NaN
2315,75,63,102,165,1,100,NaN,NaN
2316,75,116,225,341,1,100,NaN,NaN
2317,75,95,161,256,1,100,NaN,NaN
2318,75,59,119,178,1,100,NaN,NaN
2319,75,109,197,306,1,100,NaN,NaN
2320,75,78,179,257,1,100,NaN,NaN
2321,75,137,146,283,1,100,NaN,NaN
2322,75,68,230,298,1,100,NaN,NaN
2323,75,19,53,72,1,100,NaN,NaN
2324,75,117,140,257,1,100,NaN,NaN
2325,75,95,129,224,1,100,NaN,NaN
2326,75,132,159,291,1,100,NaN,NaN
2327,75,63,85,148,1,100,NaN,NaN
2328,75,201,184,385,1,100,NaN,NaN
2329,75,107,134,241,1,100,NaN,NaN
2330,75,60,82,142,1,100,NaN,NaN
2331,75,121,298,419,1,100,NaN,NaN
2332,75,126,220,346,1,100,NaN,NaN
2333,75,16,43,59,1,100,NaN,NaN
2334,75,43,179,222,1,100,NaN,NaN
2335,75,12,102,114,1,100,NaN,NaN
2336,75,33,119,152,1,100,NaN,NaN
2337,75,115,409,524,1,100,NaN,NaN
2338,75,109,251,360,1,100,NaN,NaN
2339,75,98,300,398,1,100,NaN,NaN
2340,75,80,113,193,1,100,NaN,NaN
2341,75,78,116,194,1,100,NaN,NaN
2342,75,20,75,95,1,100,NaN,NaN
2343,75,73,178,251,1,100,NaN,NaN
2344,75,46,190,236,1,100,NaN,NaN
2345,75,22,28,50,1,100,NaN,NaN
2346,75,28,134,162,1,100,NaN,NaN
2347,75,144,265,409,1,100,NaN,NaN
2348,75,111,164,275,1,100,NaN,NaN
2349,75,71,107,178,1,100,NaN,NaN
2350,75,67,138,205,1,100,NaN,NaN
2351,75,176,235,411,1,100,NaN,NaN
2352,75,18,143,161,1,100,NaN,NaN
2353,75,36,136,172,1,100,NaN,NaN
2354,75,134,223,357,1,100,NaN,NaN
2355,75,16,199,215,1,100,NaN,NaN
2356,75,7,45,52,1,100,NaN,NaN
2357,75,71,211,282,1,100,NaN,NaN
2358,75,4,19,23,1,100,NaN,NaN
2359,75,170,333,503,1,100,NaN,NaN
2360,75,37,74,111,1,100,NaN,NaN
2361,75,68,197,265,1,100,NaN,NaN
2362,75,48,161,209,1,100,NaN,NaN
2363,75,73,206,279,1,100,NaN,NaN
2364,75,98,176,274,1,100,NaN,NaN
2365,75,53,110,163,1,100,NaN,NaN
2366,75,30,66,96,1,100,NaN,NaN
2367,75,62,107,169,1,100,NaN,NaN
2368,75,11,143,154,1,100,NaN,NaN
2369,75,103,137,240,1,100,NaN,NaN
2370,75,44,72,116,1,100,NaN,NaN
2371,75,54,77,131,1,100,NaN,NaN
2372,75,89,153,242,1,100,NaN,NaN
2373,75,38,96,134,1,100,NaN,NaN
2374,75,51,88,139,1,100,NaN,NaN
2375,75,72,85,157,1,100,NaN,NaN
2376,75,13,45,58,1,100,NaN,NaN
2377,75,20,81,101,1,100,NaN,NaN
2378,75,68,106,174,1,100,NaN,NaN
2379,75,66,92,158,1,100,NaN,NaN
2380,75,164,141,305,1,100,NaN,NaN
2381,75,107,86,193,1,100,NaN,NaN
2382,75,39,78,117,1,100,NaN,NaN
2383,75,165,244,409,1,100,NaN,NaN
2384,75,50,154,204,1,100,NaN,NaN
2385,75,37,73,110,1,100,NaN,NaN
2386,75,69,171,240,1,100,NaN,NaN
2387,75,24,32,56,1,100,NaN,NaN
2388,75,41,93,134,1,100,NaN,NaN
2389,75,37,156,193,1,100,NaN,NaN
2390,75,43,60,103,1,100,NaN,NaN
2391,75,42,127,169,1,100,NaN,NaN
2392,75,93,157,250,1,100,NaN,NaN
2393,75,78,203,281,1,100,NaN,NaN
2394,75,66,176,242,1,100,NaN,NaN
2395,75,55,78,133,1,100,NaN,NaN
2396,75,31,149,180,1,100,NaN,NaN
2397,75,33,31,64,1,100,NaN,NaN
2398,75,69,143,212,1,100,NaN,NaN
2399,75,32,41,73,1,100,NaN,NaN
2400,75,109,194,303,1,100,NaN,NaN
2401,75,95,182,277,1,100,NaN,NaN
2402,75,87,150,237,1,100,NaN,NaN
2403,75,170,253,423,1,100,NaN,NaN
2404,75,28,49,77,1,100,NaN,NaN
2405,75,33,34,67,1,100,NaN,NaN
2406,75,79,113,192,1,100,NaN,NaN
2407,75,12,40,52,1,100,NaN,NaN
2408,75,121,123,244,1,100,NaN,NaN
2409,75,136,150,286,1,100,NaN,NaN
2410,75,179,181,360,1,100,NaN,NaN
2411,75,88,236,324,1,100,NaN,NaN
2412,75,44,139,183,1,100,NaN,NaN
2413,75,45,81,126,1,100,NaN,NaN
2414,75,24,36,60,1,100,NaN,NaN
2415,75,13,22,35,1,100,NaN,NaN
2416,75,0,3,3,1,100,NaN,NaN
2417,75,55,176,231,1,100,NaN,NaN
2418,75,8,107,115,1,100,NaN,NaN
2419,75,45,100,145,1,100,NaN,NaN
2420,75,38,216,254,1,100,NaN,NaN
2421,75,40,137,177,1,100,NaN,NaN
2422,75,3,11,14,1,100,NaN,NaN
2423,75,190,190,380,1,100,NaN,NaN
2424,75,127,288,415,1,100,NaN,NaN
2425,75,86,185,271,1,100,NaN,NaN
2426,75,33,144,177,1,100,NaN,NaN
2427,75,42,293,335,1,100,NaN,NaN
2428,75,42,151,193,1,100,NaN,NaN
2429,75,39,133,172,1,100,NaN,NaN
2430,75,43,139,182,1,100,NaN,NaN
2431,75,45,67,112,1,100,NaN,NaN
2432,75,72,108,180,1,100,NaN,NaN
2433,75,135,120,255,1,100,NaN,NaN
2434,75,203,211,414,1,100,NaN,NaN
2435,75,132,155,287,1,100,NaN,NaN
2436,75,46,85,131,1,100,NaN,NaN
2437,75,27,134,161,1,100,NaN,NaN
2438,75,26,79,105,1,100,NaN,NaN
2439,75,165,216,381,1,100,NaN,NaN
2440,75,36,185,221,1,100,NaN,NaN
2441,75,49,99,148,1,100,NaN,NaN
2442,75,149,246,395,1,100,NaN,NaN
2443,75,23,75,98,1,100,NaN,NaN
2444,75,129,113,242,1,100,NaN,NaN
2445,75,163,217,380,1,100,NaN,NaN
2446,75,29,79,108,1,100,NaN,NaN
2447,75,129,77,206,1,100,NaN,NaN
2448,75,115,124,239,1,100,NaN,NaN
2449,75,102,92,194,1,100,NaN,NaN
2450,75,103,117,220,1,100,NaN,NaN
2451,75,55,91,146,1,100,NaN,NaN
2452,75,107,130,237,1,100,NaN,NaN
2453,75,173,169,342,1,100,NaN,NaN
2454,75,107,112,219,1,100,NaN,NaN
2455,75,51,69,120,1,100,NaN,NaN
2456,75,103,127,230,1,100,NaN,NaN
2457,75,26,14,40,1,100,NaN,NaN
2458,75,37,56,93,1,100,NaN,NaN
2459,75,75,53,128,1,100,NaN,NaN
2460,75,21,106,127,1,100,NaN,NaN
2461,75,139,83,222,1,100,NaN,NaN
2462,75,111,96,207,1,100,NaN,NaN
2463,75,155,185,340,1,100,NaN,NaN
2464,75,223,157,380,1,100,NaN,NaN
2465,75,69,81,150,1,100,NaN,NaN
2466,75,27,158,185,1,100,NaN,NaN
2467,75,97,122,219,1,100,NaN,NaN
2468,75,182,207,389,1,100,NaN,NaN
2469,75,107,139,246,1,100,NaN,NaN
2470,75,28,52,80,1,100,NaN,NaN
2471,75,52,107,159,1,100,NaN,NaN
2472,75,92,133,225,1,100,NaN,NaN
2473,75,24,67,91,1,100,NaN,NaN
2474,75,84,153,237,1,100,NaN,NaN
2475,75,72,198,270,1,100,NaN,NaN
2476,75,92,222,314,1,100,NaN,NaN
2477,75,98,237,335,1,100,NaN,NaN
2478,75,72,244,316,1,100,NaN,NaN
2479,75,10,74,84,1,100,NaN,NaN
2480,75,91,173,264,1,100,NaN,NaN
2481,75,110,173,283,1,100,NaN,NaN
2482,75,132,148,280,1,100,NaN,NaN
2483,75,63,98,161,1,100,NaN,NaN
2484,75,52,73,125,1,100,NaN,NaN
2485,75,14,130,144,1,100,NaN,NaN
2486,75,43,55,98,1,100,NaN,NaN
2487,75,26,49,75,1,100,NaN,NaN
2488,75,34,114,148,1,100,NaN,NaN
2489,75,66,120,186,1,100,NaN,NaN
2490,75,56,122,178,1,100,NaN,NaN
2491,75,44,114,158,1,100,NaN,NaN
2492,75,73,95,168,1,100,NaN,NaN
2493,75,44,41,85,1,100,NaN,NaN
2494,75,55,28,83,1,100,NaN,NaN
2495,75,48,54,102,1,100,NaN,NaN
2496,75,92,90,182,1,100,NaN,NaN
2497,75,93,119,212,1,100,NaN,NaN
2498,75,143,171,314,1,100,NaN,NaN
2499,75,31,66,97,1,100,NaN,NaN
2500,75,131,211,342,1,100,NaN,NaN
2501,75,7,36,43,1,100,NaN,NaN
2502,75,33,106,139,1,100,NaN,NaN
2503,75,99,206,305,1,100,NaN,NaN
2504,75,22,102,124,1,100,NaN,NaN
2505,75,31,115,146,1,100,NaN,NaN
2506,75,183,349,532,1,100,NaN,NaN
2507,75,56,74,130,1,100,NaN,NaN
2508,75,97,168,265,1,100,NaN,NaN
2509,75,95,422,517,1,100,NaN,NaN
2510,75,70,148,218,1,100,NaN,NaN
2511,75,227,188,415,1,100,NaN,NaN
2512,75,130,230,360,1,100,NaN,NaN
2513,75,45,79,124,1,100,NaN,NaN
2514,75,29,82,111,1,100,NaN,NaN
2515,75,32,91,123,1,100,NaN,NaN
2516,75,87,137,224,1,100,NaN,NaN
2517,75,177,227,404,1,100,NaN,NaN
2518,75,57,182,239,1,100,NaN,NaN
2519,75,57,90,147,1,100,NaN,NaN
2520,75,110,238,348,1,100,NaN,NaN
2521,75,30,159,189,1,100,NaN,NaN
2522,75,81,107,188,1,100,NaN,NaN
2523,75,44,87,131,1,100,NaN,NaN
2524,75,60,150,210,1,100,NaN,NaN
2525,75,27,87,114,1,100,NaN,NaN
2526,75,29,132,161,1,100,NaN,NaN
2527,75,106,209,315,1,100,NaN,NaN
2528,75,70,119,189,1,100,NaN,NaN
2529,75,74,136,210,1,100,NaN,NaN
2530,75,30,70,100,1,100,NaN,NaN
2531,75,34,69,103,1,100,NaN,NaN
2532,75,66,79,145,1,100,NaN,NaN
2533,75,68,159,227,1,100,NaN,NaN
2534,75,37,150,187,1,100,NaN,NaN
2535,75,74,128,202,1,100,NaN,NaN
2536,75,68,158,226,1,100,NaN,NaN
2537,75,144,158,302,1,100,NaN,NaN
2538,75,87,113,200,1,100,NaN,NaN
2539,75,172,230,402,1,100,NaN,NaN
2540,75,61,123,184,1,100,NaN,NaN
2541,75,140,291,431,1,100,NaN,NaN
2542,75,30,54,84,1,100,NaN,NaN
2543,75,84,147,231,1,100,NaN,NaN
2544,75,15,193,208,1,100,NaN,NaN
2545,75,79,136,215,1,100,NaN,NaN
2546,75,26,46,72,1,100,NaN,NaN
2547,75,148,155,303,1,100,NaN,NaN
2548,75,84,70,154,1,100,NaN,NaN
2549,75,23,54,77,1,100,NaN,NaN
2550,75,14,24,38,1,100,NaN,NaN
2551,90,100,214,314,1,100,5000,75
2552,90,147,151,298,1,100,5000,75
2553,90,152,207,359,1,100,5000,75
2554,90,117,211,328,1,100,5000,75
2555,90,55,177,232,1,100,5000,75
2556,90,106,234,340,1,100,5000,75
2557,90,60,212,272,1,100,5000,75
2558,90,64,236,300,1,100,5000,75
2559,90,77,205,282,1,100,5000,75
2560,90,14,65,79,1,100,5000,75
2561,90,103,170,273,1,100,5000,75
2562,90,56,166,222,1,100,5000,75
2563,90,138,293,431,1,100,5000,75
2564,90,61,151,212,1,100,5000,75
2565,90,76,226,302,1,100,5000,75
2566,90,31,221,252,1,100,5000,75
2567,90,42,136,178,1,100,5000,75
2568,90,42,94,136,1,100,5000,75
2569,90,18,114,132,1,100,5000,75
2570,90,79,182,261,1,100,5000,75
2571,90,24,284,308,1,100,5000,75
2572,90,49,263,312,1,100,5000,75
2573,90,56,181,237,1,100,5000,75
2574,90,16,145,161,1,100,5000,75
2575,90,43,124,167,1,100,5000,75
2576,90,55,151,206,1,100,5000,75
2577,90,61,200,261,1,100,5000,75
2578,90,107,279,386,1,100,5000,75
2579,90,97,358,455,1,100,5000,75
2580,90,66,121,187,1,100,5000,75
2581,90,140,259,399,1,100,5000,75
2582,90,60,148,208,1,100,5000,75
2583,90,110,218,328,1,100,5000,75
2584,90,84,219,303,1,100,5000,75
2585,90,33,61,94,1,100,5000,75
2586,90,31,40,71,1,100,5000,75
2587,90,95,102,197,1,100,5000,75
2588,90,98,368,466,1,100,5000,75
2589,90,57,221,278,1,100,5000,75
2590,90,94,317,411,1,100,5000,75
2591,90,59,163,222,1,100,5000,75
2592,90,48,223,271,1,100,5000,75
2593,90,32,147,179,1,100,5000,75
2594,90,53,164,217,1,100,5000,75
2595,90,14,190,204,1,100,5000,75
2596,90,60,521,581,1,100,5000,75
2597,90,10,71,81,1,100,5000,75
2598,90,60,40,100,1,100,5000,75
2599,90,70,152,222,1,100,5000,75
2600,90,103,232,335,1,100,5000,75
2601,90,53,178,231,1,100,5000,75
2602,90,80,370,450,1,100,5000,75
2603,90,105,202,307,1,100,5000,75
2604,90,29,228,257,1,100,5000,75
2605,90,80,204,284,1,100,5000,75
2606,90,23,177,200,1,100,5000,75
2607,90,78,147,225,1,100,5000,75
2608,90,100,177,277,1,100,5000,75
2609,90,42,208,250,1,100,5000,75
2610,90,52,111,163,1,100,5000,75
2611,90,62,110,172,1,100,5000,75
2612,90,6,86,92,1,100,5000,75
2613,90,62,156,218,1,100,5000,75
2614,90,135,298,433,1,100,5000,75
2615,90,28,37,65,1,100,5000,75
2616,90,55,142,197,1,100,5000,75
2617,90,203,282,485,1,100,5000,75
2618,90,106,161,267,1,100,5000,75
2619,90,262,358,620,1,100,5000,75
2620,90,37,88,125,1,100,5000,75
2621,90,95,190,285,1,100,5000,75
2622,90,186,252,438,1,100,5000,75
2623,90,74,92,166,1,100,5000,75
2624,90,43,85,128,1,100,5000,75
2625,90,25,53,78,1,100,5000,75
2626,90,110,111,221,1,100,5000,75
2627,90,111,187,298,1,100,5000,75
2628,90,70,107,177,1,100,5000,75
2629,90,39,109,148,1,100,5000,75
2630,90,94,182,276,1,100,5000,75
2631,90,55,140,195,1,100,5000,75
2632,90,125,192,317,1,100,5000,75
2633,90,38,83,121,1,100,5000,75
2634,90,68,130,198,1,100,5000,75
2635,90,62,111,173,1,100,5000,75
2636,90,125,194,319,1,100,5000,75
2637,90,32,107,139,1,100,5000,75
2638,90,33,74,107,1,100,5000,75
2639,90,85,194,279,1,100,5000,75
2640,90,68,202,270,1,100,5000,75
2641,90,56,58,114,1,100,5000,75
2642,90,25,60,85,1,100,5000,75
2643,90,63,106,169,1,100,5000,75
2644,90,179,330,509,1,100,5000,75
2645,90,116,219,335,1,100,5000,75
2646,90,104,172,276,1,100,5000,75
2647,90,139,147,286,1,100,5000,75
2648,90,79,119,198,1,100,5000,75
2649,90,143,199,342,1,100,5000,75
2650,90,93,148,241,1,100,5000,75
2651,90,120,82,202,1,100,5000,75
2652,90,48,51,99,1,100,5000,75
2653,90,195,295,490,1,100,5000,75
2654,90,24,31,55,1,100,5000,75
2655,90,80,230,310,1,100,5000,75
2656,90,92,120,212,1,100,5000,75
2657,90,115,296,411,1,100,5000,75
2658,90,34,61,95,1,100,5000,75
2659,90,37,41,78,1,100,5000,75
2660,90,27,91,118,1,100,5000,75
2661,90,15,172,187,1,100,5000,75
2662,90,267,427,694,1,100,5000,75
2663,90,161,138,299,1,100,5000,75
2664,90,77,162,239,1,100,5000,75
2665,90,85,176,261,1,100,5000,75
2666,90,95,277,372,1,100,5000,75
2667,90,21,72,93,1,100,5000,75
2668,90,121,250,371,1,100,5000,75
2669,90,68,75,143,1,100,5000,75
2670,90,67,185,252,1,100,5000,75
2671,90,111,161,272,1,100,5000,75
2672,90,105,224,329,1,100,5000,75
2673,90,25,26,51,1,100,5000,75
2674,90,38,129,167,1,100,5000,75
2675,90,92,116,208,1,100,5000,75
2676,90,37,47,84,1,100,5000,75
2677,90,66,133,199,1,100,5000,75
2678,90,237,295,532,1,100,5000,75
2679,90,111,202,313,1,100,5000,75
2680,90,127,222,349,1,100,5000,75
2681,90,180,135,315,1,100,5000,75
2682,90,94,126,220,1,100,5000,75
2683,90,20,24,44,1,100,5000,75
2684,90,68,237,305,1,100,5000,75
2685,90,117,180,297,1,100,5000,75
2686,90,73,33,106,1,100,5000,75
2687,90,18,68,86,1,100,5000,75
2688,90,8,34,42,1,100,5000,75
2689,90,23,53,76,1,100,5000,75
2690,90,119,125,244,1,100,5000,75
2691,90,83,108,191,1,100,5000,75
2692,90,61,107,168,1,100,5000,75
2693,90,58,96,154,1,100,5000,75
2694,90,118,165,283,1,100,5000,75
2695,90,165,413,578,1,100,5000,75
2696,90,76,171,247,1,100,5000,75
2697,90,97,219,316,1,100,5000,75
2698,90,73,175,248,1,100,5000,75
2699,90,75,164,239,1,100,5000,75
2700,90,13,172,185,1,100,5000,75
2701,90,75,129,204,1,100,5000,75
2702,90,91,121,212,1,100,5000,75
2703,90,157,344,501,1,100,5000,75
2704,90,89,212,301,1,100,5000,75
2705,90,30,135,165,1,100,5000,75
2706,90,106,284,390,1,100,5000,75
2707,90,71,229,300,1,100,5000,75
2708,90,116,263,379,1,100,5000,75
2709,90,76,175,251,1,100,5000,75
2710,90,41,130,171,1,100,5000,75
2711,90,77,190,267,1,100,5000,75
2712,90,79,161,240,1,100,5000,75
2713,90,70,143,213,1,100,5000,75
2714,90,88,145,233,1,100,5000,75
2715,90,49,203,252,1,100,5000,75
2716,90,63,215,278,1,100,5000,75
2717,90,11,13,24,1,100,5000,75
2718,90,70,95,165,1,100,5000,75
2719,90,161,281,442,1,100,5000,75
2720,90,65,75,140,1,100,5000,75
2721,90,127,136,263,1,100,5000,75
2722,90,155,253,408,1,100,5000,75
2723,90,126,252,378,1,100,5000,75
2724,90,137,248,385,1,100,5000,75
2725,90,122,194,316,1,100,5000,75
2726,90,128,212,340,1,100,5000,75
2727,90,92,103,195,1,100,5000,75
2728,90,38,130,168,1,100,5000,75
2729,90,31,28,59,1,100,5000,75
2730,90,16,53,69,1,100,5000,75
2731,90,154,402,556,1,100,5000,75
2732,90,82,173,255,1,100,5000,75
2733,90,101,232,333,1,100,5000,75
2734,90,29,235,264,1,100,5000,75
2735,90,49,377,426,1,100,5000,75
2736,90,32,146,178,1,100,5000,75
2737,90,42,132,174,1,100,5000,75
2738,90,122,180,302,1,100,5000,75
2739,90,57,105,162,1,100,5000,75
2740,90,50,154,204,1,100,5000,75
2741,90,51,111,162,1,100,5000,75
2742,90,62,181,243,1,100,5000,75
2743,90,54,150,204,1,100,5000,75
2744,90,63,127,190,1,100,5000,75
2745,90,90,182,272,1,100,5000,75
2746,90,45,148,193,1,100,5000,75
2747,90,33,106,139,1,100,5000,75
2748,90,16,54,70,1,100,5000,75
2749,90,56,117,173,1,100,5000,75
2750,90,82,141,223,1,100,5000,75
2751,90,132,182,314,1,100,5000,75
2752,90,157,203,360,1,100,5000,75
2753,90,111,143,254,1,100,5000,75
2754,90,57,177,234,1,100,5000,75
2755,90,32,166,198,1,100,5000,75
2756,90,64,152,216,1,100,5000,75
2757,90,66,104,170,1,100,5000,75
2758,90,22,152,174,1,100,5000,75
2759,90,52,100,152,1,100,5000,75
2760,90,84,201,285,1,100,5000,75
2761,90,12,166,178,1,100,5000,75
2762,90,41,167,208,1,100,5000,75
2763,90,28,156,184,1,100,5000,75
2764,90,41,174,215,1,100,5000,75
2765,90,99,239,338,1,100,5000,75
2766,90,57,137,194,1,100,5000,75
2767,90,70,259,329,1,100,5000,75
2768,90,139,281,420,1,100,5000,75
2769,90,85,186,271,1,100,5000,75
2770,90,115,272,387,1,100,5000,75
2771,90,50,164,214,1,100,5000,75
2772,90,20,128,148,1,100,5000,75
2773,90,138,149,287,1,100,5000,75
2774,90,97,303,400,1,100,5000,75
2775,90,35,424,459,1,100,5000,75
2776,90,102,204,306,1,100,5000,75
2777,90,107,108,215,1,100,5000,75
2778,90,35,165,200,1,100,5000,75
2779,90,102,197,299,1,100,5000,75
2780,90,89,176,265,1,100,5000,75
2781,90,33,342,375,1,100,5000,75
2782,90,94,173,267,1,100,5000,75
2783,90,52,242,294,1,100,5000,75
2784,90,197,388,585,1,100,5000,75
2785,90,160,396,556,1,100,5000,75
2786,90,32,245,277,1,100,5000,75
2787,90,18,240,258,1,100,5000,75
2788,90,57,583,640,1,100,5000,75
2789,90,196,260,456,1,100,5000,75
2790,90,65,257,322,1,100,5000,75
2791,90,51,121,172,1,100,5000,75
2792,90,66,77,143,1,100,5000,75
2793,90,185,358,543,1,100,5000,75
2794,90,70,128,198,1,100,5000,75
2795,90,54,189,243,1,100,5000,75
2796,90,148,252,400,1,100,5000,75
2797,90,52,145,197,1,100,5000,75
2798,90,55,279,334,1,100,5000,75
2799,90,39,226,265,1,100,5000,75
2800,90,145,257,402,1,100,5000,75
2801,90,48,100,148,1,100,5000,75
2802,90,210,258,468,1,100,5000,75
2803,90,96,127,223,1,100,5000,75
2804,90,23,98,121,1,100,5000,75
2805,90,41,103,144,1,100,5000,75
2806,90,280,333,613,1,100,5000,75
2807,90,50,170,220,1,100,5000,75
2808,90,54,84,138,1,100,5000,75
2809,90,55,85,140,1,100,5000,75
2810,90,66,89,155,1,100,5000,75
2811,90,73,124,197,1,100,5000,75
2812,90,51,117,168,1,100,5000,75
2813,90,40,144,184,1,100,5000,75
2814,90,96,362,458,1,100,5000,75
2815,90,49,130,179,1,100,5000,75
2816,90,63,53,116,1,100,5000,75
2817,90,55,159,214,1,100,5000,75
2818,90,178,326,504,1,100,5000,75
2819,90,66,82,148,1,100,5000,75
2820,90,99,138,237,1,100,5000,75
2821,90,172,293,465,1,100,5000,75
2822,90,21,85,106,1,100,5000,75
2823,90,48,160,208,1,100,5000,75
2824,90,44,132,176,1,100,5000,75
2825,90,40,109,149,1,100,5000,75
2826,90,25,76,101,1,100,5000,75
2827,90,118,272,390,1,100,5000,75
2828,90,38,141,179,1,100,5000,75
2829,90,33,266,299,1,100,5000,75
2830,90,30,64,94,1,100,5000,75
2831,90,36,56,92,1,100,5000,75
2832,90,137,400,537,1,100,5000,75
2833,90,94,337,431,1,100,5000,75
2834,90,88,437,525,1,100,5000,75
2835,90,12,85,97,1,100,5000,75
2836,90,33,102,135,1,100,5000,75
2837,90,31,248,279,1,100,5000,75
2838,90,22,103,125,1,100,5000,75
2839,90,60,86,146,1,100,5000,75
2840,90,187,310,497,1,100,5000,75
2841,90,67,186,253,1,100,5000,75
2842,90,101,72,173,1,100,5000,75
2843,90,24,50,74,1,100,5000,75
2844,90,102,261,363,1,100,5000,75
2845,90,103,207,310,1,100,5000,75
2846,90,65,135,200,1,100,5000,75
2847,90,80,181,261,1,100,5000,75
2848,90,42,142,184,1,100,5000,75
2849,90,40,182,222,1,100,5000,75
2850,90,30,81,111,1,100,5000,75
2851,90,38,69,107,1,100,5000,75
2852,105,22,20,42,1,100,5000,75
2853,105,23,44,67,1,100,5000,75
2854,105,46,195,241,1,100,5000,75
2855,105,31,103,134,1,100,5000,75
2856,105,56,203,259,1,100,5000,75
2857,105,25,156,181,1,100,5000,75
2858,105,54,207,261,1,100,5000,75
2859,105,21,183,204,1,100,5000,75
2860,105,38,195,233,1,100,5000,75
2861,105,17,59,76,1,100,5000,75
2862,105,31,101,132,1,100,5000,75
2863,105,41,116,157,1,100,5000,75
2864,105,80,286,366,1,100,5000,75
2865,105,11,128,139,1,100,5000,75
2866,105,64,184,248,1,100,5000,75
2867,105,67,176,243,1,100,5000,75
2868,105,40,75,115,1,100,5000,75
2869,105,48,159,207,1,100,5000,75
2870,105,115,285,400,1,100,5000,75
2871,105,10,11,21,1,100,5000,75
2872,105,29,62,91,1,100,5000,75
2873,105,52,102,154,1,100,5000,75
2874,105,17,43,60,1,100,5000,75
2875,105,37,39,76,1,100,5000,75
2876,105,37,130,167,1,100,5000,75
2877,105,104,163,267,1,100,5000,75
2878,105,44,73,117,1,100,5000,75
2879,105,19,81,100,1,100,5000,75
2880,105,43,144,187,1,100,5000,75
2881,105,37,128,165,1,100,5000,75
2882,105,19,66,85,1,100,5000,75
2883,105,15,40,55,1,100,5000,75
2884,105,24,48,72,1,100,5000,75
2885,105,71,49,120,1,100,5000,75
2886,105,86,287,373,1,100,5000,75
2887,105,47,66,113,1,100,5000,75
2888,105,51,166,217,1,100,5000,75
2889,105,59,112,171,1,100,5000,75
2890,105,76,151,227,1,100,5000,75
2891,105,52,164,216,1,100,5000,75
2892,105,48,107,155,1,100,5000,75
2893,105,37,140,177,1,100,5000,75
2894,105,53,50,103,1,100,5000,75
2895,105,48,36,84,1,100,5000,75
2896,105,16,60,76,1,100,5000,75
2897,105,12,36,48,1,100,5000,75
2898,105,12,105,117,1,100,5000,75
2899,105,44,57,101,1,100,5000,75
2900,105,10,60,70,1,100,5000,75
2901,105,16,112,128,1,100,5000,75
2902,105,67,91,158,1,100,5000,75
2903,105,103,186,289,1,100,5000,75
2904,105,50,98,148,1,100,5000,75
2905,105,66,162,228,1,100,5000,75
2906,105,42,95,137,1,100,5000,75
2907,105,62,88,150,1,100,5000,75
2908,105,16,98,114,1,100,5000,75
2909,105,41,107,148,1,100,5000,75
2910,105,16,144,160,1,100,5000,75
2911,105,27,213,240,1,100,5000,75
2912,105,29,113,142,1,100,5000,75
2913,105,31,115,146,1,100,5000,75
2914,105,13,88,101,1,100,5000,75
2915,105,45,68,113,1,100,5000,75
2916,105,42,117,159,1,100,5000,75
2917,105,41,119,160,1,100,5000,75
2918,105,20,27,47,1,100,5000,75
2919,105,28,132,160,1,100,5000,75
2920,105,27,133,160,1,100,5000,75
2921,105,8,136,144,1,100,5000,75
2922,105,12,52,64,1,100,5000,75
2923,105,70,174,244,1,100,5000,75
2924,105,45,150,195,1,100,5000,75
2925,105,83,135,218,1,100,5000,75
2926,105,84,215,299,1,100,5000,75
2927,105,42,130,172,1,100,5000,75
2928,105,55,64,119,1,100,5000,75
2929,105,86,190,276,1,100,5000,75
2930,105,36,178,214,1,100,5000,75
2931,105,55,196,251,1,100,5000,75
2932,105,78,292,370,1,100,5000,75
2933,105,26,74,100,1,100,5000,75
2934,105,52,185,237,1,100,5000,75
2935,105,5,94,99,1,100,5000,75
2936,105,31,150,181,1,100,5000,75
2937,105,52,236,288,1,100,5000,75
2938,105,46,205,251,1,100,5000,75
2939,105,88,265,353,1,100,5000,75
2940,105,23,135,158,1,100,5000,75
2941,105,50,130,180,1,100,5000,75
2942,105,34,58,92,1,100,5000,75
2943,105,27,108,135,1,100,5000,75
2944,105,106,164,270,1,100,5000,75
2945,105,119,72,191,1,100,5000,75
2946,105,53,170,223,1,100,5000,75
2947,105,98,111,209,1,100,5000,75
2948,105,75,101,176,1,100,5000,75
2949,105,134,337,471,1,100,5000,75
2950,105,52,173,225,1,100,5000,75
2951,105,114,307,421,1,100,5000,75
2952,105,32,170,202,1,100,5000,75
2953,105,26,131,157,1,100,5000,75
2954,105,53,105,158,1,100,5000,75
2955,105,62,103,165,1,100,5000,75
2956,105,83,206,289,1,100,5000,75
2957,105,36,70,106,1,100,5000,75
2958,105,88,214,302,1,100,5000,75
2959,105,42,108,150,1,100,5000,75
2960,105,42,175,217,1,100,5000,75
2961,105,40,105,145,1,100,5000,75
2962,105,6,33,39,1,100,5000,75
2963,105,45,94,139,1,100,5000,75
2964,105,77,84,161,1,100,5000,75
2965,105,116,169,285,1,100,5000,75
2966,105,89,88,177,1,100,5000,75
2967,105,40,83,123,1,100,5000,75
2968,105,39,90,129,1,100,5000,75
2969,105,34,51,85,1,100,5000,75
2970,105,31,105,136,1,100,5000,75
2971,105,39,59,98,1,100,5000,75
2972,105,68,194,262,1,100,5000,75
2973,105,43,120,163,1,100,5000,75
2974,105,42,148,190,1,100,5000,75
2975,105,11,88,99,1,100,5000,75
2976,105,31,47,78,1,100,5000,75
2977,105,27,128,155,1,100,5000,75
2978,105,0,36,36,1,100,5000,75
2979,105,8,70,78,1,100,5000,75
2980,105,23,91,114,1,100,5000,75
2981,105,50,172,222,1,100,5000,75
2982,105,19,234,253,1,100,5000,75
2983,105,34,199,233,1,100,5000,75
2984,105,29,137,166,1,100,5000,75
2985,105,44,103,147,1,100,5000,75
2986,105,18,100,118,1,100,5000,75
2987,105,23,98,121,1,100,5000,75
2988,105,23,179,202,1,100,5000,75
2989,105,45,133,178,1,100,5000,75
2990,105,8,56,64,1,100,5000,75
2991,105,51,159,210,1,100,5000,75
2992,105,27,116,143,1,100,5000,75
2993,105,25,160,185,1,100,5000,75
2994,105,50,185,235,1,100,5000,75
2995,105,39,184,223,1,100,5000,75
2996,105,33,246,279,1,100,5000,75
2997,105,35,86,121,1,100,5000,75
2998,105,20,78,98,1,100,5000,75
2999,105,37,153,190,1,100,5000,75
3000,105,31,108,139,1,100,5000,75
3001,105,35,202,237,1,100,5000,75
3002,105,80,255,335,1,100,5000,75
3003,105,54,148,202,1,100,5000,75
3004,105,28,143,171,1,100,5000,75
3005,105,48,217,265,1,100,5000,75
3006,105,17,81,98,1,100,5000,75
3007,105,76,241,317,1,100,5000,75
3008,105,17,89,106,1,100,5000,75
3009,105,54,49,103,1,100,5000,75
3010,105,47,166,213,1,100,5000,75
3011,105,27,112,139,1,100,5000,75
3012,105,17,123,140,1,100,5000,75
3013,105,51,197,248,1,100,5000,75
3014,105,51,142,193,1,100,5000,75
3015,105,42,173,215,1,100,5000,75
3016,105,49,169,218,1,100,5000,75
3017,105,41,84,125,1,100,5000,75
3018,105,63,186,249,1,100,5000,75
3019,105,20,166,186,1,100,5000,75
3020,105,84,186,270,1,100,5000,75
3021,105,37,57,94,1,100,5000,75
3022,105,42,205,247,1,100,5000,75
3023,105,34,146,180,1,100,5000,75
3024,105,31,152,183,1,100,5000,75
3025,105,27,112,139,1,100,5000,75
3026,105,15,153,168,1,100,5000,75
3027,105,44,261,305,1,100,5000,75
3028,105,33,62,95,1,100,5000,75
3029,105,67,274,341,1,100,5000,75
3030,105,66,309,375,1,100,5000,75
3031,105,110,275,385,1,100,5000,75
3032,105,28,223,251,1,100,5000,75
3033,105,115,309,424,1,100,5000,75
3034,105,32,103,135,1,100,5000,75
3035,105,13,31,44,1,100,5000,75
3036,105,151,217,368,1,100,5000,75
3037,105,94,239,333,1,100,5000,75
3038,105,52,144,196,1,100,5000,75
3039,105,49,63,112,1,100,5000,75
3040,105,27,54,81,1,100,5000,75
3041,105,77,170,247,1,100,5000,75
3042,105,46,98,144,1,100,5000,75
3043,105,77,184,261,1,100,5000,75
3044,105,138,226,364,1,100,5000,75
3045,105,48,156,204,1,100,5000,75
3046,105,128,239,367,1,100,5000,75
3047,105,21,41,62,1,100,5000,75
3048,105,84,156,240,1,100,5000,75
3049,105,67,58,125,1,100,5000,75
3050,105,140,244,384,1,100,5000,75
3051,105,25,101,126,1,100,5000,75
3052,105,48,116,164,1,100,5000,75
3053,105,9,49,58,1,100,5000,75
3054,105,43,234,277,1,100,5000,75
3055,105,26,269,295,1,100,5000,75
3056,105,92,185,277,1,100,5000,75
3057,105,83,223,306,1,100,5000,75
3058,105,46,262,308,1,100,5000,75
3059,105,47,181,228,1,100,5000,75
3060,105,53,103,156,1,100,5000,75
3061,105,16,161,177,1,100,5000,75
3062,105,58,183,241,1,100,5000,75
3063,105,94,223,317,1,100,5000,75
3064,105,30,178,208,1,100,5000,75
3065,105,139,315,454,1,100,5000,75
3066,105,95,233,328,1,100,5000,75
3067,105,70,289,359,1,100,5000,75
3068,105,62,24,86,1,100,5000,75
3069,105,64,164,228,1,100,5000,75
3070,105,58,205,263,1,100,5000,75
3071,105,55,167,222,1,100,5000,75
3072,105,136,269,405,1,100,5000,75
3073,105,108,274,382,1,100,5000,75
3074,105,56,153,209,1,100,5000,75
3075,105,83,160,243,1,100,5000,75
3076,105,39,224,263,1,100,5000,75
3077,105,14,281,295,1,100,5000,75
3078,105,21,167,188,1,100,5000,75
3079,105,68,38,106,1,100,5000,75
3080,105,173,434,607,1,100,5000,75
3081,105,63,123,186,1,100,5000,75
3082,105,68,146,214,1,100,5000,75
3083,105,148,198,346,1,100,5000,75
3084,105,133,284,417,1,100,5000,75
3085,105,129,84,213,1,100,5000,75
3086,105,95,215,310,1,100,5000,75
3087,105,27,87,114,1,100,5000,75
3088,105,77,230,307,1,100,5000,75
3089,105,94,199,293,1,100,5000,75
3090,105,95,98,193,1,100,5000,75
3091,105,63,164,227,1,100,5000,75
3092,105,16,49,65,1,100,5000,75
3093,105,49,45,94,1,100,5000,75
3094,105,26,88,114,1,100,5000,75
3095,105,14,54,68,1,100,5000,75
3096,105,109,321,430,1,100,5000,75
3097,105,50,189,239,1,100,5000,75
3098,105,56,322,378,1,100,5000,75
3099,105,32,115,147,1,100,5000,75
3100,105,199,560,759,1,100,5000,75
3101,105,78,308,386,1,100,5000,75
3102,105,15,39,54,1,100,5000,75
3103,105,43,123,166,1,100,5000,75
3104,105,47,166,213,1,100,5000,75
3105,105,176,521,697,1,100,5000,75
3106,105,63,214,277,1,100,5000,75
3107,105,134,331,465,1,100,5000,75
3108,105,82,187,269,1,100,5000,75
3109,105,93,289,382,1,100,5000,75
3110,105,150,260,410,1,100,5000,75
3111,105,102,243,345,1,100,5000,75
3112,105,15,38,53,1,100,5000,75
3113,105,70,193,263,1,100,5000,75
3114,105,36,152,188,1,100,5000,75
3115,105,38,125,163,1,100,5000,75
3116,105,105,269,374,1,100,5000,75
3117,105,62,237,299,1,100,5000,75
3118,105,110,309,419,1,100,5000,75
3119,105,45,110,155,1,100,5000,75
3120,105,83,96,179,1,100,5000,75
3121,105,69,75,144,1,100,5000,75
3122,105,31,126,157,1,100,5000,75
3123,105,13,22,35,1,100,5000,75
3124,105,30,267,297,1,100,5000,75
3125,105,38,59,97,1,100,5000,75
3126,105,48,129,177,1,100,5000,75
3127,105,20,129,149,1,100,5000,75
3128,105,53,84,137,1,100,5000,75
3129,105,109,322,431,1,100,5000,75
3130,105,73,192,265,1,100,5000,75
3131,105,171,199,370,1,100,5000,75
3132,105,122,215,337,1,100,5000,75
3133,105,172,237,409,1,100,5000,75
3134,105,34,116,150,1,100,5000,75
3135,105,31,119,150,1,100,5000,75
3136,105,40,119,159,1,100,5000,75
3137,105,21,252,273,1,100,5000,75
3138,105,33,50,83,1,100,5000,75
3139,105,51,202,253,1,100,5000,75
3140,105,133,265,398,1,100,5000,75
3141,105,130,373,503,1,100,5000,75
3142,105,70,292,362,1,100,5000,75
3143,105,37,181,218,1,100,5000,75
3144,105,20,128,148,1,100,5000,75
3145,105,190,278,468,1,100,5000,75
3146,105,81,149,230,1,100,5000,75
3147,105,16,67,83,1,100,5000,75
3148,105,40,43,83,1,100,5000,75
3149,105,147,292,439,1,100,5000,75
3150,105,49,167,216,1,100,5000,75
3151,105,158,399,557,1,100,5000,75
3152,105,69,142,211,1,100,5000,75
3153,105,68,161,229,1,100,5000,75
3154,105,55,146,201,1,100,5000,75
3155,105,86,184,270,1,100,5000,75
3156,105,48,165,213,1,100,5000,75
3157,105,49,91,140,1,100,5000,75
3158,105,56,126,182,1,100,5000,75
3159,105,24,78,102,1,100,5000,75
3160,105,28,33,61,1,100,5000,75
3161,105,6,32,38,1,100,5000,75
3162,105,2,6,8,1,100,5000,75
3163,105,67,216,283,1,100,5000,75
3164,105,114,217,331,1,100,5000,75
3165,105,166,418,584,1,100,5000,75
3166,105,44,142,186,1,100,5000,75
3167,105,69,164,233,1,100,5000,75
3168,105,31,70,101,1,100,5000,75
3169,105,49,164,213,1,100,5000,75
3170,105,88,335,423,1,100,5000,75
3171,105,45,121,166,1,100,5000,75
3172,105,49,130,179,1,100,5000,75
3173,105,54,74,128,1,100,5000,75
3174,105,9,9,18,1,100,5000,75
3175,135,23,64,87,1,100,5000,75
3176,135,12,48,60,1,100,5000,75
3177,135,38,94,132,1,100,5000,75
3178,135,4,6,10,1,100,5000,75
3179,135,9,83,92,1,100,5000,75
3180,135,53,82,135,1,100,5000,75
3181,135,24,151,175,1,100,5000,75
3182,135,8,17,25,1,100,5000,75
3183,135,33,127,160,1,100,5000,75
3184,135,7,52,59,1,100,5000,75
3185,135,15,24,39,1,100,5000,75
3186,135,27,93,120,1,100,5000,75
3187,135,9,32,41,1,100,5000,75
3188,135,6,21,27,1,100,5000,75
3189,135,7,68,75,1,100,5000,75
3190,135,6,28,34,1,100,5000,75
3191,135,21,82,103,1,100,5000,75
3192,135,39,123,162,1,100,5000,75
3193,135,22,38,60,1,100,5000,75
3194,135,16,50,66,1,100,5000,75
3195,135,12,114,126,1,100,5000,75
3196,135,1,28,29,1,100,5000,75
3197,135,17,56,73,1,100,5000,75
3198,135,44,55,99,1,100,5000,75
3199,135,33,82,115,1,100,5000,75
3200,135,27,67,94,1,100,5000,75
3201,135,5,20,25,1,100,5000,75
3202,135,13,31,44,1,100,5000,75
3203,135,2,58,60,1,100,5000,75
3204,135,56,204,260,1,100,5000,75
3205,135,28,64,92,1,100,5000,75
3206,135,41,178,219,1,100,5000,75
3207,135,18,91,109,1,100,5000,75
3208,135,9,56,65,1,100,5000,75
3209,135,9,74,83,1,100,5000,75
3210,135,8,26,34,1,100,5000,75
3211,135,21,37,58,1,100,5000,75
3212,135,11,17,28,1,100,5000,75
3213,135,28,95,123,1,100,5000,75
3214,135,32,109,141,1,100,5000,75
3215,135,26,42,68,1,100,5000,75
3216,135,12,50,62,1,100,5000,75
3217,135,9,37,46,1,100,5000,75
3218,135,24,74,98,1,100,5000,75
3219,135,16,39,55,1,100,5000,75
3220,135,11,62,73,1,100,5000,75
3221,135,6,9,15,1,100,5000,75
3222,135,31,26,57,1,100,5000,75
3223,135,14,66,80,1,100,5000,75
3224,135,7,28,35,1,100,5000,75
3225,135,21,31,52,1,100,5000,75
3226,135,16,43,59,1,100,5000,75
3227,135,23,48,71,1,100,5000,75
3228,135,1,12,13,1,100,5000,75
3229,135,43,160,203,1,100,5000,75
3230,135,9,40,49,1,100,5000,75
3231,135,20,18,38,1,100,5000,75
3232,135,17,39,56,1,100,5000,75
3233,135,34,103,137,1,100,5000,75
3234,135,15,15,30,1,100,5000,75
3235,135,8,29,37,1,100,5000,75
3236,135,16,75,91,1,100,5000,75
3237,135,13,122,135,1,100,5000,75
3238,135,32,48,80,1,100,5000,75
3239,135,5,31,36,1,100,5000,75
3240,135,7,20,27,1,100,5000,75
3241,135,23,44,67,1,100,5000,75
3242,135,11,19,30,1,100,5000,75
3243,135,30,71,101,1,100,5000,75
3244,135,10,21,31,1,100,5000,75
3245,135,25,58,83,1,100,5000,75
3246,135,4,23,27,1,100,5000,75
3247,135,18,29,47,1,100,5000,75
3248,135,4,16,20,1,100,5000,75
3249,135,13,28,41,1,100,5000,75
3250,135,3,19,22,1,100,5000,75
3251,135,24,35,59,1,100,5000,75
3252,135,21,80,101,1,100,5000,75
3253,135,17,86,103,1,100,5000,75
3254,135,9,49,58,1,100,5000,75
3255,135,0,16,16,1,100,5000,75
3256,135,29,36,65,1,100,5000,75
3257,135,75,168,243,1,100,5000,75
3258,135,46,63,109,1,100,5000,75
3259,135,17,71,88,1,100,5000,75
3260,135,16,56,72,1,100,5000,75
3261,135,11,37,48,1,100,5000,75
3262,135,21,73,94,1,100,5000,75
3263,135,10,79,89,1,100,5000,75
3264,135,38,183,221,1,100,5000,75
3265,135,20,127,147,1,100,5000,75
3266,135,50,168,218,1,100,5000,75
3267,135,30,71,101,1,100,5000,75
3268,135,10,73,83,1,100,5000,75
3269,135,15,68,83,1,100,5000,75
3270,135,27,177,204,1,100,5000,75
3271,135,16,33,49,1,100,5000,75
3272,135,6,58,64,1,100,5000,75
3273,135,5,58,63,1,100,5000,75
3274,135,13,48,61,1,100,5000,75
3275,135,5,38,43,1,100,5000,75
3276,135,6,40,46,1,100,5000,75
3277,135,20,57,77,1,100,5000,75
3278,135,14,44,58,1,100,5000,75
3279,135,13,71,84,1,100,5000,75
3280,135,155,232,387,1,100,5000,75
3281,135,4,36,40,1,100,5000,75
3282,135,13,51,64,1,100,5000,75
3283,135,7,15,22,1,100,5000,75
3284,135,9,44,53,1,100,5000,75
3285,135,28,69,97,1,100,5000,75
3286,135,12,71,83,1,100,5000,75
3287,135,13,90,103,1,100,5000,75
3288,135,12,45,57,1,100,5000,75
3289,135,17,73,90,1,100,5000,75
3290,135,13,62,75,1,100,5000,75
3291,135,11,61,72,1,100,5000,75
3292,135,5,11,16,1,100,5000,75
3293,135,5,67,72,1,100,5000,75
3294,135,8,49,57,1,100,5000,75
3295,135,2,10,12,1,100,5000,75
3296,135,4,12,16,1,100,5000,75
3297,135,1,25,26,1,100,5000,75
3298,135,4,6,10,1,100,5000,75
3299,135,68,92,160,1,100,5000,75
3300,135,63,105,168,1,100,5000,75
3301,135,46,119,165,1,100,5000,75
3302,135,18,67,85,1,100,5000,75
3303,135,45,130,175,1,100,5000,75
3304,135,20,80,100,1,100,5000,75
3305,135,4,51,55,1,100,5000,75
3306,135,36,34,70,1,100,5000,75
3307,135,6,27,33,1,100,5000,75
3308,135,10,62,72,1,100,5000,75
3309,135,33,229,262,1,100,5000,75
3310,135,6,36,42,1,100,5000,75
3311,135,36,73,109,1,100,5000,75
3312,135,14,63,77,1,100,5000,75
3313,135,48,102,150,1,100,5000,75
3314,135,8,29,37,1,100,5000,75
3315,135,14,26,40,1,100,5000,75
3316,135,45,115,160,1,100,5000,75
3317,135,34,83,117,1,100,5000,75
3318,135,16,31,47,1,100,5000,75
3319,135,45,82,127,1,100,5000,75
3320,135,29,77,106,1,100,5000,75
3321,135,11,93,104,1,100,5000,75
3322,135,24,40,64,1,100,5000,75
3323,135,16,63,79,1,100,5000,75
3324,135,29,57,86,1,100,5000,75
3325,135,45,150,195,1,100,5000,75
3326,135,4,61,65,1,100,5000,75
3327,135,35,106,141,1,100,5000,75
3328,135,5,26,31,1,100,5000,75
3329,135,1,66,67,1,100,5000,75
3330,135,8,22,30,1,100,5000,75
3331,135,21,63,84,1,100,5000,75
3332,135,8,61,69,1,100,5000,75
3333,135,21,57,78,1,100,5000,75
3334,135,15,44,59,1,100,5000,75
3335,135,35,56,91,1,100,5000,75
3336,135,14,28,42,1,100,5000,75
3337,135,10,22,32,1,100,5000,75
3338,135,9,51,60,1,100,5000,75
3339,135,50,113,163,1,100,5000,75
3340,135,8,65,73,1,100,5000,75
3341,135,6,26,32,1,100,5000,75
3342,135,3,12,15,1,100,5000,75
3343,135,67,143,210,1,100,5000,75
3344,135,8,24,32,1,100,5000,75
3345,135,6,12,18,1,100,5000,75
3346,135,32,132,164,1,100,5000,75
3347,135,6,45,51,1,100,5000,75
3348,135,3,15,18,1,100,5000,75
3349,135,1,17,18,1,100,5000,75
3350,135,11,90,101,1,100,5000,75
3351,135,22,96,118,1,100,5000,75
3352,135,42,37,79,1,100,5000,75
3353,135,58,153,211,1,100,5000,75
3354,135,13,35,48,1,100,5000,75
3355,135,27,104,131,1,100,5000,75
3356,135,8,46,54,1,100,5000,75
3357,135,14,11,25,1,100,5000,75
3358,135,25,56,81,1,100,5000,75
3359,135,61,62,123,1,100,5000,75
3360,135,28,69,97,1,100,5000,75
3361,135,31,129,160,1,100,5000,75
3362,135,2,13,15,1,100,5000,75
3363,135,23,55,78,1,100,5000,75
3364,135,31,100,131,1,100,5000,75
3365,135,4,22,26,1,100,5000,75
3366,135,42,186,228,1,100,5000,75
3367,135,36,153,189,1,100,5000,75
3368,135,15,29,44,1,100,5000,75
3369,135,3,24,27,1,100,5000,75
3370,135,1,16,17,1,100,5000,75
3371,135,7,21,28,1,100,5000,75
3372,135,7,35,42,1,100,5000,75
3373,135,7,63,70,1,100,5000,75
3374,135,50,67,117,1,100,5000,75
3375,135,9,27,36,1,100,5000,75
3376,135,26,170,196,1,100,5000,75
3377,135,6,32,38,1,100,5000,75
3378,135,10,34,44,1,100,5000,75
3379,135,13,110,123,1,100,5000,75
3380,135,32,85,117,1,100,5000,75
3381,135,15,49,64,1,100,5000,75
3382,135,27,144,171,1,100,5000,75
3383,135,1,48,49,1,100,5000,75
3384,135,12,16,28,1,100,5000,75
3385,135,14,47,61,1,100,5000,75
3386,135,8,35,43,1,100,5000,75
3387,135,46,113,159,1,100,5000,75
3388,135,34,76,110,1,100,5000,75
3389,135,52,182,234,1,100,5000,75
3390,135,15,36,51,1,100,5000,75
3391,135,9,29,38,1,100,5000,75
3392,135,68,79,147,1,100,5000,75
3393,135,10,68,78,1,100,5000,75
3394,135,18,51,69,1,100,5000,75
3395,135,13,29,42,1,100,5000,75
3396,135,12,39,51,1,100,5000,75
3397,135,6,26,32,1,100,5000,75
3398,135,3,6,9,1,100,5000,75
3399,135,18,70,88,1,100,5000,75
3400,135,4,24,28,1,100,5000,75
3401,135,5,109,114,1,100,5000,75
3402,135,5,71,76,1,100,5000,75
3403,135,19,91,110,1,100,5000,75
3404,135,20,182,202,1,100,5000,75
3405,135,2,15,17,1,100,5000,75
3406,135,16,80,96,1,100,5000,75
3407,135,7,94,101,1,100,5000,75
3408,135,16,88,104,1,100,5000,75
3409,135,5,20,25,1,100,5000,75
3410,135,11,97,108,1,100,5000,75
3411,135,43,82,125,1,100,5000,75
3412,135,63,114,177,1,100,5000,75
3413,135,24,47,71,1,100,5000,75
3414,135,30,94,124,1,100,5000,75
3415,135,5,73,78,1,100,5000,75
3416,135,25,48,73,1,100,5000,75
3417,135,51,97,148,1,100,5000,75
3418,135,67,157,224,1,100,5000,75
3419,135,76,235,311,1,100,5000,75
3420,135,16,117,133,1,100,5000,75
3421,135,33,79,112,1,100,5000,75
3422,135,27,101,128,1,100,5000,75
3423,135,34,89,123,1,100,5000,75
3424,135,18,63,81,1,100,5000,75
3425,135,70,126,196,1,100,5000,75
3426,135,26,142,168,1,100,5000,75
3427,135,32,93,125,1,100,5000,75
3428,135,49,273,322,1,100,5000,75
3429,135,44,168,212,1,100,5000,75
3430,135,24,89,113,1,100,5000,75
3431,135,24,58,82,1,100,5000,75
3432,135,28,125,153,1,100,5000,75
3433,135,16,75,91,1,100,5000,75
3434,135,36,82,118,1,100,5000,75
3435,135,31,93,124,1,100,5000,75
3436,135,7,39,46,1,100,5000,75
3437,135,45,100,145,1,100,5000,75
3438,135,4,59,63,1,100,5000,75
3439,135,2,42,44,1,100,5000,75
3440,135,7,48,55,1,100,5000,75
3441,135,39,74,113,1,100,5000,75
3442,135,38,58,96,1,100,5000,75
3443,135,29,71,100,1,100,5000,75
3444,135,58,168,226,1,100,5000,75
3445,135,13,42,55,1,100,5000,75
3446,135,4,41,45,1,100,5000,75
3447,135,10,69,79,1,100,5000,75
3448,135,14,75,89,1,100,5000,75
3449,180,194,296,490,1,100,NaN,NaN
3450,180,244,230,474,1,100,NaN,NaN
3451,180,135,186,321,1,100,NaN,NaN
3452,180,200,299,499,1,100,NaN,NaN
3453,180,103,352,455,1,100,NaN,NaN
3454,180,170,320,490,1,100,NaN,NaN
3455,180,153,299,452,1,100,NaN,NaN
3456,180,142,287,429,1,100,NaN,NaN
3457,180,50,110,160,1,100,NaN,NaN
3458,180,35,146,181,1,100,NaN,NaN
3459,180,115,259,374,1,100,NaN,NaN
3460,180,66,155,221,1,100,NaN,NaN
3461,180,96,254,350,1,100,NaN,NaN
3462,180,138,178,316,1,100,NaN,NaN
3463,180,100,155,255,1,100,NaN,NaN
3464,180,45,160,205,1,100,NaN,NaN
3465,180,164,268,432,1,100,NaN,NaN
3466,180,225,271,496,1,100,NaN,NaN
3467,180,124,238,362,1,100,NaN,NaN
3468,180,221,222,443,1,100,NaN,NaN
3469,180,40,85,125,1,100,NaN,NaN
3470,180,145,274,419,1,100,NaN,NaN
3471,180,189,242,431,1,100,NaN,NaN
3472,180,52,112,164,1,100,NaN,NaN
3473,180,95,141,236,1,100,NaN,NaN
3474,180,122,155,277,1,100,NaN,NaN
3475,180,33,83,116,1,100,NaN,NaN
3476,180,46,110,156,1,100,NaN,NaN
3477,180,28,42,70,1,100,NaN,NaN
3478,180,4,45,49,1,100,NaN,NaN
3479,180,161,244,405,1,100,NaN,NaN
3480,180,94,98,192,1,100,NaN,NaN
3481,180,79,82,161,1,100,NaN,NaN
3482,180,139,196,335,1,100,NaN,NaN
3483,180,224,332,556,1,100,NaN,NaN
3484,180,124,212,336,1,100,NaN,NaN
3485,180,198,228,426,1,100,NaN,NaN
3486,180,163,344,507,1,100,NaN,NaN
3487,180,133,193,326,1,100,NaN,NaN
3488,180,62,82,144,1,100,NaN,NaN
3489,180,60,120,180,1,100,NaN,NaN
3490,180,149,211,360,1,100,NaN,NaN
3491,180,97,90,187,1,100,NaN,NaN
3492,180,171,227,398,1,100,NaN,NaN
3493,180,170,303,473,1,100,NaN,NaN
3494,180,93,202,295,1,100,NaN,NaN
3495,180,82,131,213,1,100,NaN,NaN
3496,180,63,81,144,1,100,NaN,NaN
3497,180,84,187,271,1,100,NaN,NaN
3498,180,36,58,94,1,100,NaN,NaN
3499,180,158,277,435,1,100,NaN,NaN
3500,180,66,136,202,1,100,NaN,NaN
3501,180,120,181,301,1,100,NaN,NaN
3502,180,101,192,293,1,100,NaN,NaN
3503,180,97,242,339,1,100,NaN,NaN
3504,180,79,174,253,1,100,NaN,NaN
3505,180,37,58,95,1,100,NaN,NaN
3506,180,72,191,263,1,100,NaN,NaN
3507,180,72,164,236,1,100,NaN,NaN
3508,180,19,39,58,1,100,NaN,NaN
3509,180,23,55,78,1,100,NaN,NaN
3510,180,39,90,129,1,100,NaN,NaN
3511,180,134,180,314,1,100,NaN,NaN
3512,180,115,188,303,1,100,NaN,NaN
3513,180,183,256,439,1,100,NaN,NaN
3514,180,155,347,502,1,100,NaN,NaN
3515,180,135,190,325,1,100,NaN,NaN
3516,180,85,161,246,1,100,NaN,NaN
3517,180,82,141,223,1,100,NaN,NaN
3518,180,53,121,174,1,100,NaN,NaN
3519,180,64,101,165,1,100,NaN,NaN
3520,180,27,38,65,1,100,NaN,NaN
3521,180,89,60,149,1,100,NaN,NaN
3522,180,112,245,357,1,100,NaN,NaN
3523,180,30,39,69,1,100,NaN,NaN
3524,180,14,9,23,1,100,NaN,NaN
3525,180,85,148,233,1,100,NaN,NaN
3526,180,170,145,315,1,100,NaN,NaN
3527,180,89,100,189,1,100,NaN,NaN
3528,180,40,71,111,1,100,NaN,NaN
3529,180,95,174,269,1,100,NaN,NaN
3530,180,74,119,193,1,100,NaN,NaN
3531,180,19,14,33,1,100,NaN,NaN
3532,180,21,27,48,1,100,NaN,NaN
3533,180,46,113,159,1,100,NaN,NaN
3534,180,50,103,153,1,100,NaN,NaN
3535,180,24,42,66,1,100,NaN,NaN
3536,180,35,110,145,1,100,NaN,NaN
3537,180,16,58,74,1,100,NaN,NaN
3538,180,42,68,110,1,100,NaN,NaN
3539,180,139,252,391,1,100,NaN,NaN
3540,180,30,69,99,1,100,NaN,NaN
3541,180,19,100,119,1,100,NaN,NaN
3542,180,30,72,102,1,100,NaN,NaN
3543,180,28,94,122,1,100,NaN,NaN
3544,180,35,91,126,1,100,NaN,NaN
3545,180,22,235,257,1,100,NaN,NaN
3546,180,91,75,166,1,100,NaN,NaN
3547,180,14,56,70,1,100,NaN,NaN
3548,180,34,50,84,1,100,NaN,NaN
3549,180,54,57,111,1,100,NaN,NaN
3550,180,128,151,279,1,100,NaN,NaN
3551,180,83,136,219,1,100,NaN,NaN
3552,180,30,66,96,1,100,NaN,NaN
3553,180,116,224,340,1,100,NaN,NaN
3554,180,67,55,122,1,100,NaN,NaN
3555,180,31,78,109,1,100,NaN,NaN
3556,180,98,165,263,1,100,NaN,NaN
3557,180,27,90,117,1,100,NaN,NaN
3558,180,102,94,196,1,100,NaN,NaN
3559,180,25,137,162,1,100,NaN,NaN
3560,180,71,128,199,1,100,NaN,NaN
3561,180,106,158,264,1,100,NaN,NaN
3562,180,26,50,76,1,100,NaN,NaN
3563,180,34,58,92,1,100,NaN,NaN
3564,180,68,123,191,1,100,NaN,NaN
3565,180,22,30,52,1,100,NaN,NaN
3566,180,9,27,36,1,100,NaN,NaN
3567,180,123,165,288,1,100,NaN,NaN
3568,180,61,122,183,1,100,NaN,NaN
3569,180,38,83,121,1,100,NaN,NaN
3570,180,60,102,162,1,100,NaN,NaN
3571,180,118,156,274,1,100,NaN,NaN
3572,180,130,174,304,1,100,NaN,NaN
3573,180,22,46,68,1,100,NaN,NaN
3574,180,51,98,149,1,100,NaN,NaN
3575,180,51,127,178,1,100,NaN,NaN
3576,180,41,128,169,1,100,NaN,NaN
3577,180,30,61,91,1,100,NaN,NaN
3578,180,116,215,331,1,100,NaN,NaN
3579,180,91,132,223,1,100,NaN,NaN
3580,180,82,45,127,1,100,NaN,NaN
3581,180,96,125,221,1,100,NaN,NaN
3582,180,105,102,207,1,100,NaN,NaN
3583,180,28,73,101,1,100,NaN,NaN
3584,180,81,153,234,1,100,NaN,NaN
3585,180,42,182,224,1,100,NaN,NaN
3586,180,43,69,112,1,100,NaN,NaN
3587,180,36,75,111,1,100,NaN,NaN
3588,180,48,96,144,1,100,NaN,NaN
3589,180,166,210,376,1,100,NaN,NaN
3590,180,100,130,230,1,100,NaN,NaN
3591,180,28,85,113,1,100,NaN,NaN
3592,180,32,59,91,1,100,NaN,NaN
3593,180,45,69,114,1,100,NaN,NaN
3594,180,81,94,175,1,100,NaN,NaN
3595,180,48,61,109,1,100,NaN,NaN
3596,180,87,160,247,1,100,NaN,NaN
3597,180,46,82,128,1,100,NaN,NaN
3598,180,68,111,179,1,100,NaN,NaN
3599,180,14,21,35,1,100,NaN,NaN
3600,180,56,60,116,1,100,NaN,NaN
3601,180,88,110,198,1,100,NaN,NaN
3602,180,82,203,285,1,100,NaN,NaN
3603,180,99,218,317,1,100,NaN,NaN
3604,180,60,92,152,1,100,NaN,NaN
3605,180,84,194,278,1,100,NaN,NaN
3606,180,20,39,59,1,100,NaN,NaN
3607,180,77,195,272,1,100,NaN,NaN
3608,180,27,74,101,1,100,NaN,NaN
3609,180,25,95,120,1,100,NaN,NaN
3610,180,19,36,55,1,100,NaN,NaN
3611,180,31,42,73,1,100,NaN,NaN
3612,180,15,55,70,1,100,NaN,NaN
3613,180,26,46,72,1,100,NaN,NaN
3614,180,32,55,87,1,100,NaN,NaN
3615,180,67,137,204,1,100,NaN,NaN
3616,180,40,81,121,1,100,NaN,NaN
3617,180,33,86,119,1,100,NaN,NaN
3618,180,19,57,76,1,100,NaN,NaN
3619,180,40,121,161,1,100,NaN,NaN
3620,180,16,69,85,1,100,NaN,NaN
3621,180,73,121,194,1,100,NaN,NaN
3622,180,76,178,254,1,100,NaN,NaN
3623,180,158,213,371,1,100,NaN,NaN
3624,180,65,95,160,1,100,NaN,NaN
3625,180,52,151,203,1,100,NaN,NaN
3626,180,24,141,165,1,100,NaN,NaN
3627,180,70,160,230,1,100,NaN,NaN
3628,180,101,192,293,1,100,NaN,NaN
3629,180,36,120,156,1,100,NaN,NaN
3630,180,59,117,176,1,100,NaN,NaN
3631,180,122,469,591,1,100,NaN,NaN
3632,180,43,107,150,1,100,NaN,NaN
3633,180,54,79,133,1,100,NaN,NaN
3634,180,115,234,349,1,100,NaN,NaN
3635,180,124,197,321,1,100,NaN,NaN
3636,180,137,185,322,1,100,NaN,NaN
3637,180,32,94,126,1,100,NaN,NaN
3638,180,103,164,267,1,100,NaN,NaN
3639,180,56,119,175,1,100,NaN,NaN
3640,180,65,134,199,1,100,NaN,NaN
3641,180,49,70,119,1,100,NaN,NaN
3642,180,57,151,208,1,100,NaN,NaN
3643,180,6,22,28,1,100,NaN,NaN
3644,180,22,177,199,1,100,NaN,NaN
3645,180,159,195,354,1,100,NaN,NaN
3646,180,398,513,911,1,100,NaN,NaN
3647,180,29,259,288,1,100,NaN,NaN
3648,180,28,173,201,1,100,NaN,NaN
3649,180,20,55,75,1,100,NaN,NaN
3650,180,19,248,267,1,100,NaN,NaN
3651,180,86,254,340,1,100,NaN,NaN
3652,180,137,220,357,1,100,NaN,NaN
3653,180,45,153,198,1,100,NaN,NaN
3654,180,25,66,91,1,100,NaN,NaN
3655,180,167,225,392,1,100,NaN,NaN
3656,180,144,288,432,1,100,NaN,NaN
3657,180,121,209,330,1,100,NaN,NaN
3658,180,52,72,124,1,100,NaN,NaN
3659,180,53,177,230,1,100,NaN,NaN
3660,180,127,217,344,1,100,NaN,NaN
3661,180,214,258,472,1,100,NaN,NaN
3662,180,45,65,110,1,100,NaN,NaN
3663,180,160,312,472,1,100,NaN,NaN
3664,180,94,167,261,1,100,NaN,NaN
3665,180,37,65,102,1,100,NaN,NaN
3666,180,107,167,274,1,100,NaN,NaN
3667,180,52,91,143,1,100,NaN,NaN
3668,180,19,54,73,1,100,NaN,NaN
3669,180,77,57,134,1,100,NaN,NaN
3670,180,44,88,132,1,100,NaN,NaN
3671,180,131,267,398,1,100,NaN,NaN
3672,180,59,62,121,1,100,NaN,NaN
3673,180,58,72,130,1,100,NaN,NaN
3674,180,70,82,152,1,100,NaN,NaN
3675,180,13,38,51,1,100,NaN,NaN
3676,180,68,111,179,1,100,NaN,NaN
3677,180,23,43,66,1,100,NaN,NaN
3678,180,108,195,303,1,100,NaN,NaN
3679,180,94,123,217,1,100,NaN,NaN
3680,180,24,50,74,1,100,NaN,NaN
3681,180,50,77,127,1,100,NaN,NaN
3682,180,30,102,132,1,100,NaN,NaN
3683,180,35,164,199,1,100,NaN,NaN
3684,180,27,55,82,1,100,NaN,NaN
3685,180,27,49,76,1,100,NaN,NaN
3686,180,6,7,13,1,100,NaN,NaN
3687,180,15,46,61,1,100,NaN,NaN
3688,180,126,170,296,1,100,NaN,NaN
3689,180,69,276,345,1,100,NaN,NaN
3690,180,139,238,377,1,100,NaN,NaN
3691,180,17,68,85,1,100,NaN,NaN
3692,180,99,183,282,1,100,NaN,NaN
3693,180,28,77,105,1,100,NaN,NaN
3694,180,112,184,296,1,100,NaN,NaN
3695,180,87,239,326,1,100,NaN,NaN
3696,180,143,287,430,1,100,NaN,NaN
3697,180,128,266,394,1,100,NaN,NaN
3698,180,115,278,393,1,100,NaN,NaN
3699,180,119,225,344,1,100,NaN,NaN
3700,180,31,151,182,1,100,NaN,NaN
3701,180,66,184,250,1,100,NaN,NaN
3702,180,46,222,268,1,100,NaN,NaN
3703,180,84,148,232,1,100,NaN,NaN
3704,180,37,130,167,1,100,NaN,NaN
3705,180,87,223,310,1,100,NaN,NaN
3706,180,23,286,309,1,100,NaN,NaN
3707,180,31,117,148,1,100,NaN,NaN
3708,180,32,157,189,1,100,NaN,NaN
3709,180,62,135,197,1,100,NaN,NaN
3710,180,2,46,48,1,100,NaN,NaN
3711,180,47,155,202,1,100,NaN,NaN
3712,180,12,87,99,1,100,NaN,NaN
3713,180,56,146,202,1,100,NaN,NaN
3714,180,25,96,121,1,100,NaN,NaN
3715,180,121,258,379,1,100,NaN,NaN
3716,180,78,190,268,1,100,NaN,NaN
3717,180,41,94,135,1,100,NaN,NaN
3718,180,71,121,192,1,100,NaN,NaN
3719,180,18,115,133,1,100,NaN,NaN
3720,180,47,154,201,1,100,NaN,NaN
3721,180,101,341,442,1,100,NaN,NaN
3722,180,39,126,165,1,100,NaN,NaN
3723,180,24,112,136,1,100,NaN,NaN
3724,180,79,152,231,1,100,NaN,NaN
3725,180,55,118,173,1,100,NaN,NaN
3726,180,52,113,165,1,100,NaN,NaN
3727,180,10,37,47,1,100,NaN,NaN
3728,180,160,212,372,1,100,NaN,NaN
3729,180,30,80,110,1,100,NaN,NaN
3730,180,11,25,36,1,100,NaN,NaN
3731,180,78,135,213,1,100,NaN,NaN
3732,180,31,45,76,1,100,NaN,NaN
3733,180,53,92,145,1,100,NaN,NaN
3734,180,45,32,77,1,100,NaN,NaN
3735,180,80,157,237,1,100,NaN,NaN
3736,180,60,145,205,1,100,NaN,NaN
3737,180,74,109,183,1,100,NaN,NaN
3738,180,23,57,80,1,100,NaN,NaN
3739,180,38,99,137,1,100,NaN,NaN
3740,180,14,21,35,1,100,NaN,NaN
3741,180,7,23,30,1,100,NaN,NaN
3742,180,44,123,167,1,100,NaN,NaN
3743,180,24,114,138,1,100,NaN,NaN
3744,180,17,34,51,1,100,NaN,NaN
3745,180,42,166,208,1,100,NaN,NaN
3746,180,12,57,69,1,100,NaN,NaN
3747,180,20,98,118,1,100,NaN,NaN
3748,180,53,117,170,1,100,NaN,NaN
3749,180,12,79,91,1,100,NaN,NaN
3750,180,29,127,156,1,100,NaN,NaN
3751,180,45,121,166,1,100,NaN,NaN
3752,180,95,185,280,1,100,NaN,NaN
3753,180,20,84,104,1,100,NaN,NaN
3754,180,55,59,114,1,100,NaN,NaN
3755,180,108,171,279,1,100,NaN,NaN
3756,180,43,36,79,1,100,NaN,NaN
3757,180,45,93,138,1,100,NaN,NaN
3758,180,49,111,160,1,100,NaN,NaN
3759,180,20,47,67,1,100,NaN,NaN
3760,180,43,107,150,1,100,NaN,NaN
3761,180,45,107,152,1,100,NaN,NaN
3762,180,63,107,170,1,100,NaN,NaN
3763,180,29,81,110,1,100,NaN,NaN
3764,180,44,142,186,1,100,NaN,NaN
3765,180,11,26,37,1,100,NaN,NaN
3766,180,19,24,43,1,100,NaN,NaN
3767,180,22,54,76,1,100,NaN,NaN
3768,180,8,51,59,1,100,NaN,NaN
3769,180,83,50,133,1,100,NaN,NaN
3770,180,55,132,187,1,100,NaN,NaN
3771,180,21,38,59,1,100,NaN,NaN
3772,180,48,95,143,1,100,NaN,NaN
3773,180,62,74,136,1,100,NaN,NaN
3774,180,52,111,163,1,100,NaN,NaN
3775,180,35,62,97,1,100,NaN,NaN
3776,180,55,164,219,1,100,NaN,NaN
3777,180,62,186,248,1,100,NaN,NaN
3778,180,54,176,230,1,100,NaN,NaN
3779,180,8,11,19,1,100,NaN,NaN
3780,195,94,265,359,1,100,5000,180
3781,195,61,186,247,1,100,5000,180
3782,195,135,337,472,1,100,5000,180
3783,195,51,109,160,1,100,5000,180
3784,195,140,164,304,1,100,5000,180
3785,195,91,233,324,1,100,5000,180
3786,195,72,146,218,1,100,5000,180
3787,195,125,226,351,1,100,5000,180
3788,195,109,230,339,1,100,5000,180
3789,195,135,314,449,1,100,5000,180
3790,195,12,98,110,1,100,5000,180
3791,195,27,39,66,1,100,5000,180
3792,195,32,74,106,1,100,5000,180
3793,195,147,301,448,1,100,5000,180
3794,195,71,137,208,1,100,5000,180
3795,195,35,193,228,1,100,5000,180
3796,195,66,142,208,1,100,5000,180
3797,195,136,295,431,1,100,5000,180
3798,195,58,144,202,1,100,5000,180
3799,195,38,152,190,1,100,5000,180
3800,195,110,238,348,1,100,5000,180
3801,195,19,113,132,1,100,5000,180
3802,195,42,117,159,1,100,5000,180
3803,195,26,106,132,1,100,5000,180
3804,195,115,257,372,1,100,5000,180
3805,195,232,200,432,1,100,5000,180
3806,195,159,335,494,1,100,5000,180
3807,195,186,240,426,1,100,5000,180
3808,195,84,218,302,1,100,5000,180
3809,195,190,319,509,1,100,5000,180
3810,195,160,287,447,1,100,5000,180
3811,195,310,223,533,1,100,5000,180
3812,195,86,236,322,1,100,5000,180
3813,195,127,230,357,1,100,5000,180
3814,195,49,224,273,1,100,5000,180
3815,195,40,55,95,1,100,5000,180
3816,195,29,94,123,1,100,5000,180
3817,195,62,129,191,1,100,5000,180
3818,195,54,184,238,1,100,5000,180
3819,195,69,226,295,1,100,5000,180
3820,195,100,189,289,1,100,5000,180
3821,195,173,422,595,1,100,5000,180
3822,195,65,240,305,1,100,5000,180
3823,195,47,99,146,1,100,5000,180
3824,195,124,308,432,1,100,5000,180
3825,195,87,211,298,1,100,5000,180
3826,195,169,282,451,1,100,5000,180
3827,195,45,149,194,1,100,5000,180
3828,195,68,182,250,1,100,5000,180
3829,195,24,109,133,1,100,5000,180
3830,195,22,82,104,1,100,5000,180
3831,195,117,330,447,1,100,5000,180
3832,195,182,320,502,1,100,5000,180
3833,195,119,268,387,1,100,5000,180
3834,195,114,282,396,1,100,5000,180
3835,195,76,177,253,1,100,5000,180
3836,195,131,381,512,1,100,5000,180
3837,195,43,162,205,1,100,5000,180
3838,195,46,51,97,1,100,5000,180
3839,195,66,277,343,1,100,5000,180
3840,195,47,154,201,1,100,5000,180
3841,195,191,370,561,1,100,5000,180
3842,195,219,396,615,1,100,5000,180
3843,195,99,386,485,1,100,5000,180
3844,195,212,412,624,1,100,5000,180
3845,195,189,437,626,1,100,5000,180
3846,195,28,65,93,1,100,5000,180
3847,195,69,126,195,1,100,5000,180
3848,195,145,290,435,1,100,5000,180
3849,195,133,213,346,1,100,5000,180
3850,195,30,117,147,1,100,5000,180
3851,195,13,112,125,1,100,5000,180
3852,195,17,161,178,1,100,5000,180
3853,195,73,63,136,1,100,5000,180
3854,195,158,233,391,1,100,5000,180
3855,195,14,51,65,1,100,5000,180
3856,195,177,224,401,1,100,5000,180
3857,195,182,341,523,1,100,5000,180
3858,195,151,261,412,1,100,5000,180
3859,195,303,327,630,1,100,5000,180
3860,195,107,215,322,1,100,5000,180
3861,195,182,151,333,1,100,5000,180
3862,195,136,209,345,1,100,5000,180
3863,195,62,42,104,1,100,5000,180
3864,195,116,234,350,1,100,5000,180
3865,195,44,127,171,1,100,5000,180
3866,195,34,96,130,1,100,5000,180
3867,195,14,43,57,1,100,5000,180
3868,195,12,141,153,1,100,5000,180
3869,195,72,190,262,1,100,5000,180
3870,195,104,270,374,1,100,5000,180
3871,195,110,267,377,1,100,5000,180
3872,195,22,169,191,1,100,5000,180
3873,195,70,180,250,1,100,5000,180
3874,195,67,283,350,1,100,5000,180
3875,195,73,215,288,1,100,5000,180
3876,195,53,143,196,1,100,5000,180
3877,195,69,205,274,1,100,5000,180
3878,195,85,265,350,1,100,5000,180
3879,195,41,149,190,1,100,5000,180
3880,195,56,167,223,1,100,5000,180
3881,195,32,153,185,1,100,5000,180
3882,195,24,76,100,1,100,5000,180
3883,195,56,80,136,1,100,5000,180
3884,195,62,459,521,1,100,5000,180
3885,195,31,103,134,1,100,5000,180
3886,195,69,140,209,1,100,5000,180
3887,195,43,56,99,1,100,5000,180
3888,195,3,71,74,1,100,5000,180
3889,195,14,174,188,1,100,5000,180
3890,195,67,189,256,1,100,5000,180
3891,195,66,230,296,1,100,5000,180
3892,195,201,309,510,1,100,5000,180
3893,195,67,124,191,1,100,5000,180
3894,195,21,100,121,1,100,5000,180
3895,195,66,91,157,1,100,5000,180
3896,195,96,261,357,1,100,5000,180
3897,195,78,208,286,1,100,5000,180
3898,195,95,166,261,1,100,5000,180
3899,195,44,175,219,1,100,5000,180
3900,195,113,214,327,1,100,5000,180
3901,195,61,119,180,1,100,5000,180
3902,195,55,133,188,1,100,5000,180
3903,195,84,119,203,1,100,5000,180
3904,195,41,41,82,1,100,5000,180
3905,195,29,72,101,1,100,5000,180
3906,195,68,179,247,1,100,5000,180
3907,195,11,52,63,1,100,5000,180
3908,195,40,113,153,1,100,5000,180
3909,195,24,50,74,1,100,5000,180
3910,195,17,83,100,1,100,5000,180
3911,195,71,142,213,1,100,5000,180
3912,195,59,209,268,1,100,5000,180
3913,195,68,241,309,1,100,5000,180
3914,195,101,183,284,1,100,5000,180
3915,195,167,483,650,1,100,5000,180
3916,195,46,211,257,1,100,5000,180
3917,195,27,110,137,1,100,5000,180
3918,195,27,130,157,1,100,5000,180
3919,195,63,142,205,1,100,5000,180
3920,195,155,222,377,1,100,5000,180
3921,195,82,233,315,1,100,5000,180
3922,195,66,38,104,1,100,5000,180
3923,195,90,206,296,1,100,5000,180
3924,195,94,184,278,1,100,5000,180
3925,195,77,146,223,1,100,5000,180
3926,195,62,183,245,1,100,5000,180
3927,195,19,73,92,1,100,5000,180
3928,195,34,75,109,1,100,5000,180
3929,195,7,20,27,1,100,5000,180
3930,195,49,124,173,1,100,5000,180
3931,195,4,23,27,1,100,5000,180
3932,195,124,212,336,1,100,5000,180
3933,195,221,544,765,1,100,5000,180
3934,195,78,202,280,1,100,5000,180
3935,195,115,256,371,1,100,5000,180
3936,195,11,32,43,1,100,5000,180
3937,195,96,220,316,1,100,5000,180
3938,195,37,66,103,1,100,5000,180
3939,195,88,93,181,1,100,5000,180
3940,195,108,220,328,1,100,5000,180
3941,195,16,66,82,1,100,5000,180
3942,195,58,118,176,1,100,5000,180
3943,195,37,111,148,1,100,5000,180
3944,195,62,178,240,1,100,5000,180
3945,195,65,94,159,1,100,5000,180
3946,195,89,259,348,1,100,5000,180
3947,195,43,135,178,1,100,5000,180
3948,195,3,58,61,1,100,5000,180
3949,195,40,104,144,1,100,5000,180
3950,195,17,130,147,1,100,5000,180
3951,195,76,246,322,1,100,5000,180
3952,195,29,179,208,1,100,5000,180
3953,195,179,305,484,1,100,5000,180
3954,195,132,265,397,1,100,5000,180
3955,195,51,141,192,1,100,5000,180
3956,195,17,95,112,1,100,5000,180
3957,195,57,122,179,1,100,5000,180
3958,195,28,78,106,1,100,5000,180
3959,195,6,18,24,1,100,5000,180
3960,195,30,98,128,1,100,5000,180
3961,195,60,90,150,1,100,5000,180
3962,195,172,320,492,1,100,5000,180
3963,195,77,242,319,1,100,5000,180
3964,195,80,220,300,1,100,5000,180
3965,195,176,332,508,1,100,5000,180
3966,195,118,128,246,1,100,5000,180
3967,195,37,116,153,1,100,5000,180
3968,195,61,111,172,1,100,5000,180
3969,195,48,123,171,1,100,5000,180
3970,195,37,55,92,1,100,5000,180
3971,195,57,239,296,1,100,5000,180
3972,195,57,109,166,1,100,5000,180
3973,195,8,26,34,1,100,5000,180
3974,195,49,83,132,1,100,5000,180
3975,195,96,139,235,1,100,5000,180
3976,195,37,188,225,1,100,5000,180
3977,195,83,190,273,1,100,5000,180
3978,195,123,162,285,1,100,5000,180
3979,195,104,240,344,1,100,5000,180
3980,195,38,135,173,1,100,5000,180
3981,195,43,127,170,1,100,5000,180
3982,195,36,150,186,1,100,5000,180
3983,195,37,159,196,1,100,5000,180
3984,195,57,137,194,1,100,5000,180
3985,195,33,145,178,1,100,5000,180
3986,195,50,439,489,1,100,5000,180
3987,195,34,149,183,1,100,5000,180
3988,195,109,230,339,1,100,5000,180
3989,195,56,185,241,1,100,5000,180
3990,195,111,257,368,1,100,5000,180
3991,195,88,204,292,1,100,5000,180
3992,195,111,199,310,1,100,5000,180
3993,195,139,269,408,1,100,5000,180
3994,195,98,337,435,1,100,5000,180
3995,195,25,131,156,1,100,5000,180
3996,195,18,121,139,1,100,5000,180
3997,195,44,149,193,1,100,5000,180
3998,195,114,280,394,1,100,5000,180
3999,195,39,214,253,1,100,5000,180
4000,195,50,339,389,1,100,5000,180
4001,195,83,239,322,1,100,5000,180
4002,195,11,44,55,1,100,5000,180
4003,195,31,76,107,1,100,5000,180
4004,195,34,106,140,1,100,5000,180
4005,195,41,148,189,1,100,5000,180
4006,195,59,98,157,1,100,5000,180
4007,195,29,75,104,1,100,5000,180
4008,195,51,120,171,1,100,5000,180
4009,195,70,221,291,1,100,5000,180
4010,195,76,225,301,1,100,5000,180
4011,195,66,137,203,1,100,5000,180
4012,195,17,51,68,1,100,5000,180
4013,195,48,168,216,1,100,5000,180
4014,195,30,31,61,1,100,5000,180
4015,195,65,194,259,1,100,5000,180
4016,195,22,28,50,1,100,5000,180
4017,195,86,254,340,1,100,5000,180
4018,195,54,211,265,1,100,5000,180
4019,195,50,222,272,1,100,5000,180
4020,195,9,39,48,1,100,5000,180
4021,195,48,113,161,1,100,5000,180
4022,195,82,243,325,1,100,5000,180
4023,195,34,110,144,1,100,5000,180
4024,195,101,205,306,1,100,5000,180
4025,195,107,184,291,1,100,5000,180
4026,195,33,42,75,1,100,5000,180
4027,195,73,188,261,1,100,5000,180
4028,195,17,52,69,1,100,5000,180
4029,195,38,74,112,1,100,5000,180
4030,195,57,125,182,1,100,5000,180
4031,195,45,168,213,1,100,5000,180
4032,195,54,124,178,1,100,5000,180
4033,195,18,85,103,1,100,5000,180
4034,195,41,161,202,1,100,5000,180
4035,195,16,130,146,1,100,5000,180
4036,195,38,130,168,1,100,5000,180
4037,195,28,141,169,1,100,5000,180
4038,195,49,147,196,1,100,5000,180
4039,195,10,31,41,1,100,5000,180
4040,195,60,184,244,1,100,5000,180
4041,195,29,55,84,1,100,5000,180
4042,195,67,185,252,1,100,5000,180
4043,195,82,193,275,1,100,5000,180
4044,195,42,87,129,1,100,5000,180
4045,195,92,233,325,1,100,5000,180
4046,195,8,67,75,1,100,5000,180
4047,195,78,201,279,1,100,5000,180
4048,195,62,214,276,1,100,5000,180
4049,195,63,134,197,1,100,5000,180
4050,195,33,113,146,1,100,5000,180
4051,195,97,148,245,1,100,5000,180
4052,195,14,154,168,1,100,5000,180
4053,195,50,75,125,1,100,5000,180
4054,195,55,278,333,1,100,5000,180
4055,195,56,173,229,1,100,5000,180
4056,195,74,180,254,1,100,5000,180
4057,195,80,191,271,1,100,5000,180
4058,195,28,297,325,1,100,5000,180
4059,195,82,447,529,1,100,5000,180
4060,195,34,320,354,1,100,5000,180
4061,195,97,324,421,1,100,5000,180
4062,195,71,265,336,1,100,5000,180
4063,195,95,220,315,1,100,5000,180
4064,195,105,155,260,1,100,5000,180
4065,195,38,67,105,1,100,5000,180
4066,195,104,158,262,1,100,5000,180
4067,195,56,95,151,1,100,5000,180
4068,195,88,226,314,1,100,5000,180
4069,195,30,114,144,1,100,5000,180
4070,195,10,27,37,1,100,5000,180
4071,195,14,55,69,1,100,5000,180
4072,195,18,111,129,1,100,5000,180
4073,210,34,96,130,1,100,5000,180
4074,210,81,172,253,1,100,5000,180
4075,210,43,105,148,1,100,5000,180
4076,210,33,223,256,1,100,5000,180
4077,210,41,45,86,1,100,5000,180
4078,210,43,195,238,1,100,5000,180
4079,210,52,121,173,1,100,5000,180
4080,210,40,87,127,1,100,5000,180
4081,210,85,83,168,1,100,5000,180
4082,210,61,162,223,1,100,5000,180
4083,210,55,203,258,1,100,5000,180
4084,210,46,168,214,1,100,5000,180
4085,210,51,178,229,1,100,5000,180
4086,210,30,127,157,1,100,5000,180
4087,210,41,248,289,1,100,5000,180
4088,210,13,54,67,1,100,5000,180
4089,210,23,65,88,1,100,5000,180
4090,210,45,143,188,1,100,5000,180
4091,210,41,203,244,1,100,5000,180
4092,210,65,171,236,1,100,5000,180
4093,210,37,142,179,1,100,5000,180
4094,210,13,55,68,1,100,5000,180
4095,210,41,167,208,1,100,5000,180
4096,210,26,126,152,1,100,5000,180
4097,210,59,245,304,1,100,5000,180
4098,210,31,151,182,1,100,5000,180
4099,210,47,163,210,1,100,5000,180
4100,210,17,90,107,1,100,5000,180
4101,210,19,76,95,1,100,5000,180
4102,210,29,134,163,1,100,5000,180
4103,210,49,154,203,1,100,5000,180
4104,210,56,114,170,1,100,5000,180
4105,210,36,34,70,1,100,5000,180
4106,210,12,56,68,1,100,5000,180
4107,210,41,111,152,1,100,5000,180
4108,210,40,102,142,1,100,5000,180
4109,210,17,63,80,1,100,5000,180
4110,210,31,128,159,1,100,5000,180
4111,210,33,89,122,1,100,5000,180
4112,210,26,192,218,1,100,5000,180
4113,210,36,118,154,1,100,5000,180
4114,210,33,107,140,1,100,5000,180
4115,210,23,89,112,1,100,5000,180
4116,210,12,58,70,1,100,5000,180
4117,210,25,72,97,1,100,5000,180
4118,210,28,59,87,1,100,5000,180
4119,210,74,151,225,1,100,5000,180
4120,210,17,74,91,1,100,5000,180
4121,210,32,150,182,1,100,5000,180
4122,210,13,51,64,1,100,5000,180
4123,210,44,139,183,1,100,5000,180
4124,210,9,40,49,1,100,5000,180
4125,210,96,119,215,1,100,5000,180
4126,210,20,103,123,1,100,5000,180
4127,210,21,101,122,1,100,5000,180
4128,210,32,117,149,1,100,5000,180
4129,210,46,132,178,1,100,5000,180
4130,210,10,73,83,1,100,5000,180
4131,210,25,100,125,1,100,5000,180
4132,210,64,192,256,1,100,5000,180
4133,210,51,170,221,1,100,5000,180
4134,210,28,126,154,1,100,5000,180
4135,210,37,136,173,1,100,5000,180
4136,210,20,219,239,1,100,5000,180
4137,210,20,101,121,1,100,5000,180
4138,210,19,101,120,1,100,5000,180
4139,210,35,171,206,1,100,5000,180
4140,210,53,243,296,1,100,5000,180
4141,210,48,136,184,1,100,5000,180
4142,210,46,130,176,1,100,5000,180
4143,210,116,257,373,1,100,5000,180
4144,210,22,77,99,1,100,5000,180
4145,210,45,180,225,1,100,5000,180
4146,210,24,82,106,1,100,5000,180
4147,210,26,236,262,1,100,5000,180
4148,210,25,68,93,1,100,5000,180
4149,210,26,44,70,1,100,5000,180
4150,210,53,154,207,1,100,5000,180
4151,210,44,106,150,1,100,5000,180
4152,210,32,149,181,1,100,5000,180
4153,210,32,82,114,1,100,5000,180
4154,210,42,183,225,1,100,5000,180
4155,210,18,187,205,1,100,5000,180
4156,210,28,76,104,1,100,5000,180
4157,210,37,60,97,1,100,5000,180
4158,210,34,90,124,1,100,5000,180
4159,210,63,113,176,1,100,5000,180
4160,210,36,146,182,1,100,5000,180
4161,210,75,170,245,1,100,5000,180
4162,210,85,222,307,1,100,5000,180
4163,210,27,77,104,1,100,5000,180
4164,210,15,125,140,1,100,5000,180
4165,210,23,168,191,1,100,5000,180
4166,210,22,97,119,1,100,5000,180
4167,210,12,31,43,1,100,5000,180
4168,210,36,122,158,1,100,5000,180
4169,210,72,188,260,1,100,5000,180
4170,210,30,122,152,1,100,5000,180
4171,210,42,143,185,1,100,5000,180
4172,210,52,82,134,1,100,5000,180
4173,210,20,139,159,1,100,5000,180
4174,210,49,111,160,1,100,5000,180
4175,210,12,47,59,1,100,5000,180
4176,210,48,145,193,1,100,5000,180
4177,210,0,0,0,1,100,5000,180
4178,210,35,142,177,1,100,5000,180
4179,210,14,157,171,1,100,5000,180
4180,210,24,76,100,1,100,5000,180
4181,210,20,177,197,1,100,5000,180
4182,210,50,164,214,1,100,5000,180
4183,210,4,56,60,1,100,5000,180
4184,210,36,146,182,1,100,5000,180
4185,210,19,101,120,1,100,5000,180
4186,210,31,203,234,1,100,5000,180
4187,210,43,100,143,1,100,5000,180
4188,210,42,126,168,1,100,5000,180
4189,210,12,47,59,1,100,5000,180
4190,210,45,92,137,1,100,5000,180
4191,210,30,70,100,1,100,5000,180
4192,210,36,136,172,1,100,5000,180
4193,210,10,43,53,1,100,5000,180
4194,210,9,39,48,1,100,5000,180
4195,210,72,171,243,1,100,5000,180
4196,210,30,234,264,1,100,5000,180
4197,210,37,137,174,1,100,5000,180
4198,210,42,191,233,1,100,5000,180
4199,210,36,106,142,1,100,5000,180
4200,210,69,175,244,1,100,5000,180
4201,210,95,232,327,1,100,5000,180
4202,210,71,246,317,1,100,5000,180
4203,210,49,200,249,1,100,5000,180
4204,210,8,114,122,1,100,5000,180
4205,210,16,93,109,1,100,5000,180
4206,210,56,180,236,1,100,5000,180
4207,210,47,168,215,1,100,5000,180
4208,210,59,252,311,1,100,5000,180
4209,210,110,245,355,1,100,5000,180
4210,210,53,132,185,1,100,5000,180
4211,210,9,83,92,1,100,5000,180
4212,210,19,56,75,1,100,5000,180
4213,210,15,134,149,1,100,5000,180
4214,210,31,116,147,1,100,5000,180
4215,210,30,101,131,1,100,5000,180
4216,210,24,112,136,1,100,5000,180
4217,210,25,104,129,1,100,5000,180
4218,210,54,161,215,1,100,5000,180
4219,210,22,38,60,1,100,5000,180
4220,210,56,276,332,1,100,5000,180
4221,210,18,148,166,1,100,5000,180
4222,210,38,74,112,1,100,5000,180
4223,210,11,112,123,1,100,5000,180
4224,210,36,121,157,1,100,5000,180
4225,210,37,109,146,1,100,5000,180
4226,210,42,129,171,1,100,5000,180
4227,210,41,129,170,1,100,5000,180
4228,210,49,131,180,1,100,5000,180
4229,210,28,168,196,1,100,5000,180
4230,210,42,52,94,1,100,5000,180
4231,210,17,72,89,1,100,5000,180
4232,210,62,125,187,1,100,5000,180
4233,210,68,206,274,1,100,5000,180
4234,210,29,185,214,1,100,5000,180
4235,210,5,89,94,1,100,5000,180
4236,210,2,16,18,1,100,5000,180
4237,210,30,117,147,1,100,5000,180
4238,210,20,113,133,1,100,5000,180
4239,210,37,196,233,1,100,5000,180
4240,210,18,40,58,1,100,5000,180
4241,210,21,76,97,1,100,5000,180
4242,210,10,35,45,1,100,5000,180
4243,210,10,179,189,1,100,5000,180
4244,210,91,181,272,1,100,5000,180
4245,210,20,73,93,1,100,5000,180
4246,210,7,13,20,1,100,5000,180
4247,210,52,257,309,1,100,5000,180
4248,210,40,114,154,1,100,5000,180
4249,210,11,178,189,1,100,5000,180
4250,210,10,62,72,1,100,5000,180
4251,240,5,73,78,1,100,5000,180
4252,240,14,34,48,1,100,5000,180
4253,240,22,93,115,1,100,5000,180
4254,240,9,38,47,1,100,5000,180
4255,240,15,69,84,1,100,5000,180
4256,240,9,20,29,1,100,5000,180
4257,240,11,33,44,1,100,5000,180
4258,240,3,12,15,1,100,5000,180
4259,240,10,57,67,1,100,5000,180
4260,240,13,23,36,1,100,5000,180
4261,240,15,19,34,1,100,5000,180
4262,240,5,63,68,1,100,5000,180
4263,240,25,51,76,1,100,5000,180
4264,240,3,51,54,1,100,5000,180
4265,240,8,35,43,1,100,5000,180
4266,240,27,105,132,1,100,5000,180
4267,240,21,132,153,1,100,5000,180
4268,240,15,221,236,1,100,5000,180
4269,240,13,68,81,1,100,5000,180
4270,240,26,177,203,1,100,5000,180
4271,240,18,108,126,1,100,5000,180
4272,240,95,130,225,1,100,5000,180
4273,240,19,112,131,1,100,5000,180
4274,240,11,48,59,1,100,5000,180
4275,240,19,117,136,1,100,5000,180
4276,240,4,56,60,1,100,5000,180
4277,240,8,66,74,1,100,5000,180
4278,240,33,117,150,1,100,5000,180
4279,240,24,71,95,1,100,5000,180
4280,240,11,20,31,1,100,5000,180
4281,240,14,20,34,1,100,5000,180
4282,240,14,143,157,1,100,5000,180
4283,240,2,24,26,1,100,5000,180
4284,240,23,36,59,1,100,5000,180
4285,240,22,68,90,1,100,5000,180
4286,240,3,12,15,1,100,5000,180
4287,240,13,47,60,1,100,5000,180
4288,240,32,65,97,1,100,5000,180
4289,240,10,26,36,1,100,5000,180
4290,240,29,66,95,1,100,5000,180
4291,240,6,10,16,1,100,5000,180
4292,240,4,40,44,1,100,5000,180
4293,240,2,48,50,1,100,5000,180
4294,240,26,60,86,1,100,5000,180
4295,240,9,72,81,1,100,5000,180
4296,240,4,24,28,1,100,5000,180
4297,240,22,73,95,1,100,5000,180
4298,240,7,36,43,1,100,5000,180
4299,240,14,64,78,1,100,5000,180
4300,240,6,26,32,1,100,5000,180
4301,240,2,13,15,1,100,5000,180
4302,240,3,32,35,1,100,5000,180
4303,240,0,0,0,1,100,5000,180
4304,240,26,64,90,1,100,5000,180
4305,240,34,131,165,1,100,5000,180
4306,240,26,162,188,1,100,5000,180
4307,240,102,244,346,1,100,5000,180
4308,240,64,210,274,1,100,5000,180
4309,240,131,238,369,1,100,5000,180
4310,240,31,120,151,1,100,5000,180
4311,240,95,187,282,1,100,5000,180
4312,240,29,144,173,1,100,5000,180
4313,240,56,213,269,1,100,5000,180
4314,240,31,50,81,1,100,5000,180
4315,240,42,38,80,1,100,5000,180
4316,240,11,46,57,1,100,5000,180
4317,240,24,94,118,1,100,5000,180
4318,240,24,58,82,1,100,5000,180
4319,240,3,46,49,1,100,5000,180
4320,240,14,129,143,1,100,5000,180
4321,240,11,69,80,1,100,5000,180
4322,240,11,36,47,1,100,5000,180
4323,240,8,37,45,1,100,5000,180
4324,240,12,74,86,1,100,5000,180
4325,240,63,156,219,1,100,5000,180
4326,240,23,108,131,1,100,5000,180
4327,240,9,154,163,1,100,5000,180
4328,240,25,122,147,1,100,5000,180
4329,240,33,245,278,1,100,5000,180
4330,240,44,158,202,1,100,5000,180
4331,240,19,114,133,1,100,5000,180
4332,240,15,79,94,1,100,5000,180
4333,240,33,76,109,1,100,5000,180
4334,240,52,217,269,1,100,5000,180
4335,240,24,149,173,1,100,5000,180
4336,240,34,175,209,1,100,5000,180
4337,240,0,0,0,1,100,5000,180
4338,240,0,0,0,1,100,5000,180
4339,240,9,12,21,1,100,5000,180
4340,240,14,22,36,1,100,5000,180
4341,240,22,60,82,1,100,5000,180
4342,240,36,59,95,1,100,5000,180
4343,240,35,52,87,1,100,5000,180
4344,240,18,38,56,1,100,5000,180
4345,240,6,16,22,1,100,5000,180
4346,240,6,7,13,1,100,5000,180
4347,240,7,10,17,1,100,5000,180
4348,240,5,14,19,1,100,5000,180
4349,240,6,22,28,1,100,5000,180
4350,240,22,46,68,1,100,5000,180
4351,240,21,123,144,1,100,5000,180
4352,240,24,101,125,1,100,5000,180
4353,240,12,24,36,1,100,5000,180
4354,240,11,65,76,1,100,5000,180
4355,240,2,29,31,1,100,5000,180
4356,240,0,0,0,1,100,5000,180
4357,240,16,43,59,1,100,5000,180
4358,240,6,48,54,1,100,5000,180
4359,240,9,24,33,1,100,5000,180
4360,240,21,71,92,1,100,5000,180
4361,240,12,78,90,1,100,5000,180
4362,240,8,14,22,1,100,5000,180
4363,240,1,21,22,1,100,5000,180
4364,240,6,129,135,1,100,5000,180
4365,240,27,98,125,1,100,5000,180
4366,240,20,69,89,1,100,5000,180
4367,240,4,47,51,1,100,5000,180
4368,240,0,0,0,1,100,5000,180
4369,240,5,18,23,1,100,5000,180
4370,240,21,94,115,1,100,5000,180
4371,240,0,0,0,1,100,5000,180
4372,240,0,0,0,1,100,5000,180
4373,240,0,0,0,1,100,5000,180
4374,240,29,96,125,1,100,5000,180
4375,240,2,27,29,1,100,5000,180
4376,240,12,18,30,1,100,5000,180
4377,240,8,33,41,1,100,5000,180
4378,240,7,22,29,1,100,5000,180
4379,240,16,20,36,1,100,5000,180
4380,240,14,21,35,1,100,5000,180
4381,240,15,24,39,1,100,5000,180
4382,240,28,62,90,1,100,5000,180
4383,240,12,16,28,1,100,5000,180
4384,240,13,44,57,1,100,5000,180
4385,240,7,17,24,1,100,5000,180
4386,240,8,30,38,1,100,5000,180
4387,240,4,5,9,1,100,5000,180