Unnamed: 0,time_index,RNA_nuc,RNA_cyto,RNA_total,rep,conc
0,0,24,41,65,1,0.0
1,0,22,45,67,1,0.0
2,0,47,52,99,1,0.0
3,0,22,30,52,1,0.0
4,0,12,19,31,1,0.0
5,0,25,58,83,1,0.0
6,0,19,24,43,1,0.0
7,0,10,24,34,1,0.0
8,0,5,9,14,1,0.0
9,0,28,33,61,1,0.0
10,0,45,89,134,1,0.0
11,0,8,32,40,1,0.0
12,0,27,35,62,1,0.0
13,0,29,21,50,1,0.0
14,0,7,10,17,1,0.0
15,0,11,28,39,1,0.0
16,0,16,50,66,1,0.0
17,0,27,41,68,1,0.0
18,0,37,24,61,1,0.0
19,0,35,49,84,1,0.0
20,0,9,17,26,1,0.0
21,0,26,25,51,1,0.0
22,0,6,17,23,1,0.0
23,0,28,39,67,1,0.0
24,0,17,42,59,1,0.0
25,0,33,49,82,1,0.0
26,0,7,6,13,1,0.0
27,0,28,50,78,1,0.0
28,0,14,20,34,1,0.0
29,0,21,54,75,1,0.0
30,0,33,38,71,1,0.0
31,0,66,65,131,1,0.0
32,0,35,85,120,1,0.0
33,0,30,28,58,1,0.0
34,0,13,12,25,1,0.0
35,0,19,29,48,1,0.0
36,0,21,23,44,1,0.0
37,0,18,15,33,1,0.0
38,0,25,20,45,1,0.0
39,0,30,33,63,1,0.0
40,0,13,13,26,1,0.0
41,0,5,22,27,1,0.0
42,0,4,27,31,1,0.0
43,0,24,57,81,1,0.0
44,0,13,11,24,1,0.0
45,0,13,35,48,1,0.0
46,0,26,33,59,1,0.0
47,0,31,24,55,1,0.0
48,0,33,58,91,1,0.0
49,0,17,15,32,1,0.0
50,0,41,72,113,1,0.0
51,0,52,53,105,1,0.0
52,0,26,54,80,1,0.0
53,0,35,51,86,1,0.0
54,0,20,60,80,1,0.0
55,0,9,18,27,1,0.0
56,0,14,33,47,1,0.0
57,0,13,10,23,1,0.0
58,0,42,92,134,1,0.0
59,0,13,15,28,1,0.0
60,0,6,28,34,1,0.0
61,0,16,25,41,1,0.0
62,0,20,41,61,1,0.0
63,0,65,53,118,1,0.0
64,0,16,35,51,1,0.0
65,0,10,10,20,1,0.0
66,0,17,15,32,1,0.0
67,0,18,33,51,1,0.0
68,0,28,63,91,1,0.0
69,0,29,23,52,1,0.0
70,0,20,14,34,1,0.0
71,0,8,18,26,1,0.0
72,0,24,51,75,1,0.0
73,0,4,8,12,1,0.0
74,0,5,2,7,1,0.0
75,0,4,12,16,1,0.0
76,0,46,31,77,1,0.0
77,0,17,25,42,1,0.0
78,0,50,28,78,1,0.0
79,0,25,29,54,1,0.0
80,0,19,52,71,1,0.0
81,0,13,9,22,1,0.0
82,0,16,17,33,1,0.0
83,0,14,45,59,1,0.0
84,0,2,12,14,1,0.0
85,0,14,20,34,1,0.0
86,0,26,88,114,1,0.0
87,0,21,29,50,1,0.0
88,0,0,0,0,1,0.0
89,0,2,6,8,1,0.0
90,0,25,29,54,1,0.0
91,0,62,114,176,1,0.0
92,0,37,45,82,1,0.0
93,0,31,68,99,1,0.0
94,0,43,61,104,1,0.0
95,0,27,50,77,1,0.0
96,0,96,102,198,1,0.0
97,0,27,43,70,1,0.0
98,0,23,39,62,1,0.0
99,0,45,103,148,1,0.0
100,0,26,21,47,1,0.0
101,0,35,53,88,1,0.0
102,0,9,5,14,1,0.0
103,0,14,34,48,1,0.0
104,0,10,25,35,1,0.0
105,0,6,17,23,1,0.0
106,0,3,8,11,1,0.0
107,0,33,45,78,1,0.0
108,0,32,27,59,1,0.0
109,0,16,18,34,1,0.0
110,0,54,80,134,1,0.0
111,0,32,68,100,1,0.0
112,0,43,64,107,1,0.0
113,0,24,40,64,1,0.0
114,0,12,26,38,1,0.0
115,0,15,13,28,1,0.0
116,0,36,34,70,1,0.0
117,0,12,19,31,1,0.0
118,0,57,127,184,1,0.0
119,0,4,6,10,1,0.0
120,0,3,3,6,1,0.0
121,0,23,32,55,1,0.0
122,0,27,50,77,1,0.0
123,0,17,28,45,1,0.0
124,0,39,77,116,1,0.0
125,0,12,15,27,1,0.0
126,0,34,46,80,1,0.0
127,0,29,32,61,1,0.0
128,0,57,85,142,1,0.0
129,0,16,25,41,1,0.0
130,0,21,35,56,1,0.0
131,0,12,31,43,1,0.0
132,0,13,10,23,1,0.0
133,0,19,23,42,1,0.0
134,0,7,22,29,1,0.0
135,0,6,2,8,1,0.0
136,0,8,22,30,1,0.0
137,0,34,94,128,1,0.0
138,0,40,101,141,1,0.0
139,0,50,101,151,1,0.0
140,0,49,39,88,1,0.0
141,0,43,81,124,1,0.0
142,0,50,55,105,1,0.0
143,0,15,21,36,1,0.0
144,0,38,55,93,1,0.0
145,0,57,88,145,1,0.0
146,0,4,7,11,1,0.0
147,0,17,25,42,1,0.0
148,0,2,5,7,1,0.0
149,0,5,3,8,1,0.0
150,0,26,42,68,1,0.0
151,0,20,24,44,1,0.0
152,0,28,42,70,1,0.0
153,0,3,6,9,1,0.0
154,0,15,29,44,1,0.0
155,0,30,67,97,1,0.0
156,0,28,13,41,1,0.0
157,0,18,26,44,1,0.0
158,0,29,42,71,1,0.0
159,0,23,60,83,1,0.0
160,0,12,21,33,1,0.0
161,0,12,17,29,1,0.0
162,0,31,27,58,1,0.0
163,0,15,32,47,1,0.0
164,0,7,21,28,1,0.0
165,0,19,37,56,1,0.0
166,0,34,36,70,1,0.0
167,0,35,75,110,1,0.0
168,0,17,31,48,1,0.0
169,0,32,47,79,1,0.0
170,0,27,41,68,1,0.0
171,0,80,102,182,1,0.0
172,0,24,43,67,1,0.0
173,0,27,55,82,1,0.0
174,0,65,116,181,1,0.0
175,0,11,32,43,1,0.0
176,0,10,24,34,1,0.0
177,0,18,15,33,1,0.0
178,0,10,23,33,1,0.0
179,0,17,39,56,1,0.0
180,0,29,33,62,1,0.0
181,0,14,47,61,1,0.0
182,0,20,28,48,1,0.0
183,0,5,8,13,1,0.0
184,0,12,24,36,1,0.0
185,0,6,14,20,1,0.0
186,0,3,1,4,1,0.0
187,0,11,17,28,1,0.0
188,0,4,3,7,1,0.0
189,0,27,39,66,1,0.0
190,0,15,23,38,1,0.0
191,0,23,29,52,1,0.0
192,0,11,18,29,1,0.0
193,0,16,18,34,1,0.0
194,0,29,61,90,1,0.0
195,0,14,37,51,1,0.0
196,0,20,29,49,1,0.0
197,0,31,11,42,1,0.0
198,0,10,13,23,1,0.0
199,0,7,11,18,1,0.0
200,0,27,27,54,1,0.0
201,0,16,20,36,1,0.0
202,0,29,33,62,1,0.0
203,0,20,30,50,1,0.0
204,0,4,7,11,1,0.0
205,0,25,39,64,1,0.0
206,0,31,22,53,1,0.0
207,0,39,65,104,1,0.0
208,0,25,46,71,1,0.0
209,0,43,48,91,1,0.0
210,0,17,29,46,1,0.0
211,0,16,36,52,1,0.0
212,0,38,90,128,1,0.0
213,0,37,74,111,1,0.0
214,0,12,33,45,1,0.0
215,0,18,19,37,1,0.0
216,0,13,29,42,1,0.0
217,0,8,8,16,1,0.0
218,0,14,8,22,1,0.0
219,0,21,20,41,1,0.0
220,0,28,47,75,1,0.0
221,0,41,58,99,1,0.0
222,0,55,74,129,1,0.0
223,0,20,43,63,1,0.0
224,0,16,51,67,1,0.0
225,0,40,59,99,1,0.0
226,0,20,39,59,1,0.0
227,0,4,11,15,1,0.0
228,0,0,0,0,1,0.0
229,0,2,7,9,1,0.0
230,0,4,6,10,1,0.0
231,0,59,79,138,1,0.0
232,0,26,31,57,1,0.0
233,0,13,40,53,1,0.0
234,0,12,21,33,1,0.0
235,0,19,13,32,1,0.0
236,0,16,26,42,1,0.0
237,0,6,12,18,1,0.0
238,0,9,15,24,1,0.0
239,0,21,35,56,1,0.0
240,0,21,33,54,1,0.0
241,0,12,16,28,1,0.0
242,0,5,1,6,1,0.0
243,0,4,8,12,1,0.0
244,0,27,52,79,1,0.0
245,0,26,34,60,1,0.0
246,0,33,34,67,1,0.0
247,0,27,27,54,1,0.0
248,0,17,25,42,1,0.0
249,0,14,14,28,1,0.0
250,0,6,35,41,1,0.0
251,0,31,40,71,1,0.0
252,0,12,30,42,1,0.0
253,0,22,29,51,1,0.0
254,0,12,9,21,1,0.0
255,0,43,65,108,1,0.0
256,0,16,26,42,1,0.0
257,0,16,36,52,1,0.0
258,0,13,24,37,1,0.0
259,0,9,19,28,1,0.0
260,0,4,6,10,1,0.0
261,0,7,27,34,1,0.0
262,0,23,39,62,1,0.0
263,0,14,6,20,1,0.0
264,0,20,35,55,1,0.0
265,0,45,49,94,1,0.0
266,0,5,19,24,1,0.0
267,0,13,17,30,1,0.0
268,0,13,23,36,1,0.0
269,0,7,12,19,1,0.0
270,0,10,15,25,1,0.0
271,0,8,13,21,1,0.0
272,0,1,9,10,1,0.0
273,0,43,39,82,1,0.0
274,0,28,62,90,1,0.0
275,0,8,13,21,1,0.0
276,0,26,29,55,1,0.0
277,0,26,34,60,1,0.0
278,0,23,34,57,1,0.0
279,0,11,8,19,1,0.0
280,0,37,34,71,1,0.0
281,0,15,41,56,1,0.0
282,0,41,50,91,1,0.0
283,0,11,14,25,1,0.0
284,0,16,37,53,1,0.0
285,0,37,69,106,1,0.0
286,0,22,34,56,1,0.0
287,0,4,68,72,1,0.0
288,0,10,14,24,1,0.0
289,0,4,6,10,1,0.0
290,0,28,50,78,1,0.0
291,0,18,24,42,1,0.0
292,0,16,34,50,1,0.0
293,0,25,45,70,1,0.0
294,0,41,65,106,1,0.0
295,0,17,28,45,1,0.0
296,0,26,23,49,1,0.0
297,0,59,66,125,1,0.0
298,0,26,40,66,1,0.0
299,0,7,16,23,1,0.0
300,0,41,66,107,1,0.0
301,0,24,17,41,1,0.0
302,0,7,18,25,1,0.0
303,0,6,26,32,1,0.0
304,0,9,2,11,1,0.0
305,0,26,22,48,1,0.0
306,0,40,89,129,1,0.0
307,0,1,1,2,1,0.0
308,0,28,37,65,1,0.0
309,0,14,17,31,1,0.0
310,0,11,18,29,1,0.0
311,0,27,47,74,1,0.0
312,0,34,53,87,1,0.0
313,0,14,23,37,1,0.0
314,0,23,25,48,1,0.0
315,0,8,20,28,1,0.0
316,0,14,23,37,1,0.0
317,0,3,4,7,1,0.0
318,0,21,55,76,1,0.0
319,0,18,50,68,1,0.0
320,0,19,30,49,1,0.0
321,0,16,5,21,1,0.0
322,0,12,22,34,1,0.0
323,0,12,36,48,1,0.0
324,0,24,24,48,1,0.0
325,0,14,32,46,1,0.0
326,0,46,43,89,1,0.0
327,0,27,38,65,1,0.0
328,0,37,56,93,1,0.0
329,0,33,57,90,1,0.0
330,0,20,30,50,1,0.0
331,0,30,35,65,1,0.0
332,0,80,119,199,1,0.0
333,0,24,35,59,1,0.0
334,0,57,92,149,1,0.0
335,0,29,46,75,1,0.0
336,0,13,17,30,1,0.0
337,0,5,16,21,1,0.0
338,0,0,4,4,1,0.0
339,0,24,41,65,1,0.0
340,0,7,13,20,1,0.0
341,0,15,34,49,1,0.0
342,0,4,25,29,1,0.0
343,0,0,6,6,1,0.0
344,0,18,36,54,1,0.0
345,0,20,22,42,1,0.0
346,0,24,41,65,1,0.0
347,0,13,18,31,1,0.0
348,0,15,39,54,1,0.0
349,0,53,83,136,1,0.0
350,0,39,76,115,1,0.0
351,0,19,33,52,1,0.0
352,0,26,36,62,1,0.0
353,0,7,2,9,1,0.0
354,0,12,36,48,1,0.0
355,0,4,3,7,1,0.0
356,0,19,29,48,1,0.0
357,0,9,15,24,1,0.0
358,0,2,21,23,1,0.0
359,0,19,26,45,1,0.0
360,0,27,26,53,1,0.0
361,0,23,58,81,1,0.0
362,0,15,32,47,1,0.0
363,0,8,19,27,1,0.0
364,0,13,22,35,1,0.0
365,0,25,12,37,1,0.0
366,0,21,28,49,1,0.0
367,0,15,24,39,1,0.0
368,0,5,4,9,1,0.0
369,0,7,19,26,1,0.0
370,0,0,0,0,1,0.0
371,0,15,21,36,1,0.0
372,0,3,4,7,1,0.0
373,0,27,21,48,1,0.0
374,0,26,42,68,1,0.0
375,0,50,70,120,1,0.0
376,0,29,54,83,1,0.0
377,0,20,349,369,1,0.0
378,0,15,29,44,1,0.0
379,0,24,34,58,1,0.0
380,0,11,14,25,1,0.0
381,0,19,28,47,1,0.0
382,0,10,22,32,1,0.0
383,0,5,27,32,1,0.0
384,0,29,49,78,1,0.0
385,0,28,30,58,1,0.0
386,0,17,19,36,1,0.0
387,0,53,67,120,1,0.0
388,0,15,17,32,1,0.0
389,0,26,39,65,1,0.0
390,0,3,15,18,1,0.0
391,0,26,16,42,1,0.0
392,0,19,40,59,1,0.0
393,0,17,23,40,1,0.0
394,0,8,3,11,1,0.0
395,0,3,7,10,1,0.0
396,0,13,24,37,1,0.0
397,0,18,30,48,1,0.0
398,0,11,22,33,1,0.0
399,0,2,8,10,1,0.0
400,0,2,3,5,1,0.0
401,0,13,5,18,1,0.0
402,0,1,5,6,1,0.0
403,0,38,35,73,1,0.0
404,0,20,43,63,1,0.0
405,0,47,61,108,1,0.0
406,0,18,20,38,1,0.0
407,0,38,33,71,1,0.0
408,0,28,34,62,1,0.0
409,0,10,20,30,1,0.0
410,0,3,5,8,1,0.0
411,0,57,83,140,1,0.0
412,0,38,42,80,1,0.0
413,0,8,18,26,1,0.0
414,0,5,20,25,1,0.0
415,0,9,13,22,1,0.0
416,0,18,19,37,1,0.0
417,0,39,33,72,1,0.0
418,0,1,2,3,1,0.0
419,0,15,51,66,1,0.0
420,0,8,6,14,1,0.0
421,0,14,22,36,1,0.0
422,0,7,22,29,1,0.0
423,0,38,78,116,1,0.0
424,0,14,21,35,1,0.0
425,0,58,57,115,1,0.0
426,0,6,15,21,1,0.0
427,0,17,28,45,1,0.0
428,0,13,24,37,1,0.0
429,0,45,60,105,1,0.0
430,0,38,65,103,1,0.0
431,0,10,25,35,1,0.0
432,30,15,22,37,1,0.3
433,30,18,35,53,1,0.3
434,30,12,11,23,1,0.3
435,30,26,56,82,1,0.3
436,30,38,48,86,1,0.3
437,30,24,43,67,1,0.3
438,30,13,10,23,1,0.3
439,30,102,137,239,1,0.3
440,30,25,39,64,1,0.3
441,30,14,45,59,1,0.3
442,30,2,3,5,1,0.3
443,30,2,6,8,1,0.3
444,30,20,43,63,1,0.3
445,30,14,17,31,1,0.3
446,30,19,21,40,1,0.3
447,30,13,19,32,1,0.3
448,30,67,62,129,1,0.3
449,30,5,18,23,1,0.3
450,30,21,47,68,1,0.3
451,30,51,54,105,1,0.3
452,30,9,19,28,1,0.3
453,30,48,25,73,1,0.3
454,30,1,6,7,1,0.3
455,30,5,10,15,1,0.3
456,30,7,10,17,1,0.3
457,30,9,7,16,1,0.3
458,30,1,2,3,1,0.3
459,30,37,39,76,1,0.3
460,30,21,27,48,1,0.3
461,30,17,26,43,1,0.3
462,30,42,43,85,1,0.3
463,30,4,11,15,1,0.3
464,30,74,129,203,1,0.3
465,30,26,34,60,1,0.3
466,30,54,73,127,1,0.3
467,30,16,26,42,1,0.3
468,30,20,45,65,1,0.3
469,30,5,10,15,1,0.3
470,30,12,24,36,1,0.3
471,30,28,19,47,1,0.3
472,30,11,11,22,1,0.3
473,30,5,7,12,1,0.3
474,30,7,4,11,1,0.3
475,30,3,13,16,1,0.3
476,30,2,2,4,1,0.3
477,30,16,10,26,1,0.3
478,30,64,94,158,1,0.3
479,30,25,50,75,1,0.3
480,30,12,14,26,1,0.3
481,30,119,181,300,1,0.3
482,30,55,105,160,1,0.3
483,30,20,29,49,1,0.3
484,30,18,40,58,1,0.3
485,30,16,29,45,1,0.3
486,30,29,56,85,1,0.3
487,30,2,52,54,1,0.3
488,30,1,4,5,1,0.3
489,30,7,4,11,1,0.3
490,30,0,0,0,1,0.3
491,30,5,8,13,1,0.3
492,30,19,32,51,1,0.3
493,30,26,58,84,1,0.3
494,30,18,21,39,1,0.3
495,30,30,45,75,1,0.3
496,30,23,56,79,1,0.3
497,30,17,24,41,1,0.3
498,30,32,67,99,1,0.3
499,30,12,17,29,1,0.3
500,30,18,25,43,1,0.3
501,30,15,11,26,1,0.3
502,30,10,11,21,1,0.3
503,30,16,20,36,1,0.3
504,30,3,16,19,1,0.3
505,30,5,40,45,1,0.3
506,30,15,22,37,1,0.3
507,30,7,19,26,1,0.3
508,30,25,84,109,1,0.3
509,30,22,48,70,1,0.3
510,30,14,23,37,1,0.3
511,30,15,31,46,1,0.3
512,30,15,26,41,1,0.3
513,30,5,11,16,1,0.3
514,30,3,8,11,1,0.3
515,30,11,11,22,1,0.3
516,30,31,46,77,1,0.3
517,30,17,19,36,1,0.3
518,30,1,13,14,1,0.3
519,30,19,37,56,1,0.3
520,30,12,20,32,1,0.3
521,30,49,109,158,1,0.3
522,30,70,64,134,1,0.3
523,30,29,49,78,1,0.3
524,30,19,27,46,1,0.3
525,30,36,47,83,1,0.3
526,30,13,10,23,1,0.3
527,30,12,43,55,1,0.3
528,30,27,26,53,1,0.3
529,30,16,34,50,1,0.3
530,30,13,33,46,1,0.3
531,30,5,23,28,1,0.3
532,30,25,31,56,1,0.3
533,30,16,36,52,1,0.3
534,30,15,22,37,1,0.3
535,30,8,20,28,1,0.3
536,30,4,13,17,1,0.3
537,30,21,41,62,1,0.3
538,30,66,55,121,1,0.3
539,30,19,22,41,1,0.3
540,30,15,28,43,1,0.3
541,30,26,79,105,1,0.3
542,30,14,33,47,1,0.3
543,30,10,37,47,1,0.3
544,30,34,57,91,1,0.3
545,30,16,14,30,1,0.3
546,30,8,27,35,1,0.3
547,30,20,43,63,1,0.3
548,30,3,22,25,1,0.3
549,30,23,27,50,1,0.3
550,30,5,12,17,1,0.3
551,30,6,12,18,1,0.3
552,30,10,11,21,1,0.3
553,30,8,29,37,1,0.3
554,30,20,49,69,1,0.3
555,30,8,22,30,1,0.3
556,30,17,27,44,1,0.3
557,30,20,55,75,1,0.3
558,30,72,107,179,1,0.3
559,30,29,44,73,1,0.3
560,30,28,32,60,1,0.3
561,30,24,20,44,1,0.3
562,30,18,33,51,1,0.3
563,30,12,8,20,1,0.3
564,30,9,14,23,1,0.3
565,30,15,10,25,1,0.3
566,30,3,6,9,1,0.3
567,30,4,9,13,1,0.3
568,30,14,26,40,1,0.3
569,30,3,3,6,1,0.3
570,30,6,16,22,1,0.3
571,30,6,6,12,1,0.3
572,30,20,53,73,1,0.3
573,30,15,32,47,1,0.3
574,30,7,14,21,1,0.3
575,30,11,13,24,1,0.3
576,30,7,18,25,1,0.3
577,30,23,50,73,1,0.3
578,30,14,15,29,1,0.3
579,30,12,17,29,1,0.3
580,30,9,22,31,1,0.3
581,30,11,17,28,1,0.3
582,30,4,13,17,1,0.3
583,30,8,3,11,1,0.3
584,30,0,4,4,1,0.3
585,30,5,29,34,1,0.3
586,30,6,7,13,1,0.3
587,30,4,19,23,1,0.3
588,30,0,0,0,1,0.3
589,30,9,15,24,1,0.3
590,30,3,3,6,1,0.3
591,30,59,101,160,1,0.3
592,30,17,29,46,1,0.3
593,30,10,35,45,1,0.3
594,30,43,78,121,1,0.3
595,30,32,58,90,1,0.3
596,30,14,29,43,1,0.3
597,30,28,70,98,1,0.3
598,30,22,22,44,1,0.3
599,30,7,18,25,1,0.3
600,30,8,11,19,1,0.3
601,30,18,24,42,1,0.3
602,30,6,25,31,1,0.3
603,30,7,21,28,1,0.3
604,30,0,0,0,1,0.3
605,30,12,6,18,1,0.3
606,30,19,41,60,1,0.3
607,30,56,79,135,1,0.3
608,30,27,47,74,1,0.3
609,30,89,119,208,1,0.3
610,30,16,21,37,1,0.3
611,30,32,59,91,1,0.3
612,30,4,13,17,1,0.3
613,30,25,61,86,1,0.3
614,30,11,29,40,1,0.3
615,30,10,21,31,1,0.3
616,30,23,12,35,1,0.3
617,30,25,44,69,1,0.3
618,30,18,32,50,1,0.3
619,30,9,27,36,1,0.3
620,30,20,41,61,1,0.3
621,30,34,62,96,1,0.3
622,30,14,16,30,1,0.3
623,30,17,22,39,1,0.3
624,30,41,53,94,1,0.3
625,30,17,43,60,1,0.3
626,30,19,22,41,1,0.3
627,30,8,36,44,1,0.3
628,30,6,8,14,1,0.3
629,30,9,26,35,1,0.3
630,30,4,12,16,1,0.3
631,30,3,10,13,1,0.3
632,30,8,33,41,1,0.3
633,30,3,2,5,1,0.3
634,30,24,50,74,1,0.3
635,30,24,47,71,1,0.3
636,30,42,67,109,1,0.3
637,30,15,33,48,1,0.3
638,30,20,28,48,1,0.3
639,30,26,36,62,1,0.3
640,30,45,76,121,1,0.3
641,30,42,62,104,1,0.3
642,30,13,43,56,1,0.3
643,30,11,12,23,1,0.3
644,30,38,52,90,1,0.3
645,30,4,4,8,1,0.3
646,30,12,13,25,1,0.3
647,30,11,30,41,1,0.3
648,30,11,14,25,1,0.3
649,30,1,1,2,1,0.3
650,30,0,0,0,1,0.3
651,30,1,3,4,1,0.3
652,30,4,22,26,1,0.3
653,30,5,7,12,1,0.3
654,30,11,20,31,1,0.3
655,30,9,38,47,1,0.3
656,30,19,28,47,1,0.3
657,30,15,39,54,1,0.3
658,30,20,44,64,1,0.3
659,30,8,14,22,1,0.3
660,30,5,13,18,1,0.3
661,30,17,37,54,1,0.3
662,30,15,17,32,1,0.3
663,30,3,12,15,1,0.3
664,30,6,15,21,1,0.3
665,30,11,32,43,1,0.3
666,30,25,38,63,1,0.3
667,30,53,52,105,1,0.3
668,30,24,42,66,1,0.3
669,30,42,33,75,1,0.3
670,30,34,64,98,1,0.3
671,30,25,46,71,1,0.3
672,30,5,14,19,1,0.3
673,30,26,46,72,1,0.3
674,30,36,54,90,1,0.3
675,30,54,80,134,1,0.3
676,30,5,6,11,1,0.3
677,30,20,13,33,1,0.3
678,30,65,51,116,1,0.3
679,30,17,20,37,1,0.3
680,30,13,17,30,1,0.3
681,30,17,44,61,1,0.3
682,30,67,87,154,1,0.3
683,30,37,16,53,1,0.3
684,30,49,49,98,1,0.3
685,30,10,22,32,1,0.3
686,30,68,103,171,1,0.3
687,30,21,26,47,1,0.3
688,30,15,19,34,1,0.3
689,30,12,21,33,1,0.3
690,30,21,39,60,1,0.3
691,30,0,0,0,1,0.3
692,30,22,25,47,1,0.3
693,30,49,66,115,1,0.3
694,30,7,14,21,1,0.3
695,30,2,2,4,1,0.3
696,30,8,5,13,1,0.3
697,30,32,49,81,1,0.3
698,30,39,65,104,1,0.3
699,30,27,57,84,1,0.3
700,30,21,41,62,1,0.3
701,30,21,67,88,1,0.3
702,30,27,19,46,1,0.3
703,30,48,116,164,1,0.3
704,30,70,151,221,1,0.3
705,30,11,29,40,1,0.3
706,30,60,141,201,1,0.3
707,30,10,28,38,1,0.3
708,30,46,42,88,1,0.3
709,30,34,57,91,1,0.3
710,30,48,35,83,1,0.3
711,30,4,20,24,1,0.3
712,30,14,17,31,1,0.3
713,30,64,88,152,1,0.3
714,30,2,15,17,1,0.3
715,30,14,23,37,1,0.3
716,30,43,81,124,1,0.3
717,30,19,42,61,1,0.3
718,30,30,44,74,1,0.3
719,30,21,45,66,1,0.3
720,30,56,90,146,1,0.3
721,30,104,87,191,1,0.3
722,30,85,188,273,1,0.3
723,30,15,16,31,1,0.3
724,30,0,6,6,1,0.3
725,30,17,31,48,1,0.3
726,30,15,39,54,1,0.3
727,30,20,39,59,1,0.3
728,30,20,42,62,1,0.3
729,30,6,14,20,1,0.3
730,30,23,36,59,1,0.3
731,30,9,16,25,1,0.3
732,30,34,37,71,1,0.3
733,30,46,56,102,1,0.3
734,30,14,36,50,1,0.3
735,30,11,17,28,1,0.3
736,30,5,13,18,1,0.3
737,30,29,41,70,1,0.3
738,30,27,42,69,1,0.3
739,30,16,36,52,1,0.3
740,30,36,48,84,1,0.3
741,30,18,11,29,1,0.3
742,30,20,49,69,1,0.3
743,30,42,72,114,1,0.3
744,30,33,57,90,1,0.3
745,30,1,18,19,1,0.3
746,30,37,16,53,1,0.3
747,30,5,12,17,1,0.3
748,30,11,9,20,1,0.3
749,30,8,13,21,1,0.3
750,30,14,21,35,1,0.3
751,30,16,13,29,1,0.3
752,30,2,7,9,1,0.3
753,30,2,2,4,1,0.3
754,30,5,2,7,1,0.3
755,30,33,27,60,1,0.3
756,30,64,67,131,1,0.3
757,30,45,58,103,1,0.3
758,30,49,42,91,1,0.3
759,30,14,25,39,1,0.3
760,30,7,25,32,1,0.3
761,30,46,56,102,1,0.3
762,30,6,23,29,1,0.3
763,30,14,39,53,1,0.3
764,30,30,85,115,1,0.3
765,30,2,10,12,1,0.3
766,30,3,8,11,1,0.3
767,30,6,2,8,1,0.3
768,30,25,28,53,1,0.3
769,30,52,50,102,1,0.3
770,30,9,16,25,1,0.3
771,30,36,48,84,1,0.3
772,30,20,44,64,1,0.3
773,30,21,22,43,1,0.3
774,30,19,23,42,1,0.3
775,30,69,69,138,1,0.3
776,30,18,14,32,1,0.3
777,30,28,31,59,1,0.3
778,30,25,43,68,1,0.3
779,30,1,10,11,1,0.3
780,30,5,7,12,1,0.3
781,30,6,5,11,1,0.3
782,30,15,30,45,1,0.3
783,30,23,22,45,1,0.3
784,30,44,84,128,1,0.3
785,30,64,137,201,1,0.3
786,30,57,95,152,1,0.3
787,30,63,155,218,1,0.3
788,30,46,69,115,1,0.3
789,30,42,64,106,1,0.3
790,30,58,87,145,1,0.3
791,30,34,49,83,1,0.3
792,30,36,42,78,1,0.3
793,30,8,12,20,1,0.3
794,30,18,52,70,1,0.3
795,30,59,63,122,1,0.3
796,30,38,58,96,1,0.3
797,30,21,46,67,1,0.3
798,30,52,79,131,1,0.3
799,30,24,47,71,1,0.3
800,30,72,114,186,1,0.3
801,30,31,28,59,1,0.3
802,30,23,26,49,1,0.3
803,30,41,72,113,1,0.3
804,30,36,49,85,1,0.3
805,30,25,29,54,1,0.3
806,30,62,128,190,1,0.3
807,30,4,22,26,1,0.3
808,30,9,16,25,1,0.3
809,30,17,15,32,1,0.3
810,30,17,21,38,1,0.3
811,30,18,19,37,1,0.3
812,30,5,8,13,1,0.3
813,30,12,20,32,1,0.3
814,30,10,12,22,1,0.3
815,30,1,2,3,1,0.3
816,30,44,80,124,1,0.3
817,30,26,41,67,1,0.3
818,30,19,18,37,1,0.3
819,30,99,100,199,1,0.3
820,30,25,38,63,1,0.3
821,30,14,14,28,1,0.3
822,30,45,62,107,1,0.3
823,30,27,24,51,1,0.3
824,30,24,67,91,1,0.3
825,30,25,94,119,1,0.3
826,30,15,29,44,1,0.3
827,30,12,12,24,1,0.3
828,30,8,9,17,1,0.3
829,30,17,24,41,1,0.3
830,30,19,24,43,1,0.3
831,30,130,207,337,1,0.3
832,30,12,25,37,1,0.3
833,30,24,24,48,1,0.3
834,30,22,34,56,1,0.3
835,30,46,47,93,1,0.3
836,30,35,28,63,1,0.3
837,30,55,19,74,1,0.3
838,30,24,44,68,1,0.3
839,30,37,40,77,1,0.3
840,30,24,30,54,1,0.3
841,30,9,34,43,1,0.3
842,30,10,28,38,1,0.3
843,30,8,25,33,1,0.3
844,30,51,58,109,1,0.3
845,30,76,128,204,1,0.3
846,30,84,103,187,1,0.3
847,30,32,64,96,1,0.3
848,30,31,58,89,1,0.3
849,30,82,137,219,1,0.3
850,30,19,40,59,1,0.3
851,30,83,138,221,1,0.3
852,30,58,66,124,1,0.3
853,30,22,45,67,1,0.3
854,30,22,37,59,1,0.3
855,30,62,92,154,1,0.3
856,30,8,16,24,1,0.3
857,30,27,51,78,1,0.3
858,30,101,87,188,1,0.3
859,30,60,89,149,1,0.3
860,30,133,226,359,1,0.3
861,30,46,44,90,1,0.3
862,30,53,45,98,1,0.3
863,30,68,107,175,1,0.3
864,30,75,67,142,1,0.3
865,30,113,89,202,1,0.3
866,30,40,57,97,1,0.3
867,30,120,176,296,1,0.3
868,30,93,92,185,1,0.3
869,30,39,85,124,1,0.3
870,30,27,27,54,1,0.3
871,30,33,68,101,1,0.3
872,30,17,28,45,1,0.3
873,30,36,47,83,1,0.3
874,30,46,59,105,1,0.3
875,30,54,81,135,1,0.3
876,30,30,24,54,1,0.3
877,30,33,45,78,1,0.3
878,30,12,25,37,1,0.3
879,30,34,58,92,1,0.3
880,50,6,12,18,1,0.3
881,50,9,39,48,1,0.3
882,50,21,32,53,1,0.3
883,50,40,61,101,1,0.3
884,50,78,94,172,1,0.3
885,50,22,31,53,1,0.3
886,50,43,49,92,1,0.3
887,50,30,43,73,1,0.3
888,50,14,34,48,1,0.3
889,50,53,44,97,1,0.3
890,50,7,29,36,1,0.3
891,50,3,6,9,1,0.3
892,50,21,34,55,1,0.3
893,50,19,13,32,1,0.3
894,50,12,18,30,1,0.3
895,50,18,33,51,1,0.3
896,50,16,21,37,1,0.3
897,50,28,60,88,1,0.3
898,50,38,47,85,1,0.3
899,50,15,29,44,1,0.3
900,50,17,39,56,1,0.3
901,50,60,49,109,1,0.3
902,50,34,42,76,1,0.3
903,50,29,63,92,1,0.3
904,50,29,38,67,1,0.3
905,50,22,41,63,1,0.3
906,50,6,15,21,1,0.3
907,50,27,57,84,1,0.3
908,50,12,10,22,1,0.3
909,50,8,10,18,1,0.3
910,50,11,12,23,1,0.3
911,50,1,12,13,1,0.3
912,50,75,121,196,1,0.3
913,50,45,65,110,1,0.3
914,50,30,47,77,1,0.3
915,50,11,4,15,1,0.3
916,50,15,12,27,1,0.3
917,50,70,121,191,1,0.3
918,50,3,11,14,1,0.3
919,50,55,71,126,1,0.3
920,50,42,43,85,1,0.3
921,50,9,14,23,1,0.3
922,50,42,53,95,1,0.3
923,50,38,64,102,1,0.3
924,50,35,23,58,1,0.3
925,50,3,5,8,1,0.3
926,50,4,4,8,1,0.3
927,50,11,10,21,1,0.3
928,50,33,163,196,1,0.3
929,50,46,54,100,1,0.3
930,50,27,36,63,1,0.3
931,50,18,36,54,1,0.3
932,50,20,32,52,1,0.3
933,50,35,102,137,1,0.3
934,50,25,34,59,1,0.3
935,50,81,108,189,1,0.3
936,50,16,23,39,1,0.3
937,50,19,25,44,1,0.3
938,50,10,25,35,1,0.3
939,50,11,16,27,1,0.3
940,50,54,78,132,1,0.3
941,50,25,34,59,1,0.3
942,50,6,41,47,1,0.3
943,50,20,18,38,1,0.3
944,50,13,11,24,1,0.3
945,50,48,119,167,1,0.3
946,50,11,15,26,1,0.3
947,50,18,27,45,1,0.3
948,50,20,51,71,1,0.3
949,50,5,3,8,1,0.3
950,50,25,38,63,1,0.3
951,50,11,20,31,1,0.3
952,50,20,56,76,1,0.3
953,50,3,5,8,1,0.3
954,50,16,22,38,1,0.3
955,50,4,12,16,1,0.3
956,50,18,24,42,1,0.3
957,50,8,9,17,1,0.3
958,50,7,13,20,1,0.3
959,50,3,3,6,1,0.3
960,50,33,36,69,1,0.3
961,50,7,12,19,1,0.3
962,50,159,79,238,1,0.3
963,50,40,36,76,1,0.3
964,50,23,31,54,1,0.3
965,50,7,16,23,1,0.3
966,50,10,15,25,1,0.3
967,50,33,38,71,1,0.3
968,50,22,33,55,1,0.3
969,50,29,30,59,1,0.3
970,50,27,49,76,1,0.3
971,50,6,16,22,1,0.3
972,50,12,30,42,1,0.3
973,50,16,24,40,1,0.3
974,50,14,28,42,1,0.3
975,50,8,12,20,1,0.3
976,50,8,18,26,1,0.3
977,50,18,30,48,1,0.3
978,50,59,73,132,1,0.3
979,50,18,15,33,1,0.3
980,50,33,52,85,1,0.3
981,50,21,34,55,1,0.3
982,50,13,27,40,1,0.3
983,50,14,31,45,1,0.3
984,50,20,32,52,1,0.3
985,50,21,38,59,1,0.3
986,50,17,7,24,1,0.3
987,50,7,11,18,1,0.3
988,50,25,47,72,1,0.3
989,50,8,18,26,1,0.3
990,50,8,18,26,1,0.3
991,50,2,8,10,1,0.3
992,50,8,8,16,1,0.3
993,50,11,22,33,1,0.3
994,50,50,55,105,1,0.3
995,50,80,123,203,1,0.3
996,50,4,5,9,1,0.3
997,50,29,61,90,1,0.3
998,50,41,40,81,1,0.3
999,50,21,22,43,1,0.3
1000,50,12,23,35,1,0.3
1001,50,15,11,26,1,0.3
1002,50,120,142,262,1,0.3
1003,50,5,0,5,1,0.3
1004,50,13,20,33,1,0.3
1005,50,23,37,60,1,0.3
1006,50,4,2,6,1,0.3
1007,50,2,5,7,1,0.3
1008,50,17,19,36,1,0.3
1009,50,13,37,50,1,0.3
1010,50,44,37,81,1,0.3
1011,50,47,41,88,1,0.3
1012,50,10,18,28,1,0.3
1013,50,49,49,98,1,0.3
1014,50,16,39,55,1,0.3
1015,50,39,50,89,1,0.3
1016,50,15,21,36,1,0.3
1017,50,28,49,77,1,0.3
1018,50,36,36,72,1,0.3
1019,50,3,6,9,1,0.3
1020,50,3,4,7,1,0.3
1021,50,4,4,8,1,0.3
1022,50,23,158,181,1,0.3
1023,50,5,13,18,1,0.3
1024,50,12,18,30,1,0.3
1025,50,49,56,105,1,0.3
1026,50,24,55,79,1,0.3
1027,50,25,35,60,1,0.3
1028,50,12,15,27,1,0.3
1029,50,7,13,20,1,0.3
1030,50,12,17,29,1,0.3
1031,50,4,23,27,1,0.3
1032,50,14,27,41,1,0.3
1033,50,2,8,10,1,0.3
1034,50,16,10,26,1,0.3
1035,50,43,28,71,1,0.3
1036,50,11,42,53,1,0.3
1037,50,14,33,47,1,0.3
1038,50,16,45,61,1,0.3
1039,50,50,43,93,1,0.3
1040,50,30,26,56,1,0.3
1041,50,33,51,84,1,0.3
1042,50,24,36,60,1,0.3
1043,50,37,28,65,1,0.3
1044,50,26,38,64,1,0.3
1045,50,54,57,111,1,0.3
1046,50,18,25,43,1,0.3
1047,50,57,68,125,1,0.3
1048,50,23,37,60,1,0.3
1049,50,39,38,77,1,0.3
1050,50,13,22,35,1,0.3
1051,50,23,28,51,1,0.3
1052,50,10,15,25,1,0.3
1053,50,2,12,14,1,0.3
1054,50,21,33,54,1,0.3
1055,50,15,19,34,1,0.3
1056,50,13,12,25,1,0.3
1057,50,27,28,55,1,0.3
1058,50,23,52,75,1,0.3
1059,50,16,52,68,1,0.3
1060,50,31,35,66,1,0.3
1061,50,52,125,177,1,0.3
1062,50,34,64,98,1,0.3
1063,50,42,62,104,1,0.3
1064,50,35,46,81,1,0.3
1065,50,2,8,10,1,0.3
1066,50,42,52,94,1,0.3
1067,50,19,19,38,1,0.3
1068,50,17,20,37,1,0.3
1069,50,2,0,2,1,0.3
1070,50,21,34,55,1,0.3
1071,50,11,20,31,1,0.3
1072,50,10,32,42,1,0.3
1073,50,17,21,38,1,0.3
1074,50,7,20,27,1,0.3
1075,50,14,27,41,1,0.3
1076,50,22,65,87,1,0.3
1077,50,16,22,38,1,0.3
1078,50,11,14,25,1,0.3
1079,50,0,9,9,1,0.3
1080,50,7,3,10,1,0.3
1081,50,10,7,17,1,0.3
1082,50,29,50,79,1,0.3
1083,50,5,26,31,1,0.3
1084,50,3,10,13,1,0.3
1085,50,10,18,28,1,0.3
1086,50,7,3,10,1,0.3
1087,50,8,18,26,1,0.3
1088,50,21,45,66,1,0.3
1089,50,28,42,70,1,0.3
1090,50,9,24,33,1,0.3
1091,50,27,42,69,1,0.3
1092,50,21,49,70,1,0.3
1093,50,19,46,65,1,0.3
1094,50,4,16,20,1,0.3
1095,50,12,31,43,1,0.3
1096,50,8,8,16,1,0.3
1097,50,13,29,42,1,0.3
1098,50,4,8,12,1,0.3
1099,50,14,57,71,1,0.3
1100,50,14,19,33,1,0.3
1101,50,39,68,107,1,0.3
1102,50,34,63,97,1,0.3
1103,50,25,46,71,1,0.3
1104,50,7,7,14,1,0.3
1105,50,8,17,25,1,0.3
1106,50,14,59,73,1,0.3
1107,50,6,11,17,1,0.3
1108,50,23,33,56,1,0.3
1109,50,34,47,81,1,0.3
1110,50,26,33,59,1,0.3
1111,50,14,18,32,1,0.3
1112,50,8,15,23,1,0.3
1113,50,6,13,19,1,0.3
1114,50,0,0,0,1,0.3
1115,50,2,4,6,1,0.3
1116,50,23,39,62,1,0.3
1117,50,22,40,62,1,0.3
1118,50,31,68,99,1,0.3
1119,50,8,13,21,1,0.3
1120,50,26,53,79,1,0.3
1121,50,47,101,148,1,0.3
1122,50,7,29,36,1,0.3
1123,50,11,29,40,1,0.3
1124,50,19,32,51,1,0.3
1125,50,10,22,32,1,0.3
1126,50,69,138,207,1,0.3
1127,50,54,108,162,1,0.3
1128,50,31,71,102,1,0.3
1129,50,26,86,112,1,0.3
1130,50,23,70,93,1,0.3
1131,50,31,35,66,1,0.3
1132,50,6,20,26,1,0.3
1133,50,21,43,64,1,0.3
1134,50,14,27,41,1,0.3
1135,50,54,72,126,1,0.3
1136,50,9,24,33,1,0.3
1137,50,3,15,18,1,0.3
1138,50,57,94,151,1,0.3
1139,50,72,177,249,1,0.3
1140,50,58,137,195,1,0.3
1141,50,56,76,132,1,0.3
1142,50,47,108,155,1,0.3
1143,50,34,41,75,1,0.3
1144,50,16,32,48,1,0.3
1145,50,18,23,41,1,0.3
1146,50,22,43,65,1,0.3
1147,50,12,40,52,1,0.3
1148,50,23,51,74,1,0.3
1149,50,5,10,15,1,0.3
1150,50,13,84,97,1,0.3
1151,50,8,28,36,1,0.3
1152,50,16,37,53,1,0.3
1153,50,119,187,306,1,0.3
1154,50,9,32,41,1,0.3
1155,50,81,202,283,1,0.3
1156,50,61,119,180,1,0.3
1157,50,61,117,178,1,0.3
1158,50,36,63,99,1,0.3
1159,50,18,31,49,1,0.3
1160,50,18,16,34,1,0.3
1161,50,10,27,37,1,0.3
1162,50,18,11,29,1,0.3
1163,50,13,26,39,1,0.3
1164,50,64,197,261,1,0.3
1165,50,46,92,138,1,0.3
1166,50,95,159,254,1,0.3
1167,50,38,179,217,1,0.3
1168,50,40,89,129,1,0.3
1169,50,66,76,142,1,0.3
1170,50,26,94,120,1,0.3
1171,50,24,63,87,1,0.3
1172,50,2,5,7,1,0.3
1173,50,24,39,63,1,0.3
1174,50,38,64,102,1,0.3
1175,50,58,98,156,1,0.3
1176,50,6,38,44,1,0.3
1177,50,8,6,14,1,0.3
1178,50,2,2,4,1,0.3
1179,50,3,8,11,1,0.3
1180,50,0,0,0,1,0.3
1181,50,21,32,53,1,0.3
1182,50,17,90,107,1,0.3
1183,50,21,91,112,1,0.3
1184,50,16,54,70,1,0.3
1185,50,30,103,133,1,0.3
1186,50,26,54,80,1,0.3
1187,50,33,84,117,1,0.3
1188,50,32,82,114,1,0.3
1189,50,32,100,132,1,0.3
1190,50,16,64,80,1,0.3
1191,50,11,26,37,1,0.3
1192,50,9,46,55,1,0.3
1193,50,17,49,66,1,0.3
1194,50,54,120,174,1,0.3
1195,50,90,112,202,1,0.3
1196,50,13,32,45,1,0.3
1197,50,51,124,175,1,0.3
1198,50,12,59,71,1,0.3
1199,50,29,80,109,1,0.3
1200,50,15,39,54,1,0.3
1201,50,48,104,152,1,0.3
1202,50,23,35,58,1,0.3
1203,50,22,51,73,1,0.3
1204,50,14,33,47,1,0.3
1205,50,9,28,37,1,0.3
1206,50,25,73,98,1,0.3
1207,50,78,136,214,1,0.3
1208,50,29,115,144,1,0.3
1209,50,14,27,41,1,0.3
1210,50,14,19,33,1,0.3
1211,50,76,148,224,1,0.3
1212,50,87,148,235,1,0.3
1213,50,24,89,113,1,0.3
1214,50,28,36,64,1,0.3
1215,50,85,126,211,1,0.3
1216,50,6,11,17,1,0.3
1217,50,38,68,106,1,0.3
1218,50,52,124,176,1,0.3
1219,50,13,16,29,1,0.3
1220,50,1,11,12,1,0.3
1221,50,15,15,30,1,0.3
1222,50,4,1,5,1,0.3
1223,50,17,45,62,1,0.3
1224,50,29,79,108,1,0.3
1225,50,57,177,234,1,0.3
1226,50,50,131,181,1,0.3
1227,50,34,119,153,1,0.3
1228,50,26,31,57,1,0.3
1229,50,49,83,132,1,0.3
1230,50,34,53,87,1,0.3
1231,50,7,17,24,1,0.3
1232,50,15,30,45,1,0.3
1233,50,8,14,22,1,0.3
1234,50,3,2,5,1,0.3
1235,50,6,4,10,1,0.3
1236,50,26,47,73,1,0.3
1237,50,108,151,259,1,0.3
1238,50,30,66,96,1,0.3
1239,50,37,70,107,1,0.3
1240,50,8,24,32,1,0.3
1241,50,92,81,173,1,0.3
1242,50,21,46,67,1,0.3
1243,50,1,5,6,1,0.3
1244,50,16,40,56,1,0.3
1245,50,14,36,50,1,0.3
1246,50,8,14,22,1,0.3
1247,50,4,15,19,1,0.3
1248,50,27,33,60,1,0.3
1249,50,2,2,4,1,0.3
1250,50,46,59,105,1,0.3
1251,50,18,12,30,1,0.3
1252,50,4,4,8,1,0.3
1253,50,21,54,75,1,0.3
1254,50,32,33,65,1,0.3
1255,50,43,43,86,1,0.3
1256,50,30,55,85,1,0.3
1257,50,29,29,58,1,0.3
1258,50,32,52,84,1,0.3
1259,50,32,72,104,1,0.3
1260,50,31,17,48,1,0.3
1261,50,21,34,55,1,0.3
1262,50,15,5,20,1,0.3
1263,50,3,11,14,1,0.3
1264,50,13,35,48,1,0.3
1265,50,35,60,95,1,0.3
1266,50,22,25,47,1,0.3
1267,50,55,88,143,1,0.3
1268,50,8,13,21,1,0.3
1269,50,50,92,142,1,0.3
1270,50,42,62,104,1,0.3
1271,50,7,11,18,1,0.3
1272,50,21,54,75,1,0.3
1273,50,28,59,87,1,0.3
1274,50,24,29,53,1,0.3
1275,50,8,2,10,1,0.3
1276,50,3,13,16,1,0.3
1277,50,22,69,91,1,0.3
1278,50,14,27,41,1,0.3
1279,50,32,23,55,1,0.3
1280,50,8,9,17,1,0.3
1281,50,16,15,31,1,0.3
1282,50,40,49,89,1,0.3
1283,50,37,58,95,1,0.3
1284,50,91,134,225,1,0.3
1285,50,25,33,58,1,0.3
1286,50,36,75,111,1,0.3
1287,50,33,60,93,1,0.3
1288,50,38,48,86,1,0.3
1289,50,62,71,133,1,0.3
1290,50,80,107,187,1,0.3
1291,50,35,35,70,1,0.3
1292,50,110,117,227,1,0.3
1293,50,19,36,55,1,0.3
1294,50,19,38,57,1,0.3
1295,50,6,27,33,1,0.3
1296,50,21,41,62,1,0.3
1297,50,1,7,8,1,0.3
1298,50,13,28,41,1,0.3
1299,50,36,68,104,1,0.3
1300,50,17,22,39,1,0.3
1301,50,17,16,33,1,0.3
1302,50,3,23,26,1,0.3
1303,50,12,17,29,1,0.3
1304,50,31,58,89,1,0.3
1305,50,26,23,49,1,0.3
1306,50,49,101,150,1,0.3
1307,50,22,30,52,1,0.3
1308,50,24,49,73,1,0.3
1309,50,13,13,26,1,0.3
1310,50,36,54,90,1,0.3
1311,50,20,47,67,1,0.3
1312,50,9,20,29,1,0.3
1313,50,13,15,28,1,0.3
1314,50,15,28,43,1,0.3
1315,50,6,1,7,1,0.3
1316,50,11,13,24,1,0.3
1317,50,9,11,20,1,0.3
1318,50,2,0,2,1,0.3
1319,50,8,16,24,1,0.3
1320,50,49,91,140,1,0.3
1321,50,61,71,132,1,0.3
1322,50,15,18,33,1,0.3
1323,50,54,100,154,1,0.3
1324,50,54,91,145,1,0.3
1325,50,32,64,96,1,0.3
1326,50,49,71,120,1,0.3
1327,50,28,64,92,1,0.3
1328,50,23,49,72,1,0.3
1329,50,23,49,72,1,0.3
1330,50,5,12,17,1,0.3
1331,50,10,24,34,1,0.3
1332,50,2,1,3,1,0.3
1333,50,1,5,6,1,0.3
1334,75,9,17,26,1,0.3
1335,75,34,26,60,1,0.3
1336,75,15,18,33,1,0.3
1337,75,22,31,53,1,0.3
1338,75,15,9,24,1,0.3
1339,75,11,25,36,1,0.3
1340,75,25,63,88,1,0.3
1341,75,5,14,19,1,0.3
1342,75,22,32,54,1,0.3
1343,75,6,14,20,1,0.3
1344,75,33,59,92,1,0.3
1345,75,32,64,96,1,0.3
1346,75,2,7,9,1,0.3
1347,75,8,8,16,1,0.3
1348,75,12,40,52,1,0.3
1349,75,11,22,33,1,0.3
1350,75,51,103,154,1,0.3
1351,75,37,24,61,1,0.3
1352,75,9,3,12,1,0.3
1353,75,15,41,56,1,0.3
1354,75,31,91,122,1,0.3
1355,75,44,60,104,1,0.3
1356,75,27,93,120,1,0.3
1357,75,68,107,175,1,0.3
1358,75,38,65,103,1,0.3
1359,75,12,33,45,1,0.3
1360,75,35,27,62,1,0.3
1361,75,19,17,36,1,0.3
1362,75,34,73,107,1,0.3
1363,75,19,25,44,1,0.3
1364,75,50,60,110,1,0.3
1365,75,97,174,271,1,0.3
1366,75,64,111,175,1,0.3
1367,75,31,51,82,1,0.3
1368,75,58,56,114,1,0.3
1369,75,22,15,37,1,0.3
1370,75,19,32,51,1,0.3
1371,75,10,8,18,1,0.3
1372,75,27,37,64,1,0.3
1373,75,61,77,138,1,0.3
1374,75,33,45,78,1,0.3
1375,75,48,71,119,1,0.3
1376,75,12,32,44,1,0.3
1377,75,31,13,44,1,0.3
1378,75,40,89,129,1,0.3
1379,75,6,12,18,1,0.3
1380,75,48,72,120,1,0.3
1381,75,51,102,153,1,0.3
1382,75,22,50,72,1,0.3
1383,75,11,33,44,1,0.3
1384,75,19,51,70,1,0.3
1385,75,34,45,79,1,0.3
1386,75,16,10,26,1,0.3
1387,75,32,31,63,1,0.3
1388,75,19,49,68,1,0.3
1389,75,15,24,39,1,0.3
1390,75,20,15,35,1,0.3
1391,75,11,19,30,1,0.3
1392,75,18,22,40,1,0.3
1393,75,40,33,73,1,0.3
1394,75,7,13,20,1,0.3
1395,75,12,16,28,1,0.3
1396,75,2,4,6,1,0.3
1397,75,38,50,88,1,0.3
1398,75,10,4,14,1,0.3
1399,75,10,26,36,1,0.3
1400,75,29,33,62,1,0.3
1401,75,18,47,65,1,0.3
1402,75,52,56,108,1,0.3
1403,75,17,67,84,1,0.3
1404,75,39,67,106,1,0.3
1405,75,36,44,80,1,0.3
1406,75,14,29,43,1,0.3
1407,75,32,51,83,1,0.3
1408,75,33,39,72,1,0.3
1409,75,27,43,70,1,0.3
1410,75,62,144,206,1,0.3
1411,75,18,17,35,1,0.3
1412,75,41,74,115,1,0.3
1413,75,22,32,54,1,0.3
1414,75,23,32,55,1,0.3
1415,75,29,44,73,1,0.3
1416,75,29,58,87,1,0.3
1417,75,24,48,72,1,0.3
1418,75,16,20,36,1,0.3
1419,75,6,37,43,1,0.3
1420,75,9,16,25,1,0.3
1421,75,25,48,73,1,0.3
1422,75,16,27,43,1,0.3
1423,75,20,39,59,1,0.3
1424,75,16,49,65,1,0.3
1425,75,7,28,35,1,0.3
1426,75,10,13,23,1,0.3
1427,75,14,14,28,1,0.3
1428,75,24,26,50,1,0.3
1429,75,26,33,59,1,0.3
1430,75,45,50,95,1,0.3
1431,75,47,61,108,1,0.3
1432,75,39,66,105,1,0.3
1433,75,31,30,61,1,0.3
1434,75,59,106,165,1,0.3
1435,75,43,49,92,1,0.3
1436,75,17,29,46,1,0.3
1437,75,25,66,91,1,0.3
1438,75,26,27,53,1,0.3
1439,75,24,37,61,1,0.3
1440,75,37,75,112,1,0.3
1441,75,15,19,34,1,0.3
1442,75,21,53,74,1,0.3
1443,75,32,70,102,1,0.3
1444,75,10,22,32,1,0.3
1445,75,13,20,33,1,0.3
1446,75,26,34,60,1,0.3
1447,75,26,53,79,1,0.3
1448,75,31,53,84,1,0.3
1449,75,19,22,41,1,0.3
1450,75,27,75,102,1,0.3
1451,75,3,18,21,1,0.3
1452,75,4,4,8,1,0.3
1453,75,4,15,19,1,0.3
1454,75,20,21,41,1,0.3
1455,75,10,29,39,1,0.3
1456,75,22,23,45,1,0.3
1457,75,1,10,11,1,0.3
1458,75,4,14,18,1,0.3
1459,75,16,8,24,1,0.3
1460,75,16,49,65,1,0.3
1461,75,85,136,221,1,0.3
1462,75,65,74,139,1,0.3
1463,75,21,26,47,1,0.3
1464,75,23,30,53,1,0.3
1465,75,45,33,78,1,0.3
1466,75,22,29,51,1,0.3
1467,75,25,59,84,1,0.3
1468,75,27,27,54,1,0.3
1469,75,18,32,50,1,0.3
1470,75,28,62,90,1,0.3
1471,75,25,46,71,1,0.3
1472,75,25,19,44,1,0.3
1473,75,16,25,41,1,0.3
1474,75,4,7,11,1,0.3
1475,75,4,10,14,1,0.3
1476,75,52,47,99,1,0.3
1477,75,17,29,46,1,0.3
1478,75,14,26,40,1,0.3
1479,75,29,74,103,1,0.3
1480,75,33,53,86,1,0.3
1481,75,16,14,30,1,0.3
1482,75,57,80,137,1,0.3
1483,75,44,50,94,1,0.3
1484,75,3,4,7,1,0.3
1485,75,9,25,34,1,0.3
1486,75,20,13,33,1,0.3
1487,75,5,13,18,1,0.3
1488,75,1,3,4,1,0.3
1489,75,35,9,44,1,0.3
1490,75,10,13,23,1,0.3
1491,75,7,7,14,1,0.3
1492,75,61,127,188,1,0.3
1493,75,13,8,21,1,0.3
1494,75,10,15,25,1,0.3
1495,75,22,44,66,1,0.3
1496,75,48,96,144,1,0.3
1497,75,6,23,29,1,0.3
1498,75,50,120,170,1,0.3
1499,75,36,65,101,1,0.3
1500,75,6,15,21,1,0.3
1501,75,11,22,33,1,0.3
1502,75,39,64,103,1,0.3
1503,75,32,43,75,1,0.3
1504,75,44,67,111,1,0.3
1505,75,54,93,147,1,0.3
1506,75,39,76,115,1,0.3
1507,75,37,80,117,1,0.3
1508,75,48,88,136,1,0.3
1509,75,31,32,63,1,0.3
1510,75,30,31,61,1,0.3
1511,75,7,8,15,1,0.3
1512,75,33,40,73,1,0.3
1513,75,2,12,14,1,0.3
1514,75,35,57,92,1,0.3
1515,75,66,121,187,1,0.3
1516,75,57,79,136,1,0.3
1517,75,26,16,42,1,0.3
1518,75,13,33,46,1,0.3
1519,75,32,69,101,1,0.3
1520,75,9,26,35,1,0.3
1521,75,23,38,61,1,0.3
1522,75,3,5,8,1,0.3
1523,75,8,34,42,1,0.3
1524,75,7,14,21,1,0.3
1525,75,26,108,134,1,0.3
1526,75,38,49,87,1,0.3
1527,75,35,61,96,1,0.3
1528,75,56,108,164,1,0.3
1529,75,26,22,48,1,0.3
1530,75,30,37,67,1,0.3
1531,75,16,13,29,1,0.3
1532,75,45,40,85,1,0.3
1533,75,10,12,22,1,0.3
1534,75,29,35,64,1,0.3
1535,75,34,29,63,1,0.3
1536,75,20,39,59,1,0.3
1537,75,56,55,111,1,0.3
1538,75,50,65,115,1,0.3
1539,75,12,18,30,1,0.3
1540,75,61,118,179,1,0.3
1541,75,33,32,65,1,0.3
1542,75,46,41,87,1,0.3
1543,75,24,24,48,1,0.3
1544,75,18,23,41,1,0.3
1545,75,27,48,75,1,0.3
1546,75,10,12,22,1,0.3
1547,75,25,26,51,1,0.3
1548,75,33,63,96,1,0.3
1549,75,12,23,35,1,0.3
1550,75,16,10,26,1,0.3
1551,75,8,6,14,1,0.3
1552,75,24,29,53,1,0.3
1553,75,28,18,46,1,0.3
1554,75,43,63,106,1,0.3
1555,75,15,18,33,1,0.3
1556,75,50,113,163,1,0.3
1557,75,33,63,96,1,0.3
1558,75,35,61,96,1,0.3
1559,75,48,86,134,1,0.3
1560,75,86,154,240,1,0.3
1561,75,23,19,42,1,0.3
1562,75,20,31,51,1,0.3
1563,75,19,40,59,1,0.3
1564,75,5,6,11,1,0.3
1565,75,21,22,43,1,0.3
1566,75,2,6,8,1,0.3
1567,75,3,6,9,1,0.3
1568,75,21,19,40,1,0.3
1569,75,28,35,63,1,0.3
1570,75,53,63,116,1,0.3
1571,75,55,74,129,1,0.3
1572,75,26,29,55,1,0.3
1573,75,44,75,119,1,0.3
1574,75,85,92,177,1,0.3
1575,75,56,69,125,1,0.3
1576,75,43,59,102,1,0.3
1577,75,17,31,48,1,0.3
1578,75,12,23,35,1,0.3
1579,75,16,35,51,1,0.3
1580,75,6,6,12,1,0.3
1581,75,19,32,51,1,0.3
1582,75,80,144,224,1,0.3
1583,75,20,23,43,1,0.3
1584,75,20,22,42,1,0.3
1585,75,29,58,87,1,0.3
1586,75,23,28,51,1,0.3
1587,75,33,65,98,1,0.3
1588,75,12,29,41,1,0.3
1589,75,50,69,119,1,0.3
1590,75,29,33,62,1,0.3
1591,75,35,77,112,1,0.3
1592,75,24,37,61,1,0.3
1593,75,7,9,16,1,0.3
1594,75,18,51,69,1,0.3
1595,75,0,7,7,1,0.3
1596,75,40,72,112,1,0.3
1597,75,43,87,130,1,0.3
1598,75,8,18,26,1,0.3
1599,75,65,132,197,1,0.3
1600,75,31,35,66,1,0.3
1601,75,45,48,93,1,0.3
1602,75,53,164,217,1,0.3
1603,75,22,52,74,1,0.3
1604,75,12,39,51,1,0.3
1605,75,9,47,56,1,0.3
1606,75,21,27,48,1,0.3
1607,75,34,55,89,1,0.3
1608,75,41,51,92,1,0.3
1609,75,35,42,77,1,0.3
1610,75,48,49,97,1,0.3
1611,75,34,50,84,1,0.3
1612,75,29,42,71,1,0.3
1613,75,34,82,116,1,0.3
1614,75,56,65,121,1,0.3
1615,75,14,20,34,1,0.3
1616,75,13,12,25,1,0.3
1617,75,23,20,43,1,0.3
1618,75,36,32,68,1,0.3
1619,75,21,41,62,1,0.3
1620,75,58,39,97,1,0.3
1621,75,42,58,100,1,0.3
1622,75,17,19,36,1,0.3
1623,75,76,114,190,1,0.3
1624,75,13,27,40,1,0.3
1625,75,23,36,59,1,0.3
1626,75,49,80,129,1,0.3
1627,75,26,43,69,1,0.3
1628,75,40,35,75,1,0.3
1629,75,14,34,48,1,0.3
1630,75,27,50,77,1,0.3
1631,75,16,29,45,1,0.3
1632,75,12,26,38,1,0.3
1633,75,2,2,4,1,0.3
1634,75,14,7,21,1,0.3
1635,75,33,58,91,1,0.3
1636,75,55,75,130,1,0.3
1637,75,57,76,133,1,0.3
1638,75,54,35,89,1,0.3
1639,75,34,32,66,1,0.3
1640,75,35,50,85,1,0.3
1641,75,29,55,84,1,0.3
1642,75,44,45,89,1,0.3
1643,75,17,15,32,1,0.3
1644,75,46,57,103,1,0.3
1645,75,48,51,99,1,0.3
1646,75,17,27,44,1,0.3
1647,75,8,9,17,1,0.3
1648,75,48,90,138,1,0.3
1649,75,6,6,12,1,0.3
1650,75,43,29,72,1,0.3
1651,75,33,20,53,1,0.3
1652,75,11,25,36,1,0.3
1653,75,2,7,9,1,0.3
1654,75,24,73,97,1,0.3
1655,75,26,35,61,1,0.3
1656,75,43,63,106,1,0.3
1657,75,40,105,145,1,0.3
1658,75,18,23,41,1,0.3
1659,75,11,41,52,1,0.3
1660,75,46,66,112,1,0.3
1661,75,28,49,77,1,0.3
1662,75,12,21,33,1,0.3
1663,75,11,27,38,1,0.3
1664,75,25,29,54,1,0.3
1665,75,9,15,24,1,0.3
1666,75,12,9,21,1,0.3
1667,75,39,62,101,1,0.3
1668,75,42,78,120,1,0.3
1669,75,31,91,122,1,0.3
1670,75,19,35,54,1,0.3
1671,75,21,51,72,1,0.3
1672,75,30,33,63,1,0.3
1673,75,10,15,25,1,0.3
1674,75,14,39,53,1,0.3
1675,75,22,24,46,1,0.3
1676,75,23,16,39,1,0.3
1677,75,30,34,64,1,0.3
1678,75,10,25,35,1,0.3
1679,75,3,3,6,1,0.3
1680,75,13,14,27,1,0.3
1681,75,29,24,53,1,0.3
1682,75,16,19,35,1,0.3
1683,75,33,45,78,1,0.3
1684,75,20,33,53,1,0.3
1685,75,19,48,67,1,0.3
1686,75,26,29,55,1,0.3
1687,75,26,50,76,1,0.3
1688,75,50,70,120,1,0.3
1689,75,7,14,21,1,0.3
1690,75,17,54,71,1,0.3
1691,75,7,27,34,1,0.3
1692,75,4,18,22,1,0.3
1693,75,17,22,39,1,0.3
1694,75,9,15,24,1,0.3
1695,75,2,2,4,1,0.3
1696,75,6,9,15,1,0.3
1697,75,3,4,7,1,0.3
1698,75,64,87,151,1,0.3
1699,75,19,13,32,1,0.3
1700,75,22,42,64,1,0.3
1701,75,21,57,78,1,0.3
1702,75,32,35,67,1,0.3
1703,75,33,76,109,1,0.3
1704,75,33,76,109,1,0.3
1705,75,24,35,59,1,0.3
1706,75,3,3,6,1,0.3
1707,75,13,43,56,1,0.3
1708,75,7,18,25,1,0.3
1709,75,7,17,24,1,0.3
1710,75,34,39,73,1,0.3
1711,75,33,49,82,1,0.3
1712,75,24,46,70,1,0.3
1713,75,52,39,91,1,0.3
1714,75,45,67,112,1,0.3
1715,75,51,76,127,1,0.3
1716,75,19,27,46,1,0.3
1717,75,37,43,80,1,0.3
1718,75,23,8,31,1,0.3
1719,75,88,137,225,1,0.3
1720,75,51,59,110,1,0.3
1721,75,4,19,23,1,0.3
1722,75,10,20,30,1,0.3
1723,75,23,51,74,1,0.3
1724,75,14,19,33,1,0.3
1725,75,2,3,5,1,0.3
1726,75,106,271,377,1,0.3
1727,75,44,75,119,1,0.3
1728,75,69,144,213,1,0.3
1729,75,34,78,112,1,0.3
1730,75,49,92,141,1,0.3
1731,75,29,53,82,1,0.3
1732,75,40,85,125,1,0.3
1733,75,25,53,78,1,0.3
1734,75,26,50,76,1,0.3
1735,75,23,27,50,1,0.3
1736,75,9,28,37,1,0.3
1737,75,16,16,32,1,0.3
1738,75,10,7,17,1,0.3
1739,75,20,23,43,1,0.3
1740,75,14,26,40,1,0.3
1741,75,10,28,38,1,0.3
1742,75,21,42,63,1,0.3
1743,75,25,45,70,1,0.3
1744,75,20,30,50,1,0.3
1745,75,88,152,240,1,0.3
1746,75,5,24,29,1,0.3
1747,75,13,30,43,1,0.3
1748,75,23,43,66,1,0.3
1749,75,22,61,83,1,0.3
1750,75,19,18,37,1,0.3
1751,75,48,72,120,1,0.3
1752,75,26,68,94,1,0.3
1753,75,7,9,16,1,0.3
1754,75,49,58,107,1,0.3
1755,75,21,60,81,1,0.3
1756,75,17,33,50,1,0.3
1757,75,19,19,38,1,0.3
1758,75,16,26,42,1,0.3
1759,75,15,20,35,1,0.3
1760,75,57,116,173,1,0.3
1761,75,42,51,93,1,0.3
1762,75,29,56,85,1,0.3
1763,75,16,34,50,1,0.3
1764,75,223,55,278,1,0.3
1765,75,14,35,49,1,0.3
1766,75,12,20,32,1,0.3
1767,75,10,30,40,1,0.3
1768,75,19,33,52,1,0.3
1769,75,10,33,43,1,0.3
1770,75,2,2,4,1,0.3
1771,75,17,27,44,1,0.3
1772,90,49,81,130,1,0.3
1773,90,38,47,85,1,0.3
1774,90,26,24,50,1,0.3
1775,90,25,28,53,1,0.3
1776,90,40,74,114,1,0.3
1777,90,85,146,231,1,0.3
1778,90,10,20,30,1,0.3
1779,90,69,116,185,1,0.3
1780,90,33,68,101,1,0.3
1781,90,34,60,94,1,0.3
1782,90,109,131,240,1,0.3
1783,90,36,22,58,1,0.3
1784,90,65,79,144,1,0.3
1785,90,24,77,101,1,0.3
1786,90,69,36,105,1,0.3
1787,90,21,30,51,1,0.3
1788,90,46,63,109,1,0.3
1789,90,26,34,60,1,0.3
1790,90,33,48,81,1,0.3
1791,90,12,35,47,1,0.3
1792,90,36,78,114,1,0.3
1793,90,20,24,44,1,0.3
1794,90,18,33,51,1,0.3
1795,90,30,44,74,1,0.3
1796,90,29,76,105,1,0.3
1797,90,17,27,44,1,0.3
1798,90,4,21,25,1,0.3
1799,90,28,33,61,1,0.3
1800,90,23,41,64,1,0.3
1801,90,25,88,113,1,0.3
1802,90,25,39,64,1,0.3
1803,90,31,31,62,1,0.3
1804,90,29,30,59,1,0.3
1805,90,24,41,65,1,0.3
1806,90,8,5,13,1,0.3
1807,90,45,96,141,1,0.3
1808,90,29,34,63,1,0.3
1809,90,17,37,54,1,0.3
1810,90,25,18,43,1,0.3
1811,90,10,27,37,1,0.3
1812,90,18,32,50,1,0.3
1813,90,69,147,216,1,0.3
1814,90,23,97,120,1,0.3
1815,90,27,43,70,1,0.3
1816,90,35,35,70,1,0.3
1817,90,10,23,33,1,0.3
1818,90,12,21,33,1,0.3
1819,90,22,31,53,1,0.3
1820,90,16,25,41,1,0.3
1821,90,38,69,107,1,0.3
1822,90,19,16,35,1,0.3
1823,90,25,40,65,1,0.3
1824,90,18,73,91,1,0.3
1825,90,48,141,189,1,0.3
1826,90,25,45,70,1,0.3
1827,90,9,45,54,1,0.3
1828,90,23,48,71,1,0.3
1829,90,21,49,70,1,0.3
1830,90,66,66,132,1,0.3
1831,90,30,34,64,1,0.3
1832,90,12,45,57,1,0.3
1833,90,62,86,148,1,0.3
1834,90,24,20,44,1,0.3
1835,90,1,6,7,1,0.3
1836,90,31,99,130,1,0.3
1837,90,34,122,156,1,0.3
1838,90,20,54,74,1,0.3
1839,90,45,179,224,1,0.3
1840,90,70,153,223,1,0.3
1841,90,29,37,66,1,0.3
1842,90,39,194,233,1,0.3
1843,90,24,57,81,1,0.3
1844,90,30,79,109,1,0.3
1845,90,25,34,59,1,0.3
1846,90,11,7,18,1,0.3
1847,90,9,23,32,1,0.3
1848,90,9,29,38,1,0.3
1849,90,47,52,99,1,0.3
1850,90,4,6,10,1,0.3
1851,90,47,125,172,1,0.3
1852,90,22,42,64,1,0.3
1853,90,40,91,131,1,0.3
1854,90,22,61,83,1,0.3
1855,90,14,15,29,1,0.3
1856,90,37,61,98,1,0.3
1857,90,30,58,88,1,0.3
1858,90,87,94,181,1,0.3
1859,90,64,101,165,1,0.3
1860,90,14,22,36,1,0.3
1861,90,4,7,11,1,0.3
1862,90,23,21,44,1,0.3
1863,90,9,20,29,1,0.3
1864,90,140,199,339,1,0.3
1865,90,64,117,181,1,0.3
1866,90,39,47,86,1,0.3
1867,90,56,113,169,1,0.3
1868,90,18,25,43,1,0.3
1869,90,5,27,32,1,0.3
1870,90,68,99,167,1,0.3
1871,90,31,39,70,1,0.3
1872,90,47,42,89,1,0.3
1873,90,9,9,18,1,0.3
1874,90,35,79,114,1,0.3
1875,90,8,16,24,1,0.3
1876,90,18,30,48,1,0.3
1877,90,32,42,74,1,0.3
1878,90,8,11,19,1,0.3
1879,90,3,13,16,1,0.3
1880,90,79,164,243,1,0.3
1881,90,46,47,93,1,0.3
1882,90,27,26,53,1,0.3
1883,90,56,72,128,1,0.3
1884,90,93,120,213,1,0.3
1885,90,19,37,56,1,0.3
1886,90,62,62,124,1,0.3
1887,90,22,52,74,1,0.3
1888,90,32,21,53,1,0.3
1889,90,14,10,24,1,0.3
1890,90,23,23,46,1,0.3
1891,90,15,26,41,1,0.3
1892,90,11,11,22,1,0.3
1893,90,13,9,22,1,0.3
1894,90,40,49,89,1,0.3
1895,90,90,121,211,1,0.3
1896,90,21,20,41,1,0.3
1897,90,10,23,33,1,0.3
1898,90,40,111,151,1,0.3
1899,90,108,140,248,1,0.3
1900,90,47,43,90,1,0.3
1901,90,25,38,63,1,0.3
1902,90,51,54,105,1,0.3
1903,90,12,12,24,1,0.3
1904,90,18,16,34,1,0.3
1905,90,30,40,70,1,0.3
1906,90,37,87,124,1,0.3
1907,90,13,23,36,1,0.3
1908,90,63,76,139,1,0.3
1909,90,69,76,145,1,0.3
1910,90,34,70,104,1,0.3
1911,90,19,116,135,1,0.3
1912,90,33,42,75,1,0.3
1913,90,33,49,82,1,0.3
1914,90,32,33,65,1,0.3
1915,90,31,38,69,1,0.3
1916,90,51,57,108,1,0.3
1917,90,19,21,40,1,0.3
1918,90,4,7,11,1,0.3
1919,90,18,23,41,1,0.3
1920,90,20,17,37,1,0.3
1921,90,20,17,37,1,0.3
1922,90,12,12,24,1,0.3
1923,90,19,10,29,1,0.3
1924,90,1,2,3,1,0.3
1925,90,10,18,28,1,0.3
1926,90,48,42,90,1,0.3
1927,90,54,74,128,1,0.3
1928,90,35,30,65,1,0.3
1929,90,36,32,68,1,0.3
1930,90,31,70,101,1,0.3
1931,90,27,26,53,1,0.3
1932,90,3,18,21,1,0.3
1933,90,42,51,93,1,0.3
1934,90,40,31,71,1,0.3
1935,90,14,9,23,1,0.3
1936,90,63,119,182,1,0.3
1937,90,9,14,23,1,0.3
1938,90,10,44,54,1,0.3
1939,90,27,37,64,1,0.3
1940,90,25,41,66,1,0.3
1941,90,3,5,8,1,0.3
1942,90,12,34,46,1,0.3
1943,90,51,143,194,1,0.3
1944,90,20,21,41,1,0.3
1945,90,38,49,87,1,0.3
1946,90,27,43,70,1,0.3
1947,90,14,16,30,1,0.3
1948,90,26,68,94,1,0.3
1949,90,19,27,46,1,0.3
1950,90,6,14,20,1,0.3
1951,90,22,27,49,1,0.3
1952,90,17,20,37,1,0.3
1953,90,20,28,48,1,0.3
1954,90,40,62,102,1,0.3
1955,90,55,98,153,1,0.3
1956,90,47,116,163,1,0.3
1957,90,42,82,124,1,0.3
1958,90,61,67,128,1,0.3
1959,90,21,42,63,1,0.3
1960,90,54,100,154,1,0.3
1961,90,14,41,55,1,0.3
1962,90,8,3,11,1,0.3
1963,90,59,62,121,1,0.3
1964,90,31,80,111,1,0.3
1965,90,56,80,136,1,0.3
1966,90,140,178,318,1,0.3
1967,90,31,48,79,1,0.3
1968,90,20,32,52,1,0.3
1969,90,41,77,118,1,0.3
1970,90,12,48,60,1,0.3
1971,90,39,30,69,1,0.3
1972,90,23,39,62,1,0.3
1973,90,32,90,122,1,0.3
1974,90,9,20,29,1,0.3
1975,90,32,112,144,1,0.3
1976,90,43,71,114,1,0.3
1977,90,47,26,73,1,0.3
1978,90,31,84,115,1,0.3
1979,90,48,95,143,1,0.3
1980,90,28,30,58,1,0.3
1981,90,41,137,178,1,0.3
1982,90,63,57,120,1,0.3
1983,90,21,45,66,1,0.3
1984,90,24,62,86,1,0.3
1985,90,12,29,41,1,0.3
1986,90,1,6,7,1,0.3
1987,90,0,6,6,1,0.3
1988,90,0,0,0,1,0.3
1989,90,34,54,88,1,0.3
1990,90,7,22,29,1,0.3
1991,90,38,63,101,1,0.3
1992,90,49,116,165,1,0.3
1993,90,34,40,74,1,0.3
1994,90,33,44,77,1,0.3
1995,90,23,18,41,1,0.3
1996,90,9,12,21,1,0.3
1997,90,35,87,122,1,0.3
1998,90,17,40,57,1,0.3
1999,90,10,29,39,1,0.3
2000,90,30,37,67,1,0.3
2001,90,30,86,116,1,0.3
2002,90,24,52,76,1,0.3
2003,90,26,37,63,1,0.3
2004,90,32,31,63,1,0.3
2005,90,22,29,51,1,0.3
2006,90,8,29,37,1,0.3
2007,90,2,1,3,1,0.3
2008,90,23,39,62,1,0.3
2009,90,28,69,97,1,0.3
2010,90,56,107,163,1,0.3
2011,90,26,56,82,1,0.3
2012,90,35,139,174,1,0.3
2013,90,5,10,15,1,0.3
2014,90,27,74,101,1,0.3
2015,90,7,11,18,1,0.3
2016,90,33,63,96,1,0.3
2017,90,60,146,206,1,0.3
2018,90,32,69,101,1,0.3
2019,90,5,12,17,1,0.3
2020,90,18,43,61,1,0.3
2021,90,21,10,31,1,0.3
2022,90,13,25,38,1,0.3
2023,90,6,16,22,1,0.3
2024,90,3,3,6,1,0.3
2025,90,82,161,243,1,0.3
2026,90,32,81,113,1,0.3
2027,90,24,33,57,1,0.3
2028,90,65,105,170,1,0.3
2029,90,29,95,124,1,0.3
2030,90,34,128,162,1,0.3
2031,90,31,59,90,1,0.3
2032,90,40,71,111,1,0.3
2033,90,25,43,68,1,0.3
2034,90,44,55,99,1,0.3
2035,90,15,26,41,1,0.3
2036,90,15,22,37,1,0.3
2037,90,4,8,12,1,0.3
2038,90,29,75,104,1,0.3
2039,90,32,47,79,1,0.3
2040,90,43,29,72,1,0.3
2041,90,30,45,75,1,0.3
2042,90,18,111,129,1,0.3
2043,90,29,19,48,1,0.3
2044,90,17,38,55,1,0.3
2045,90,15,26,41,1,0.3
2046,90,26,26,52,1,0.3
2047,90,17,15,32,1,0.3
2048,90,6,28,34,1,0.3
2049,90,29,39,68,1,0.3
2050,90,12,10,22,1,0.3
2051,90,12,25,37,1,0.3
2052,90,15,14,29,1,0.3
2053,90,16,56,72,1,0.3
2054,90,1,2,3,1,0.3
2055,90,0,0,0,1,0.3
2056,90,98,112,210,1,0.3
2057,90,38,27,65,1,0.3
2058,90,43,78,121,1,0.3
2059,90,41,29,70,1,0.3
2060,90,18,10,28,1,0.3
2061,90,39,73,112,1,0.3
2062,90,42,52,94,1,0.3
2063,90,18,17,35,1,0.3
2064,90,21,42,63,1,0.3
2065,90,48,77,125,1,0.3
2066,90,30,29,59,1,0.3
2067,90,84,124,208,1,0.3
2068,90,19,18,37,1,0.3
2069,90,9,12,21,1,0.3
2070,90,26,28,54,1,0.3
2071,90,10,11,21,1,0.3
2072,90,44,43,87,1,0.3
2073,90,33,75,108,1,0.3
2074,90,40,16,56,1,0.3
2075,90,18,58,76,1,0.3
2076,90,43,70,113,1,0.3
2077,90,23,56,79,1,0.3
2078,90,20,29,49,1,0.3
2079,90,50,122,172,1,0.3
2080,90,29,40,69,1,0.3
2081,90,36,47,83,1,0.3
2082,90,7,19,26,1,0.3
2083,90,20,22,42,1,0.3
2084,90,20,20,40,1,0.3
2085,90,31,32,63,1,0.3
2086,90,22,22,44,1,0.3
2087,90,22,28,50,1,0.3
2088,90,18,24,42,1,0.3
2089,90,37,79,116,1,0.3
2090,90,27,43,70,1,0.3
2091,90,39,73,112,1,0.3
2092,90,124,198,322,1,0.3
2093,90,27,44,71,1,0.3
2094,90,40,54,94,1,0.3
2095,90,39,52,91,1,0.3
2096,90,31,51,82,1,0.3
2097,90,44,45,89,1,0.3
2098,90,29,49,78,1,0.3
2099,90,5,16,21,1,0.3
2100,90,17,19,36,1,0.3
2101,90,20,22,42,1,0.3
2102,90,2,2,4,1,0.3
2103,90,46,88,134,1,0.3
2104,90,45,53,98,1,0.3
2105,90,41,87,128,1,0.3
2106,90,20,33,53,1,0.3
2107,90,60,81,141,1,0.3
2108,90,31,49,80,1,0.3
2109,90,33,39,72,1,0.3
2110,90,12,18,30,1,0.3
2111,90,5,11,16,1,0.3
2112,90,38,49,87,1,0.3
2113,90,16,32,48,1,0.3
2114,90,25,21,46,1,0.3
2115,90,13,36,49,1,0.3
2116,90,24,35,59,1,0.3
2117,90,31,20,51,1,0.3
2118,90,48,67,115,1,0.3
2119,90,40,64,104,1,0.3
2120,90,23,41,64,1,0.3
2121,90,44,57,101,1,0.3
2122,90,28,36,64,1,0.3
2123,90,26,39,65,1,0.3
2124,90,9,25,34,1,0.3
2125,90,9,22,31,1,0.3
2126,90,49,39,88,1,0.3
2127,90,25,37,62,1,0.3
2128,90,26,49,75,1,0.3
2129,90,34,31,65,1,0.3
2130,90,43,79,122,1,0.3
2131,90,32,18,50,1,0.3
2132,90,24,62,86,1,0.3
2133,90,42,47,89,1,0.3
2134,90,54,98,152,1,0.3
2135,90,21,37,58,1,0.3
2136,90,51,89,140,1,0.3
2137,90,20,90,110,1,0.3
2138,90,20,50,70,1,0.3
2139,90,83,186,269,1,0.3
2140,90,10,24,34,1,0.3
2141,90,49,85,134,1,0.3
2142,90,20,15,35,1,0.3
2143,90,52,58,110,1,0.3
2144,90,34,32,66,1,0.3
2145,90,57,109,166,1,0.3
2146,90,26,27,53,1,0.3
2147,90,55,29,84,1,0.3
2148,90,23,27,50,1,0.3
2149,90,19,38,57,1,0.3
2150,90,36,34,70,1,0.3
2151,90,11,17,28,1,0.3
2152,90,12,24,36,1,0.3
2153,90,7,13,20,1,0.3
2154,90,50,63,113,1,0.3
2155,90,12,33,45,1,0.3
2156,90,22,28,50,1,0.3
2157,90,34,40,74,1,0.3
2158,90,8,9,17,1,0.3
2159,90,35,25,60,1,0.3
2160,90,35,62,97,1,0.3
2161,90,28,42,70,1,0.3
2162,90,45,59,104,1,0.3
2163,90,24,32,56,1,0.3
2164,90,34,24,58,1,0.3
2165,90,19,45,64,1,0.3
2166,90,17,9,26,1,0.3
2167,90,30,34,64,1,0.3
2168,90,20,24,44,1,0.3
2169,90,8,13,21,1,0.3
2170,90,10,19,29,1,0.3
2171,90,6,17,23,1,0.3
2172,90,21,52,73,1,0.3
2173,90,7,15,22,1,0.3
2174,90,7,8,15,1,0.3
2175,90,62,65,127,1,0.3
2176,90,54,59,113,1,0.3
2177,90,65,149,214,1,0.3
2178,90,80,42,122,1,0.3
2179,90,25,31,56,1,0.3
2180,90,21,39,60,1,0.3
2181,90,18,20,38,1,0.3
2182,90,22,21,43,1,0.3
2183,90,12,12,24,1,0.3
2184,90,18,11,29,1,0.3
2185,90,28,38,66,1,0.3
2186,90,15,28,43,1,0.3
2187,90,5,8,13,1,0.3
2188,90,2,2,4,1,0.3
2189,90,13,37,50,1,0.3
2190,90,90,90,180,1,0.3
2191,90,33,45,78,1,0.3
2192,90,24,13,37,1,0.3
2193,90,13,36,49,1,0.3
2194,90,44,95,139,1,0.3
2195,90,26,18,44,1,0.3
2196,90,13,48,61,1,0.3
2197,90,63,139,202,1,0.3
2198,90,31,40,71,1,0.3
2199,90,21,17,38,1,0.3
2200,90,7,16,23,1,0.3
2201,90,29,35,64,1,0.3
2202,90,6,3,9,1,0.3
2203,90,35,27,62,1,0.3
2204,90,42,54,96,1,0.3
2205,90,28,50,78,1,0.3
2206,90,33,52,85,1,0.3
2207,90,25,40,65,1,0.3
2208,90,35,24,59,1,0.3
2209,90,22,38,60,1,0.3
2210,90,14,7,21,1,0.3
2211,90,31,27,58,1,0.3
2212,90,21,35,56,1,0.3
2213,90,10,10,20,1,0.3
2214,90,12,18,30,1,0.3
2215,90,8,16,24,1,0.3
2216,90,23,60,83,1,0.3
2217,90,9,25,34,1,0.3
2218,90,4,5,9,1,0.3
2219,120,12,32,44,1,0.3
2220,120,21,20,41,1,0.3
2221,120,6,18,24,1,0.3
2222,120,29,57,86,1,0.3
2223,120,45,64,109,1,0.3
2224,120,23,35,58,1,0.3
2225,120,25,39,64,1,0.3
2226,120,7,6,13,1,0.3
2227,120,13,34,47,1,0.3
2228,120,9,23,32,1,0.3
2229,120,23,16,39,1,0.3
2230,120,14,20,34,1,0.3
2231,120,17,27,44,1,0.3
2232,120,1,4,5,1,0.3
2233,120,0,0,0,1,0.3
2234,120,48,58,106,1,0.3
2235,120,35,28,63,1,0.3
2236,120,21,96,117,1,0.3
2237,120,100,179,279,1,0.3
2238,120,32,44,76,1,0.3
2239,120,39,100,139,1,0.3
2240,120,62,96,158,1,0.3
2241,120,17,26,43,1,0.3
2242,120,16,23,39,1,0.3
2243,120,26,28,54,1,0.3
2244,120,83,84,167,1,0.3
2245,120,15,30,45,1,0.3
2246,120,6,13,19,1,0.3
2247,120,8,18,26,1,0.3
2248,120,26,19,45,1,0.3
2249,120,23,36,59,1,0.3
2250,120,50,51,101,1,0.3
2251,120,45,88,133,1,0.3
2252,120,30,41,71,1,0.3
2253,120,14,20,34,1,0.3
2254,120,17,26,43,1,0.3
2255,120,43,29,72,1,0.3
2256,120,72,60,132,1,0.3
2257,120,24,37,61,1,0.3
2258,120,37,58,95,1,0.3
2259,120,8,13,21,1,0.3
2260,120,10,16,26,1,0.3
2261,120,45,57,102,1,0.3
2262,120,21,14,35,1,0.3
2263,120,22,43,65,1,0.3
2264,120,25,43,68,1,0.3
2265,120,30,87,117,1,0.3
2266,120,141,105,246,1,0.3
2267,120,144,101,245,1,0.3
2268,120,49,54,103,1,0.3
2269,120,13,19,32,1,0.3
2270,120,31,50,81,1,0.3
2271,120,18,36,54,1,0.3
2272,120,24,9,33,1,0.3
2273,120,28,47,75,1,0.3
2274,120,41,69,110,1,0.3
2275,120,48,65,113,1,0.3
2276,120,12,6,18,1,0.3
2277,120,46,58,104,1,0.3
2278,120,27,26,53,1,0.3
2279,120,32,53,85,1,0.3
2280,120,68,92,160,1,0.3
2281,120,29,57,86,1,0.3
2282,120,9,20,29,1,0.3
2283,120,57,104,161,1,0.3
2284,120,8,16,24,1,0.3
2285,120,4,7,11,1,0.3
2286,120,4,10,14,1,0.3
2287,120,16,19,35,1,0.3
2288,120,19,21,40,1,0.3
2289,120,11,15,26,1,0.3
2290,120,8,14,22,1,0.3
2291,120,3,9,12,1,0.3
2292,120,53,61,114,1,0.3
2293,120,8,2,10,1,0.3
2294,120,62,99,161,1,0.3
2295,120,34,48,82,1,0.3
2296,120,18,45,63,1,0.3
2297,120,21,35,56,1,0.3
2298,120,11,30,41,1,0.3
2299,120,39,73,112,1,0.3
2300,120,20,39,59,1,0.3
2301,120,12,12,24,1,0.3
2302,120,19,16,35,1,0.3
2303,120,19,34,53,1,0.3
2304,120,23,42,65,1,0.3
2305,120,13,42,55,1,0.3
2306,120,13,17,30,1,0.3
2307,120,3,4,7,1,0.3
2308,120,2,0,2,1,0.3
2309,120,4,6,10,1,0.3
2310,120,12,24,36,1,0.3
2311,120,14,31,45,1,0.3
2312,120,96,159,255,1,0.3
2313,120,16,26,42,1,0.3
2314,120,30,39,69,1,0.3
2315,120,73,93,166,1,0.3
2316,120,25,45,70,1,0.3
2317,120,27,85,112,1,0.3
2318,120,29,46,75,1,0.3
2319,120,49,53,102,1,0.3
2320,120,37,58,95,1,0.3
2321,120,19,26,45,1,0.3
2322,120,9,19,28,1,0.3
2323,120,12,11,23,1,0.3
2324,120,11,17,28,1,0.3
2325,120,2,4,6,1,0.3
2326,120,10,14,24,1,0.3
2327,120,13,10,23,1,0.3
2328,120,9,22,31,1,0.3
2329,120,45,38,83,1,0.3
2330,120,26,30,56,1,0.3
2331,120,13,29,42,1,0.3
2332,120,3,6,9,1,0.3
2333,120,16,10,26,1,0.3
2334,120,15,34,49,1,0.3
2335,120,17,26,43,1,0.3
2336,120,34,40,74,1,0.3
2337,120,11,17,28,1,0.3
2338,120,52,59,111,1,0.3
2339,120,26,29,55,1,0.3
2340,120,10,25,35,1,0.3
2341,120,19,33,52,1,0.3
2342,120,33,36,69,1,0.3
2343,120,11,41,52,1,0.3
2344,120,4,7,11,1,0.3
2345,120,3,4,7,1,0.3
2346,120,23,42,65,1,0.3
2347,120,4,15,19,1,0.3
2348,120,23,48,71,1,0.3
2349,120,9,14,23,1,0.3
2350,120,109,182,291,1,0.3
2351,120,37,187,224,1,0.3
2352,120,42,25,67,1,0.3
2353,120,35,21,56,1,0.3
2354,120,7,14,21,1,0.3
2355,120,14,29,43,1,0.3
2356,120,9,33,42,1,0.3
2357,120,7,7,14,1,0.3
2358,120,16,42,58,1,0.3
2359,120,12,17,29,1,0.3
2360,120,13,27,40,1,0.3
2361,120,11,26,37,1,0.3
2362,120,24,40,64,1,0.3
2363,120,3,4,7,1,0.3
2364,120,12,23,35,1,0.3
2365,120,30,41,71,1,0.3
2366,120,19,53,72,1,0.3
2367,120,10,13,23,1,0.3
2368,120,15,35,50,1,0.3
2369,120,20,21,41,1,0.3
2370,120,41,62,103,1,0.3
2371,120,4,27,31,1,0.3
2372,120,13,17,30,1,0.3
2373,120,46,60,106,1,0.3
2374,120,2,1,3,1,0.3
2375,120,3,7,10,1,0.3
2376,120,15,21,36,1,0.3
2377,120,4,13,17,1,0.3
2378,120,2,3,5,1,0.3
2379,120,8,1,9,1,0.3
2380,120,44,39,83,1,0.3
2381,120,32,43,75,1,0.3
2382,120,21,33,54,1,0.3
2383,120,19,13,32,1,0.3
2384,120,40,64,104,1,0.3
2385,120,33,79,112,1,0.3
2386,120,27,38,65,1,0.3
2387,120,22,66,88,1,0.3
2388,120,13,23,36,1,0.3
2389,120,8,17,25,1,0.3
2390,120,14,26,40,1,0.3
2391,120,19,28,47,1,0.3
2392,120,21,18,39,1,0.3
2393,120,5,10,15,1,0.3
2394,120,62,99,161,1,0.3
2395,120,39,54,93,1,0.3
2396,120,77,101,178,1,0.3
2397,120,25,52,77,1,0.3
2398,120,14,39,53,1,0.3
2399,120,23,48,71,1,0.3
2400,120,17,35,52,1,0.3
2401,120,20,23,43,1,0.3
2402,120,32,11,43,1,0.3
2403,120,15,27,42,1,0.3
2404,120,3,13,16,1,0.3
2405,120,5,12,17,1,0.3
2406,120,37,44,81,1,0.3
2407,120,5,10,15,1,0.3
2408,120,19,28,47,1,0.3
2409,120,42,37,79,1,0.3
2410,120,17,19,36,1,0.3
2411,120,52,70,122,1,0.3
2412,120,50,100,150,1,0.3
2413,120,27,25,52,1,0.3
2414,120,3,11,14,1,0.3
2415,120,25,38,63,1,0.3
2416,120,39,56,95,1,0.3
2417,120,3,5,8,1,0.3
2418,120,12,29,41,1,0.3
2419,120,25,33,58,1,0.3
2420,120,31,26,57,1,0.3
2421,120,3,6,9,1,0.3
2422,120,11,15,26,1,0.3
2423,120,11,10,21,1,0.3
2424,120,6,9,15,1,0.3
2425,120,21,47,68,1,0.3
2426,120,28,63,91,1,0.3
2427,120,31,63,94,1,0.3
2428,120,27,46,73,1,0.3
2429,120,38,38,76,1,0.3
2430,120,74,174,248,1,0.3
2431,120,60,65,125,1,0.3
2432,120,3,6,9,1,0.3
2433,120,16,31,47,1,0.3
2434,120,17,33,50,1,0.3
2435,120,22,33,55,1,0.3
2436,120,10,26,36,1,0.3
2437,120,28,43,71,1,0.3
2438,120,9,21,30,1,0.3
2439,120,3,8,11,1,0.3
2440,120,1,5,6,1,0.3
2441,120,21,13,34,1,0.3
2442,120,78,132,210,1,0.3
2443,120,15,35,50,1,0.3
2444,120,30,50,80,1,0.3
2445,120,27,31,58,1,0.3
2446,120,41,45,86,1,0.3
2447,120,67,84,151,1,0.3
2448,120,88,145,233,1,0.3
2449,120,45,67,112,1,0.3
2450,120,72,76,148,1,0.3
2451,120,35,79,114,1,0.3
2452,120,4,10,14,1,0.3
2453,120,30,58,88,1,0.3
2454,120,9,6,15,1,0.3
2455,120,9,17,26,1,0.3
2456,120,22,48,70,1,0.3
2457,120,8,12,20,1,0.3
2458,120,25,33,58,1,0.3
2459,120,21,23,44,1,0.3
2460,120,25,28,53,1,0.3
2461,120,12,21,33,1,0.3
2462,120,33,48,81,1,0.3
2463,120,25,29,54,1,0.3
2464,120,30,23,53,1,0.3
2465,120,34,53,87,1,0.3
2466,120,18,19,37,1,0.3
2467,120,3,3,6,1,0.3
2468,120,8,11,19,1,0.3
2469,120,17,11,28,1,0.3
2470,120,3,3,6,1,0.3
2471,120,17,6,23,1,0.3
2472,120,4,6,10,1,0.3
2473,120,33,128,161,1,0.3
2474,120,30,46,76,1,0.3
2475,120,7,7,14,1,0.3
2476,120,29,77,106,1,0.3
2477,120,32,96,128,1,0.3
2478,120,16,22,38,1,0.3
2479,120,66,154,220,1,0.3
2480,120,17,49,66,1,0.3
2481,120,33,44,77,1,0.3
2482,120,46,83,129,1,0.3
2483,120,24,20,44,1,0.3
2484,120,41,31,72,1,0.3
2485,120,23,27,50,1,0.3
2486,120,26,30,56,1,0.3
2487,120,13,46,59,1,0.3
2488,120,13,34,47,1,0.3
2489,120,24,47,71,1,0.3
2490,120,39,39,78,1,0.3
2491,120,2,6,8,1,0.3
2492,120,40,91,131,1,0.3
2493,120,42,74,116,1,0.3
2494,120,39,93,132,1,0.3
2495,120,24,57,81,1,0.3
2496,120,19,57,76,1,0.3
2497,120,21,68,89,1,0.3
2498,120,52,126,178,1,0.3
2499,120,23,32,55,1,0.3
2500,120,31,79,110,1,0.3
2501,120,18,35,53,1,0.3
2502,120,50,66,116,1,0.3
2503,120,34,58,92,1,0.3
2504,120,5,5,10,1,0.3
2505,120,2,10,12,1,0.3
2506,120,57,114,171,1,0.3
2507,120,50,124,174,1,0.3
2508,120,44,113,157,1,0.3
2509,120,11,33,44,1,0.3
2510,120,18,57,75,1,0.3
2511,120,77,82,159,1,0.3
2512,120,28,14,42,1,0.3
2513,120,20,50,70,1,0.3
2514,120,12,37,49,1,0.3
2515,120,7,7,14,1,0.3
2516,120,2,2,4,1,0.3
2517,120,4,4,8,1,0.3
2518,120,0,3,3,1,0.3
2519,120,2,1,3,1,0.3
2520,120,40,102,142,1,0.3
2521,120,26,115,141,1,0.3
2522,120,22,69,91,1,0.3
2523,120,38,89,127,1,0.3
2524,120,36,92,128,1,0.3
2525,120,28,53,81,1,0.3
2526,120,22,62,84,1,0.3
2527,120,61,140,201,1,0.3
2528,120,11,22,33,1,0.3
2529,120,13,43,56,1,0.3
2530,120,7,11,18,1,0.3
2531,120,7,18,25,1,0.3
2532,120,21,37,58,1,0.3
2533,120,12,20,32,1,0.3
2534,120,1,1,2,1,0.3
2535,120,0,5,5,1,0.3
2536,120,2,3,5,1,0.3
2537,120,11,19,30,1,0.3
2538,120,47,75,122,1,0.3
2539,120,53,153,206,1,0.3
2540,120,24,70,94,1,0.3
2541,120,15,45,60,1,0.3
2542,120,41,103,144,1,0.3
2543,120,42,47,89,1,0.3
2544,120,54,133,187,1,0.3
2545,120,18,64,82,1,0.3
2546,120,14,51,65,1,0.3
2547,120,8,58,66,1,0.3
2548,120,9,48,57,1,0.3
2549,120,22,40,62,1,0.3
2550,120,12,14,26,1,0.3
2551,120,4,7,11,1,0.3
2552,120,15,9,24,1,0.3
2553,120,1,5,6,1,0.3
2554,120,4,10,14,1,0.3
2555,120,4,10,14,1,0.3
2556,120,1,13,14,1,0.3
2557,120,53,74,127,1,0.3
2558,120,63,61,124,1,0.3
2559,120,25,55,80,1,0.3
2560,120,38,125,163,1,0.3
2561,120,25,68,93,1,0.3
2562,120,55,84,139,1,0.3
2563,120,19,40,59,1,0.3
2564,120,25,30,55,1,0.3
2565,120,18,84,102,1,0.3
2566,120,14,20,34,1,0.3
2567,120,34,85,119,1,0.3
2568,120,20,16,36,1,0.3
2569,120,20,27,47,1,0.3
2570,120,17,16,33,1,0.3
2571,120,8,42,50,1,0.3
2572,120,3,2,5,1,0.3
2573,120,2,11,13,1,0.3
2574,120,3,1,4,1,0.3
2575,120,5,7,12,1,0.3
2576,120,20,66,86,1,0.3
2577,120,26,74,100,1,0.3
2578,120,28,83,111,1,0.3
2579,120,24,69,93,1,0.3
2580,120,44,169,213,1,0.3
2581,120,21,31,52,1,0.3
2582,120,38,43,81,1,0.3
2583,120,51,96,147,1,0.3
2584,120,31,54,85,1,0.3
2585,120,34,75,109,1,0.3
2586,120,20,43,63,1,0.3
2587,120,7,13,20,1,0.3
2588,120,40,32,72,1,0.3
2589,120,7,17,24,1,0.3
2590,120,10,6,16,1,0.3
2591,120,12,28,40,1,0.3
2592,120,0,4,4,1,0.3
2593,120,41,42,83,1,0.3
2594,120,123,242,365,1,0.3
2595,120,32,68,100,1,0.3
2596,120,62,182,244,1,0.3
2597,120,90,185,275,1,0.3
2598,120,17,36,53,1,0.3
2599,120,34,93,127,1,0.3
2600,120,48,70,118,1,0.3
2601,120,52,103,155,1,0.3
2602,120,35,40,75,1,0.3
2603,120,41,86,127,1,0.3
2604,120,28,46,74,1,0.3
2605,120,16,28,44,1,0.3
2606,120,11,14,25,1,0.3
2607,120,25,52,77,1,0.3
2608,120,93,214,307,1,0.3
2609,120,40,64,104,1,0.3
2610,120,40,42,82,1,0.3
2611,120,129,160,289,1,0.3
2612,120,49,41,90,1,0.3
2613,120,41,43,84,1,0.3
2614,120,101,108,209,1,0.3
2615,120,14,42,56,1,0.3
2616,120,6,39,45,1,0.3
2617,120,8,19,27,1,0.3
2618,120,28,39,67,1,0.3
2619,120,22,41,63,1,0.3
2620,120,49,61,110,1,0.3
2621,120,22,52,74,1,0.3
2622,120,41,59,100,1,0.3
2623,120,29,42,71,1,0.3
2624,120,38,47,85,1,0.3
2625,120,50,81,131,1,0.3
2626,120,26,32,58,1,0.3
2627,120,36,58,94,1,0.3
2628,120,19,23,42,1,0.3
2629,120,36,59,95,1,0.3
2630,120,43,38,81,1,0.3
2631,120,19,18,37,1,0.3
2632,120,7,37,44,1,0.3
2633,120,6,25,31,1,0.3
2634,120,32,38,70,1,0.3
2635,120,27,47,74,1,0.3
2636,120,39,49,88,1,0.3
2637,120,26,35,61,1,0.3
2638,120,30,21,51,1,0.3
2639,120,64,87,151,1,0.3
2640,120,16,36,52,1,0.3
2641,120,17,47,64,1,0.3
2642,120,18,21,39,1,0.3
2643,120,67,100,167,1,0.3
2644,120,26,41,67,1,0.3
2645,120,11,16,27,1,0.3
2646,120,3,7,10,1,0.3
2647,120,20,38,58,1,0.3
2648,120,37,33,70,1,0.3
2649,120,53,64,117,1,0.3
2650,120,30,57,87,1,0.3
2651,120,34,60,94,1,0.3
2652,120,12,31,43,1,0.3
2653,120,42,57,99,1,0.3
2654,120,3,8,11,1,0.3
2655,120,36,66,102,1,0.3
2656,120,2,2,4,1,0.3
2657,120,24,41,65,1,0.3
2658,120,11,20,31,1,0.3
2659,120,19,25,44,1,0.3
2660,120,87,167,254,1,0.3
2661,120,49,130,179,1,0.3
2662,120,31,45,76,1,0.3
2663,120,33,63,96,1,0.3
2664,120,34,52,86,1,0.3
2665,120,9,41,50,1,0.3
2666,120,21,31,52,1,0.3
2667,120,30,56,86,1,0.3
2668,120,23,25,48,1,0.3
2669,120,6,10,16,1,0.3
2670,120,18,34,52,1,0.3
2671,120,13,16,29,1,0.3
2672,120,36,44,80,1,0.3
2673,120,13,19,32,1,0.3
2674,120,39,44,83,1,0.3
2675,120,50,107,157,1,0.3
2676,120,16,19,35,1,0.3
2677,120,25,55,80,1,0.3
2678,120,44,56,100,1,0.3
2679,120,17,35,52,1,0.3
2680,120,32,26,58,1,0.3
2681,120,9,12,21,1,0.3
2682,120,4,10,14,1,0.3
2683,120,29,34,63,1,0.3
2684,120,12,13,25,1,0.3
2685,120,23,35,58,1,0.3
2686,120,23,27,50,1,0.3
2687,120,7,30,37,1,0.3
2688,180,18,15,33,1,0.3
2689,180,25,33,58,1,0.3
2690,180,18,60,78,1,0.3
2691,180,23,31,54,1,0.3
2692,180,27,45,72,1,0.3
2693,180,18,25,43,1,0.3
2694,180,8,25,33,1,0.3
2695,180,20,57,77,1,0.3
2696,180,20,55,75,1,0.3
2697,180,11,29,40,1,0.3
2698,180,7,8,15,1,0.3
2699,180,13,33,46,1,0.3
2700,180,20,32,52,1,0.3
2701,180,7,9,16,1,0.3
2702,180,10,26,36,1,0.3
2703,180,6,11,17,1,0.3
2704,180,12,24,36,1,0.3
2705,180,28,54,82,1,0.3
2706,180,17,28,45,1,0.3
2707,180,19,41,60,1,0.3
2708,180,23,47,70,1,0.3
2709,180,29,47,76,1,0.3
2710,180,20,66,86,1,0.3
2711,180,19,52,71,1,0.3
2712,180,18,23,41,1,0.3
2713,180,20,47,67,1,0.3
2714,180,6,11,17,1,0.3
2715,180,29,76,105,1,0.3
2716,180,50,59,109,1,0.3
2717,180,9,10,19,1,0.3
2718,180,4,5,9,1,0.3
2719,180,11,24,35,1,0.3
2720,180,48,135,183,1,0.3
2721,180,28,27,55,1,0.3
2722,180,19,101,120,1,0.3
2723,180,35,63,98,1,0.3
2724,180,21,63,84,1,0.3
2725,180,10,28,38,1,0.3
2726,180,28,83,111,1,0.3
2727,180,22,78,100,1,0.3
2728,180,20,47,67,1,0.3
2729,180,19,19,38,1,0.3
2730,180,1,6,7,1,0.3
2731,180,9,15,24,1,0.3
2732,180,0,2,2,1,0.3
2733,180,9,43,52,1,0.3
2734,180,10,13,23,1,0.3
2735,180,37,53,90,1,0.3
2736,180,35,108,143,1,0.3
2737,180,24,61,85,1,0.3
2738,180,11,41,52,1,0.3
2739,180,13,61,74,1,0.3
2740,180,7,15,22,1,0.3
2741,180,7,19,26,1,0.3
2742,180,21,21,42,1,0.3
2743,180,8,25,33,1,0.3
2744,180,3,26,29,1,0.3
2745,180,5,11,16,1,0.3
2746,180,7,20,27,1,0.3
2747,180,9,23,32,1,0.3
2748,180,1,13,14,1,0.3
2749,180,2,6,8,1,0.3
2750,180,58,174,232,1,0.3
2751,180,8,30,38,1,0.3
2752,180,14,27,41,1,0.3
2753,180,30,55,85,1,0.3
2754,180,36,115,151,1,0.3
2755,180,42,151,193,1,0.3
2756,180,79,149,228,1,0.3
2757,180,25,168,193,1,0.3
2758,180,71,123,194,1,0.3
2759,180,6,34,40,1,0.3
2760,180,37,60,97,1,0.3
2761,180,19,54,73,1,0.3
2762,180,16,26,42,1,0.3
2763,180,6,5,11,1,0.3
2764,180,117,165,282,1,0.3
2765,180,80,177,257,1,0.3
2766,180,25,80,105,1,0.3
2767,180,71,206,277,1,0.3
2768,180,70,186,256,1,0.3
2769,180,111,155,266,1,0.3
2770,180,54,177,231,1,0.3
2771,180,37,123,160,1,0.3
2772,180,66,148,214,1,0.3
2773,180,19,52,71,1,0.3
2774,180,7,19,26,1,0.3
2775,180,13,54,67,1,0.3
2776,180,20,34,54,1,0.3
2777,180,10,27,37,1,0.3
2778,180,22,34,56,1,0.3
2779,180,0,5,5,1,0.3
2780,180,12,68,80,1,0.3
2781,180,12,49,61,1,0.3
2782,180,50,199,249,1,0.3
2783,180,5,10,15,1,0.3
2784,180,15,42,57,1,0.3
2785,180,32,78,110,1,0.3
2786,180,20,43,63,1,0.3
2787,180,16,27,43,1,0.3
2788,180,19,146,165,1,0.3
2789,180,27,85,112,1,0.3
2790,180,5,8,13,1,0.3
2791,180,14,18,32,1,0.3
2792,180,29,91,120,1,0.3
2793,180,13,28,41,1,0.3
2794,180,6,9,15,1,0.3
2795,180,2,6,8,1,0.3
2796,180,7,11,18,1,0.3
2797,180,0,0,0,1,0.3
2798,180,3,4,7,1,0.3
2799,180,6,15,21,1,0.3
2800,180,35,65,100,1,0.3
2801,180,8,65,73,1,0.3
2802,180,9,7,16,1,0.3
2803,180,34,199,233,1,0.3
2804,180,79,147,226,1,0.3
2805,180,21,71,92,1,0.3
2806,180,39,145,184,1,0.3
2807,180,28,58,86,1,0.3
2808,180,7,10,17,1,0.3
2809,180,44,80,124,1,0.3
2810,180,14,27,41,1,0.3
2811,180,13,18,31,1,0.3
2812,180,0,0,0,1,0.3
2813,180,5,9,14,1,0.3
2814,180,60,104,164,1,0.3
2815,180,24,87,111,1,0.3
2816,180,5,67,72,1,0.3
2817,180,21,104,125,1,0.3
2818,180,22,122,144,1,0.3
2819,180,26,145,171,1,0.3
2820,180,20,115,135,1,0.3
2821,180,10,17,27,1,0.3
2822,180,18,73,91,1,0.3
2823,180,15,18,33,1,0.3
2824,180,12,14,26,1,0.3
2825,180,7,15,22,1,0.3
2826,180,14,29,43,1,0.3
2827,180,0,10,10,1,0.3
2828,180,59,139,198,1,0.3
2829,180,21,80,101,1,0.3
2830,180,37,46,83,1,0.3
2831,180,24,115,139,1,0.3
2832,180,30,56,86,1,0.3
2833,180,6,20,26,1,0.3
2834,180,25,58,83,1,0.3
2835,180,11,117,128,1,0.3
2836,180,6,39,45,1,0.3
2837,180,20,64,84,1,0.3
2838,180,25,65,90,1,0.3
2839,180,24,49,73,1,0.3
2840,180,32,112,144,1,0.3
2841,180,21,29,50,1,0.3
2842,180,21,46,67,1,0.3
2843,180,3,26,29,1,0.3
2844,180,24,103,127,1,0.3
2845,180,30,66,96,1,0.3
2846,180,53,155,208,1,0.3
2847,180,29,163,192,1,0.3
2848,180,25,36,61,1,0.3
2849,180,18,132,150,1,0.3
2850,180,34,87,121,1,0.3
2851,180,57,122,179,1,0.3
2852,180,18,47,65,1,0.3
2853,180,19,42,61,1,0.3
2854,180,19,59,78,1,0.3
2855,180,12,17,29,1,0.3
2856,180,17,36,53,1,0.3
2857,180,2,3,5,1,0.3
2858,180,6,23,29,1,0.3
2859,180,32,123,155,1,0.3
2860,180,46,45,91,1,0.3
2861,180,45,169,214,1,0.3
2862,180,26,80,106,1,0.3
2863,180,82,297,379,1,0.3
2864,180,26,44,70,1,0.3
2865,180,20,58,78,1,0.3
2866,180,75,114,189,1,0.3
2867,180,64,96,160,1,0.3
2868,180,56,161,217,1,0.3
2869,180,37,115,152,1,0.3
2870,180,65,76,141,1,0.3
2871,180,17,27,44,1,0.3
2872,180,49,88,137,1,0.3
2873,180,8,15,23,1,0.3
2874,180,103,279,382,1,0.3
2875,180,46,156,202,1,0.3
2876,180,41,68,109,1,0.3
2877,180,42,131,173,1,0.3
2878,180,82,265,347,1,0.3
2879,180,37,108,145,1,0.3
2880,180,44,164,208,1,0.3
2881,180,26,149,175,1,0.3
2882,180,38,81,119,1,0.3
2883,180,24,63,87,1,0.3
2884,180,19,50,69,1,0.3
2885,180,1,12,13,1,0.3
2886,180,23,67,90,1,0.3
2887,180,44,52,96,1,0.3
2888,180,46,81,127,1,0.3
2889,180,46,114,160,1,0.3
2890,180,30,68,98,1,0.3
2891,180,23,42,65,1,0.3
2892,180,30,229,259,1,0.3
2893,180,36,158,194,1,0.3
2894,180,14,36,50,1,0.3
2895,180,19,37,56,1,0.3
2896,180,26,51,77,1,0.3
2897,180,12,29,41,1,0.3
2898,180,13,31,44,1,0.3
2899,180,24,19,43,1,0.3
2900,180,11,14,25,1,0.3
2901,180,23,30,53,1,0.3
2902,180,1,10,11,1,0.3
2903,180,5,11,16,1,0.3
2904,180,12,48,60,1,0.3
2905,180,18,59,77,1,0.3
2906,180,9,45,54,1,0.3
2907,180,51,55,106,1,0.3
2908,180,26,85,111,1,0.3
2909,180,14,80,94,1,0.3
2910,180,10,24,34,1,0.3
2911,180,6,40,46,1,0.3
2912,180,19,59,78,1,0.3
2913,180,37,31,68,1,0.3
2914,180,17,25,42,1,0.3
2915,180,4,14,18,1,0.3
2916,180,7,22,29,1,0.3
2917,180,4,30,34,1,0.3
2918,180,4,5,9,1,0.3
2919,180,49,68,117,1,0.3
2920,180,38,47,85,1,0.3
2921,180,32,50,82,1,0.3
2922,180,50,79,129,1,0.3
2923,180,26,13,39,1,0.3
2924,180,21,36,57,1,0.3
2925,180,33,40,73,1,0.3
2926,180,69,87,156,1,0.3
2927,180,20,71,91,1,0.3
2928,180,19,33,52,1,0.3
2929,180,28,37,65,1,0.3
2930,180,23,44,67,1,0.3
2931,180,20,29,49,1,0.3
2932,180,22,14,36,1,0.3
2933,180,26,43,69,1,0.3
2934,180,9,20,29,1,0.3
2935,180,1,2,3,1,0.3
2936,180,25,42,67,1,0.3
2937,180,11,34,45,1,0.3
2938,180,25,37,62,1,0.3
2939,180,7,33,40,1,0.3
2940,180,44,47,91,1,0.3
2941,180,15,43,58,1,0.3
2942,180,8,9,17,1,0.3
2943,180,9,29,38,1,0.3
2944,180,36,42,78,1,0.3
2945,180,45,60,105,1,0.3
2946,180,16,13,29,1,0.3
2947,180,21,46,67,1,0.3
2948,180,10,15,25,1,0.3
2949,180,10,35,45,1,0.3
2950,180,31,61,92,1,0.3
2951,180,3,11,14,1,0.3
2952,180,31,20,51,1,0.3
2953,180,12,32,44,1,0.3
2954,180,5,5,10,1,0.3
2955,180,57,65,122,1,0.3
2956,180,25,102,127,1,0.3
2957,180,56,65,121,1,0.3
2958,180,30,55,85,1,0.3
2959,180,16,53,69,1,0.3
2960,180,18,40,58,1,0.3
2961,180,19,24,43,1,0.3
2962,180,39,45,84,1,0.3
2963,180,31,39,70,1,0.3
2964,180,23,47,70,1,0.3
2965,180,58,82,140,1,0.3
2966,180,25,23,48,1,0.3
2967,180,36,72,108,1,0.3
2968,180,53,90,143,1,0.3
2969,180,19,73,92,1,0.3
2970,180,14,31,45,1,0.3
2971,180,19,20,39,1,0.3
2972,180,32,48,80,1,0.3
2973,180,16,28,44,1,0.3
2974,180,14,23,37,1,0.3
2975,180,9,12,21,1,0.3
2976,180,65,94,159,1,0.3
2977,180,13,23,36,1,0.3
2978,180,29,55,84,1,0.3
2979,180,45,66,111,1,0.3
2980,180,10,9,19,1,0.3
2981,180,11,13,24,1,0.3
2982,180,12,21,33,1,0.3
2983,180,5,12,17,1,0.3
2984,180,2,3,5,1,0.3
2985,180,9,9,18,1,0.3
2986,180,42,38,80,1,0.3
2987,180,12,12,24,1,0.3
2988,180,4,11,15,1,0.3
2989,180,3,20,23,1,0.3
2990,180,5,5,10,1,0.3
2991,180,11,16,27,1,0.3
2992,180,5,10,15,1,0.3
2993,180,55,100,155,1,0.3
2994,180,80,106,186,1,0.3
2995,180,12,5,17,1,0.3
2996,180,10,10,20,1,0.3
2997,180,36,52,88,1,0.3
2998,180,3,12,15,1,0.3
2999,180,22,27,49,1,0.3
3000,180,21,22,43,1,0.3
3001,180,10,20,30,1,0.3
3002,180,4,26,30,1,0.3
3003,180,17,50,67,1,0.3
3004,180,46,86,132,1,0.3
3005,180,4,6,10,1,0.3
3006,180,55,84,139,1,0.3
3007,180,1,2,3,1,0.3
3008,180,3,8,11,1,0.3
3009,180,7,2,9,1,0.3
3010,180,9,3,12,1,0.3
3011,180,7,13,20,1,0.3
3012,180,27,45,72,1,0.3
3013,180,25,44,69,1,0.3
3014,180,23,33,56,1,0.3
3015,180,31,27,58,1,0.3
3016,180,2,16,18,1,0.3
3017,180,27,47,74,1,0.3
3018,180,3,2,5,1,0.3
3019,180,12,14,26,1,0.3
3020,180,3,9,12,1,0.3
3021,180,14,19,33,1,0.3
3022,180,72,278,350,1,0.3
3023,180,32,74,106,1,0.3
3024,180,13,24,37,1,0.3
3025,180,0,16,16,1,0.3
3026,180,42,49,91,1,0.3
3027,180,59,127,186,1,0.3
3028,180,23,40,63,1,0.3
3029,180,24,78,102,1,0.3
3030,180,27,37,64,1,0.3
3031,180,30,48,78,1,0.3
3032,180,17,93,110,1,0.3
3033,180,56,92,148,1,0.3
3034,180,16,32,48,1,0.3
3035,180,22,14,36,1,0.3
3036,180,17,38,55,1,0.3
3037,180,9,22,31,1,0.3
3038,180,26,26,52,1,0.3
3039,180,12,25,37,1,0.3
3040,180,34,66,100,1,0.3
3041,180,8,22,30,1,0.3
3042,180,54,116,170,1,0.3
3043,180,28,73,101,1,0.3
3044,180,50,66,116,1,0.3
3045,180,16,22,38,1,0.3
3046,180,19,8,27,1,0.3
3047,180,6,13,19,1,0.3
3048,180,14,39,53,1,0.3
3049,180,18,30,48,1,0.3
3050,180,7,15,22,1,0.3
3051,180,2,0,2,1,0.3
3052,180,82,38,120,1,0.3
3053,180,5,14,19,1,0.3
3054,180,3,4,7,1,0.3
3055,180,10,54,64,1,0.3
3056,180,64,113,177,1,0.3
3057,180,17,39,56,1,0.3
3058,180,11,35,46,1,0.3
3059,180,40,66,106,1,0.3
3060,180,32,37,69,1,0.3
3061,180,0,2,2,1,0.3
3062,180,31,38,69,1,0.3
3063,180,9,12,21,1,0.3
3064,180,3,12,15,1,0.3
3065,180,3,4,7,1,0.3
3066,180,14,20,34,1,0.3
3067,180,28,63,91,1,0.3
3068,180,19,15,34,1,0.3
3069,180,9,21,30,1,0.3
3070,180,22,40,62,1,0.3
3071,180,27,27,54,1,0.3
3072,180,12,20,32,1,0.3
3073,180,18,27,45,1,0.3
3074,180,14,12,26,1,0.3
3075,180,25,36,61,1,0.3
3076,180,12,16,28,1,0.3
3077,180,45,37,82,1,0.3
3078,180,15,18,33,1,0.3
3079,180,3,10,13,1,0.3
3080,180,0,3,3,1,0.3
3081,180,12,39,51,1,0.3
3082,180,8,4,12,1,0.3
3083,180,8,19,27,1,0.3
3084,180,16,26,42,1,0.3
3085,180,27,50,77,1,0.3
3086,180,9,19,28,1,0.3
3087,180,9,14,23,1,0.3
3088,180,0,3,3,1,0.3
3089,180,35,37,72,1,0.3
3090,180,5,4,9,1,0.3
3091,180,14,31,45,1,0.3
3092,180,5,10,15,1,0.3
3093,180,25,32,57,1,0.3
3094,180,5,21,26,1,0.3
3095,180,25,38,63,1,0.3
3096,180,8,11,19,1,0.3
3097,180,22,40,62,1,0.3
3098,180,57,70,127,1,0.3
3099,180,17,29,46,1,0.3
3100,180,12,14,26,1,0.3
3101,180,30,44,74,1,0.3
3102,180,17,9,26,1,0.3
3103,180,23,33,56,1,0.3
3104,180,10,18,28,1,0.3
3105,180,22,24,46,1,0.3
3106,180,27,40,67,1,0.3
3107,180,32,41,73,1,0.3
3108,180,16,28,44,1,0.3
3109,180,15,25,40,1,0.3
3110,180,15,15,30,1,0.3
3111,180,4,11,15,1,0.3
3112,180,5,5,10,1,0.3
3113,180,5,1,6,1,0.3
3114,180,13,35,48,1,0.3
3115,180,21,21,42,1,0.3
3116,180,46,63,109,1,0.3
3117,180,56,58,114,1,0.3
3118,180,29,21,50,1,0.3
3119,180,51,69,120,1,0.3
3120,180,37,33,70,1,0.3
3121,180,76,99,175,1,0.3
3122,180,43,65,108,1,0.3
3123,180,8,25,33,1,0.3
3124,180,27,39,66,1,0.3
3125,180,34,32,66,1,0.3
3126,180,4,54,58,1,0.3
3127,180,13,12,25,1,0.3
3128,180,25,22,47,1,0.3
3129,180,1,8,9,1,0.3
3130,180,28,58,86,1,0.3
3131,180,11,13,24,1,0.3
3132,180,46,45,91,1,0.3
3133,180,16,25,41,1,0.3
3134,180,19,36,55,1,0.3
3135,180,23,45,68,1,0.3
3136,180,33,70,103,1,0.3
3137,180,60,61,121,1,0.3
3138,180,20,16,36,1,0.3
3139,180,98,127,225,1,0.3
3140,180,38,66,104,1,0.3
3141,180,52,52,104,1,0.3
3142,180,10,9,19,1,0.3
3143,180,47,21,68,1,0.3
3144,180,23,36,59,1,0.3
3145,180,4,19,23,1,0.3
3146,180,30,46,76,1,0.3
3147,30,27,57,84,1,1.0
3148,30,25,83,108,1,1.0
3149,30,18,56,74,1,1.0
3150,30,47,142,189,1,1.0
3151,30,11,13,24,1,1.0
3152,30,38,79,117,1,1.0
3153,30,83,149,232,1,1.0
3154,30,33,75,108,1,1.0
3155,30,15,26,41,1,1.0
3156,30,4,14,18,1,1.0
3157,30,67,66,133,1,1.0
3158,30,45,24,69,1,1.0
3159,30,1,4,5,1,1.0
3160,30,19,68,87,1,1.0
3161,30,12,55,67,1,1.0
3162,30,24,104,128,1,1.0
3163,30,5,24,29,1,1.0
3164,30,38,79,117,1,1.0
3165,30,23,47,70,1,1.0
3166,30,17,71,88,1,1.0
3167,30,44,84,128,1,1.0
3168,30,17,37,54,1,1.0
3169,30,24,53,77,1,1.0
3170,30,23,25,48,1,1.0
3171,30,9,26,35,1,1.0
3172,30,18,37,55,1,1.0
3173,30,20,66,86,1,1.0
3174,30,22,59,81,1,1.0
3175,30,18,31,49,1,1.0
3176,30,40,72,112,1,1.0
3177,30,35,120,155,1,1.0
3178,30,47,92,139,1,1.0
3179,30,12,46,58,1,1.0
3180,30,14,26,40,1,1.0
3181,30,39,61,100,1,1.0
3182,30,15,52,67,1,1.0
3183,30,3,12,15,1,1.0
3184,30,12,13,25,1,1.0
3185,30,12,23,35,1,1.0
3186,30,7,19,26,1,1.0
3187,30,72,71,143,1,1.0
3188,30,24,49,73,1,1.0
3189,30,40,73,113,1,1.0
3190,30,15,73,88,1,1.0
3191,30,36,61,97,1,1.0
3192,30,16,50,66,1,1.0
3193,30,26,28,54,1,1.0
3194,30,36,30,66,1,1.0
3195,30,15,23,38,1,1.0
3196,30,16,43,59,1,1.0
3197,30,6,11,17,1,1.0
3198,30,49,30,79,1,1.0
3199,30,16,32,48,1,1.0
3200,30,19,21,40,1,1.0
3201,30,15,20,35,1,1.0
3202,30,21,36,57,1,1.0
3203,30,15,27,42,1,1.0
3204,30,2,9,11,1,1.0
3205,30,0,0,0,1,1.0
3206,30,4,5,9,1,1.0
3207,30,42,50,92,1,1.0
3208,30,52,94,146,1,1.0
3209,30,16,76,92,1,1.0
3210,30,60,69,129,1,1.0
3211,30,31,111,142,1,1.0
3212,30,18,39,57,1,1.0
3213,30,31,58,89,1,1.0
3214,30,9,25,34,1,1.0
3215,30,20,43,63,1,1.0
3216,30,9,24,33,1,1.0
3217,30,20,51,71,1,1.0
3218,30,7,29,36,1,1.0
3219,30,17,15,32,1,1.0
3220,30,6,17,23,1,1.0
3221,30,14,16,30,1,1.0
3222,30,16,17,33,1,1.0
3223,30,7,22,29,1,1.0
3224,30,8,9,17,1,1.0
3225,30,27,17,44,1,1.0
3226,30,53,115,168,1,1.0
3227,30,4,12,16,1,1.0
3228,30,51,87,138,1,1.0
3229,30,41,95,136,1,1.0
3230,30,23,83,106,1,1.0
3231,30,86,67,153,1,1.0
3232,30,9,27,36,1,1.0
3233,30,28,77,105,1,1.0
3234,30,14,42,56,1,1.0
3235,30,30,93,123,1,1.0
3236,30,25,25,50,1,1.0
3237,30,15,27,42,1,1.0
3238,30,19,21,40,1,1.0
3239,30,4,9,13,1,1.0
3240,30,76,114,190,1,1.0
3241,30,54,97,151,1,1.0
3242,30,21,41,62,1,1.0
3243,30,240,356,596,1,1.0
3244,30,35,50,85,1,1.0
3245,30,24,31,55,1,1.0
3246,30,17,21,38,1,1.0
3247,30,58,97,155,1,1.0
3248,30,12,10,22,1,1.0
3249,30,1,1,2,1,1.0
3250,30,34,29,63,1,1.0
3251,30,10,12,22,1,1.0
3252,30,9,14,23,1,1.0
3253,30,0,2,2,1,1.0
3254,30,3,12,15,1,1.0
3255,30,36,77,113,1,1.0
3256,30,15,28,43,1,1.0
3257,30,106,137,243,1,1.0
3258,30,34,71,105,1,1.0
3259,30,16,14,30,1,1.0
3260,30,17,54,71,1,1.0
3261,30,45,45,90,1,1.0
3262,30,15,19,34,1,1.0
3263,30,50,83,133,1,1.0
3264,30,85,94,179,1,1.0
3265,30,16,22,38,1,1.0
3266,30,17,29,46,1,1.0
3267,30,4,10,14,1,1.0
3268,30,10,13,23,1,1.0
3269,30,3,3,6,1,1.0
3270,30,32,77,109,1,1.0
3271,30,48,85,133,1,1.0
3272,30,61,133,194,1,1.0
3273,30,30,39,69,1,1.0
3274,30,32,39,71,1,1.0
3275,30,36,57,93,1,1.0
3276,30,10,12,22,1,1.0
3277,30,7,21,28,1,1.0
3278,30,13,25,38,1,1.0
3279,30,12,10,22,1,1.0
3280,30,16,14,30,1,1.0
3281,30,42,64,106,1,1.0
3282,30,47,65,112,1,1.0
3283,30,29,32,61,1,1.0
3284,30,31,53,84,1,1.0
3285,30,16,39,55,1,1.0
3286,30,17,65,82,1,1.0
3287,30,7,17,24,1,1.0
3288,30,21,27,48,1,1.0
3289,30,3,12,15,1,1.0
3290,30,6,18,24,1,1.0
3291,30,4,8,12,1,1.0
3292,30,3,4,7,1,1.0
3293,30,2,4,6,1,1.0
3294,30,48,90,138,1,1.0
3295,30,77,105,182,1,1.0
3296,30,19,12,31,1,1.0
3297,30,74,107,181,1,1.0
3298,30,13,20,33,1,1.0
3299,30,9,11,20,1,1.0
3300,30,69,34,103,1,1.0
3301,30,43,61,104,1,1.0
3302,30,17,15,32,1,1.0
3303,30,40,58,98,1,1.0
3304,30,7,30,37,1,1.0
3305,30,4,7,11,1,1.0
3306,30,18,21,39,1,1.0
3307,30,19,19,38,1,1.0
3308,30,6,10,16,1,1.0
3309,30,3,2,5,1,1.0
3310,30,6,2,8,1,1.0
3311,30,43,70,113,1,1.0
3312,30,21,48,69,1,1.0
3313,30,29,77,106,1,1.0
3314,30,32,12,44,1,1.0
3315,30,10,67,77,1,1.0
3316,30,18,25,43,1,1.0
3317,30,44,84,128,1,1.0
3318,30,10,23,33,1,1.0
3319,30,25,43,68,1,1.0
3320,30,11,23,34,1,1.0
3321,30,11,22,33,1,1.0
3322,30,8,13,21,1,1.0
3323,30,32,52,84,1,1.0
3324,30,19,24,43,1,1.0
3325,30,10,15,25,1,1.0
3326,30,24,69,93,1,1.0
3327,30,25,60,85,1,1.0
3328,30,22,48,70,1,1.0
3329,30,25,27,52,1,1.0
3330,30,20,40,60,1,1.0
3331,30,85,174,259,1,1.0
3332,30,12,20,32,1,1.0
3333,30,3,14,17,1,1.0
3334,30,18,30,48,1,1.0
3335,30,3,7,10,1,1.0
3336,30,18,40,58,1,1.0
3337,30,3,16,19,1,1.0
3338,30,20,36,56,1,1.0
3339,30,23,30,53,1,1.0
3340,30,58,76,134,1,1.0
3341,30,44,58,102,1,1.0
3342,30,44,72,116,1,1.0
3343,30,70,151,221,1,1.0
3344,30,25,55,80,1,1.0
3345,30,36,80,116,1,1.0
3346,30,23,47,70,1,1.0
3347,30,6,28,34,1,1.0
3348,30,13,25,38,1,1.0
3349,30,5,45,50,1,1.0
3350,30,12,15,27,1,1.0
3351,30,32,25,57,1,1.0
3352,30,4,8,12,1,1.0
3353,30,5,4,9,1,1.0
3354,30,22,52,74,1,1.0
3355,30,57,80,137,1,1.0
3356,30,15,10,25,1,1.0
3357,30,18,46,64,1,1.0
3358,30,7,42,49,1,1.0
3359,30,34,34,68,1,1.0
3360,30,52,83,135,1,1.0
3361,30,15,32,47,1,1.0
3362,30,20,26,46,1,1.0
3363,30,14,17,31,1,1.0
3364,30,41,31,72,1,1.0
3365,30,5,7,12,1,1.0
3366,30,28,26,54,1,1.0
3367,30,13,19,32,1,1.0
3368,30,19,17,36,1,1.0
3369,30,15,22,37,1,1.0
3370,30,9,8,17,1,1.0
3371,30,2,13,15,1,1.0
3372,30,75,92,167,1,1.0
3373,30,30,71,101,1,1.0
3374,30,74,120,194,1,1.0
3375,30,81,104,185,1,1.0
3376,30,13,37,50,1,1.0
3377,30,30,52,82,1,1.0
3378,30,31,90,121,1,1.0
3379,30,18,43,61,1,1.0
3380,30,21,35,56,1,1.0
3381,30,15,40,55,1,1.0
3382,30,4,14,18,1,1.0
3383,30,20,58,78,1,1.0
3384,30,38,92,130,1,1.0
3385,30,7,7,14,1,1.0
3386,30,56,138,194,1,1.0
3387,30,68,73,141,1,1.0
3388,30,13,17,30,1,1.0
3389,30,82,132,214,1,1.0
3390,30,25,85,110,1,1.0
3391,30,35,48,83,1,1.0
3392,30,45,93,138,1,1.0
3393,30,6,11,17,1,1.0
3394,30,7,11,18,1,1.0
3395,30,10,12,22,1,1.0
3396,30,11,23,34,1,1.0
3397,30,30,50,80,1,1.0
3398,30,10,15,25,1,1.0
3399,30,28,30,58,1,1.0
3400,30,35,62,97,1,1.0
3401,30,45,57,102,1,1.0
3402,30,29,43,72,1,1.0
3403,30,15,13,28,1,1.0
3404,30,27,53,80,1,1.0
3405,30,26,28,54,1,1.0
3406,30,20,20,40,1,1.0
3407,30,48,28,76,1,1.0
3408,30,37,50,87,1,1.0
3409,30,31,71,102,1,1.0
3410,30,35,66,101,1,1.0
3411,30,34,30,64,1,1.0
3412,30,34,53,87,1,1.0
3413,30,15,15,30,1,1.0
3414,30,15,25,40,1,1.0
3415,30,30,94,124,1,1.0
3416,30,8,8,16,1,1.0
3417,30,21,33,54,1,1.0
3418,30,34,46,80,1,1.0
3419,30,28,33,61,1,1.0
3420,30,22,54,76,1,1.0
3421,30,33,47,80,1,1.0
3422,30,5,17,22,1,1.0
3423,30,13,34,47,1,1.0
3424,30,8,19,27,1,1.0
3425,30,12,29,41,1,1.0
3426,30,29,58,87,1,1.0
3427,30,26,46,72,1,1.0
3428,30,27,48,75,1,1.0
3429,30,28,47,75,1,1.0
3430,30,28,59,87,1,1.0
3431,30,26,34,60,1,1.0
3432,30,17,42,59,1,1.0
3433,30,13,20,33,1,1.0
3434,30,46,58,104,1,1.0
3435,30,32,95,127,1,1.0
3436,30,27,31,58,1,1.0
3437,30,38,58,96,1,1.0
3438,30,28,61,89,1,1.0
3439,30,21,20,41,1,1.0
3440,30,15,50,65,1,1.0
3441,30,35,38,73,1,1.0
3442,30,35,76,111,1,1.0
3443,30,39,61,100,1,1.0
3444,30,12,23,35,1,1.0
3445,30,44,77,121,1,1.0
3446,30,80,154,234,1,1.0
3447,30,10,11,21,1,1.0
3448,30,43,44,87,1,1.0
3449,30,124,122,246,1,1.0
3450,30,142,104,246,1,1.0
3451,30,64,105,169,1,1.0
3452,30,14,23,37,1,1.0
3453,30,58,80,138,1,1.0
3454,30,12,21,33,1,1.0
3455,30,17,12,29,1,1.0
3456,30,48,40,88,1,1.0
3457,30,11,27,38,1,1.0
3458,30,9,6,15,1,1.0
3459,30,21,30,51,1,1.0
3460,30,27,25,52,1,1.0
3461,30,32,42,74,1,1.0
3462,30,27,36,63,1,1.0
3463,30,10,15,25,1,1.0
3464,30,15,46,61,1,1.0
3465,30,25,16,41,1,1.0
3466,30,11,19,30,1,1.0
3467,30,16,16,32,1,1.0
3468,30,10,19,29,1,1.0
3469,30,20,32,52,1,1.0
3470,30,38,43,81,1,1.0
3471,30,31,27,58,1,1.0
3472,30,13,18,31,1,1.0
3473,30,24,37,61,1,1.0
3474,30,8,8,16,1,1.0
3475,30,16,12,28,1,1.0
3476,30,19,16,35,1,1.0
3477,30,20,34,54,1,1.0
3478,30,32,62,94,1,1.0
3479,30,23,44,67,1,1.0
3480,30,5,8,13,1,1.0
3481,30,23,25,48,1,1.0
3482,30,4,7,11,1,1.0
3483,30,8,17,25,1,1.0
3484,30,8,3,11,1,1.0
3485,30,15,42,57,1,1.0
3486,30,6,14,20,1,1.0
3487,30,54,106,160,1,1.0
3488,30,27,72,99,1,1.0
3489,30,36,49,85,1,1.0
3490,30,44,107,151,1,1.0
3491,30,26,24,50,1,1.0
3492,30,22,33,55,1,1.0
3493,30,18,40,58,1,1.0
3494,30,26,104,130,1,1.0
3495,30,14,17,31,1,1.0
3496,30,20,50,70,1,1.0
3497,30,21,22,43,1,1.0
3498,30,18,23,41,1,1.0
3499,30,2,1,3,1,1.0
3500,30,31,53,84,1,1.0
3501,30,18,39,57,1,1.0
3502,30,36,94,130,1,1.0
3503,30,40,67,107,1,1.0
3504,30,27,27,54,1,1.0
3505,30,44,70,114,1,1.0
3506,30,36,59,95,1,1.0
3507,30,31,117,148,1,1.0
3508,30,17,46,63,1,1.0
3509,30,21,49,70,1,1.0
3510,30,7,26,33,1,1.0
3511,30,21,33,54,1,1.0
3512,30,16,22,38,1,1.0
3513,30,3,18,21,1,1.0
3514,30,34,52,86,1,1.0
3515,30,17,46,63,1,1.0
3516,30,67,92,159,1,1.0
3517,30,38,98,136,1,1.0
3518,30,38,71,109,1,1.0
3519,30,22,63,85,1,1.0
3520,30,10,27,37,1,1.0
3521,30,7,18,25,1,1.0
3522,30,22,61,83,1,1.0
3523,30,15,18,33,1,1.0
3524,30,3,15,18,1,1.0
3525,30,12,14,26,1,1.0
3526,30,2,3,5,1,1.0
3527,30,40,89,129,1,1.0
3528,30,17,26,43,1,1.0
3529,30,41,131,172,1,1.0
3530,30,30,30,60,1,1.0
3531,30,45,78,123,1,1.0
3532,30,130,161,291,1,1.0
3533,30,87,167,254,1,1.0
3534,30,106,188,294,1,1.0
3535,30,90,193,283,1,1.0
3536,30,38,42,80,1,1.0
3537,30,9,18,27,1,1.0
3538,30,12,31,43,1,1.0
3539,30,16,10,26,1,1.0
3540,30,3,3,6,1,1.0
3541,30,6,10,16,1,1.0
3542,30,2,2,4,1,1.0
3543,30,66,129,195,1,1.0
3544,30,48,50,98,1,1.0
3545,30,12,17,29,1,1.0
3546,30,38,67,105,1,1.0
3547,30,63,130,193,1,1.0
3548,30,92,163,255,1,1.0
3549,30,59,137,196,1,1.0
3550,30,68,76,144,1,1.0
3551,30,11,29,40,1,1.0
3552,30,64,72,136,1,1.0
3553,30,7,19,26,1,1.0
3554,30,4,16,20,1,1.0
3555,30,36,61,97,1,1.0
3556,30,59,91,150,1,1.0
3557,30,49,72,121,1,1.0
3558,30,29,69,98,1,1.0
3559,30,44,86,130,1,1.0
3560,30,36,39,75,1,1.0
3561,30,17,27,44,1,1.0
3562,30,29,13,42,1,1.0
3563,30,15,39,54,1,1.0
3564,30,15,23,38,1,1.0
3565,30,17,30,47,1,1.0
3566,30,1,30,31,1,1.0
3567,30,13,34,47,1,1.0
3568,50,113,143,256,1,1.0
3569,50,44,53,97,1,1.0
3570,50,38,48,86,1,1.0
3571,50,32,37,69,1,1.0
3572,50,19,40,59,1,1.0
3573,50,45,50,95,1,1.0
3574,50,40,51,91,1,1.0
3575,50,78,77,155,1,1.0
3576,50,19,14,33,1,1.0
3577,50,15,17,32,1,1.0
3578,50,33,48,81,1,1.0
3579,50,27,39,66,1,1.0
3580,50,20,22,42,1,1.0
3581,50,13,40,53,1,1.0
3582,50,11,10,21,1,1.0
3583,50,90,63,153,1,1.0
3584,50,10,16,26,1,1.0
3585,50,25,43,68,1,1.0
3586,50,71,34,105,1,1.0
3587,50,90,109,199,1,1.0
3588,50,23,41,64,1,1.0
3589,50,62,33,95,1,1.0
3590,50,55,65,120,1,1.0
3591,50,55,40,95,1,1.0
3592,50,57,53,110,1,1.0
3593,50,28,45,73,1,1.0
3594,50,33,52,85,1,1.0
3595,50,12,16,28,1,1.0
3596,50,40,31,71,1,1.0
3597,50,34,50,84,1,1.0
3598,50,48,72,120,1,1.0
3599,50,20,14,34,1,1.0
3600,50,39,60,99,1,1.0
3601,50,24,35,59,1,1.0
3602,50,8,9,17,1,1.0
3603,50,41,88,129,1,1.0
3604,50,30,31,61,1,1.0
3605,50,7,30,37,1,1.0
3606,50,20,15,35,1,1.0
3607,50,9,9,18,1,1.0
3608,50,86,137,223,1,1.0
3609,50,29,53,82,1,1.0
3610,50,17,41,58,1,1.0
3611,50,26,21,47,1,1.0
3612,50,40,36,76,1,1.0
3613,50,21,31,52,1,1.0
3614,50,40,64,104,1,1.0
3615,50,59,51,110,1,1.0
3616,50,67,89,156,1,1.0
3617,50,86,55,141,1,1.0
3618,50,56,61,117,1,1.0
3619,50,32,42,74,1,1.0
3620,50,14,11,25,1,1.0
3621,50,22,35,57,1,1.0
3622,50,21,45,66,1,1.0
3623,50,90,92,182,1,1.0
3624,50,9,20,29,1,1.0
3625,50,33,30,63,1,1.0
3626,50,32,31,63,1,1.0
3627,50,49,35,84,1,1.0
3628,50,37,59,96,1,1.0
3629,50,63,71,134,1,1.0
3630,50,33,31,64,1,1.0
3631,50,35,76,111,1,1.0
3632,50,22,38,60,1,1.0
3633,50,62,83,145,1,1.0
3634,50,12,42,54,1,1.0
3635,50,53,47,100,1,1.0
3636,50,45,61,106,1,1.0
3637,50,34,33,67,1,1.0
3638,50,45,63,108,1,1.0
3639,50,5,15,20,1,1.0
3640,50,16,30,46,1,1.0
3641,50,7,19,26,1,1.0
3642,50,53,32,85,1,1.0
3643,50,14,18,32,1,1.0
3644,50,35,63,98,1,1.0
3645,50,38,41,79,1,1.0
3646,50,31,53,84,1,1.0
3647,50,43,71,114,1,1.0
3648,50,33,44,77,1,1.0
3649,50,83,63,146,1,1.0
3650,50,17,14,31,1,1.0
3651,50,39,65,104,1,1.0
3652,50,31,41,72,1,1.0
3653,50,44,43,87,1,1.0
3654,50,16,25,41,1,1.0
3655,50,58,103,161,1,1.0
3656,50,50,64,114,1,1.0
3657,50,15,30,45,1,1.0
3658,50,17,26,43,1,1.0
3659,50,18,47,65,1,1.0
3660,50,61,35,96,1,1.0
3661,50,25,50,75,1,1.0
3662,50,51,74,125,1,1.0
3663,50,18,41,59,1,1.0
3664,50,52,82,134,1,1.0
3665,50,24,32,56,1,1.0
3666,50,33,43,76,1,1.0
3667,50,45,81,126,1,1.0
3668,50,40,73,113,1,1.0
3669,50,9,25,34,1,1.0
3670,50,18,32,50,1,1.0
3671,50,57,82,139,1,1.0
3672,50,23,42,65,1,1.0
3673,50,17,10,27,1,1.0
3674,50,6,4,10,1,1.0
3675,50,66,64,130,1,1.0
3676,50,13,11,24,1,1.0
3677,50,26,37,63,1,1.0
3678,50,23,56,79,1,1.0
3679,50,38,37,75,1,1.0
3680,50,38,74,112,1,1.0
3681,50,55,137,192,1,1.0
3682,50,74,100,174,1,1.0
3683,50,34,31,65,1,1.0
3684,50,26,16,42,1,1.0
3685,50,13,27,40,1,1.0
3686,50,24,31,55,1,1.0
3687,50,25,20,45,1,1.0
3688,50,34,52,86,1,1.0
3689,50,16,23,39,1,1.0
3690,50,33,44,77,1,1.0
3691,50,5,8,13,1,1.0
3692,50,5,2,7,1,1.0
3693,50,54,12,66,1,1.0
3694,50,7,15,22,1,1.0
3695,50,29,29,58,1,1.0
3696,50,14,15,29,1,1.0
3697,50,58,66,124,1,1.0
3698,50,65,68,133,1,1.0
3699,50,11,15,26,1,1.0
3700,50,32,43,75,1,1.0
3701,50,67,75,142,1,1.0
3702,50,184,294,478,1,1.0
3703,50,28,36,64,1,1.0
3704,50,32,29,61,1,1.0
3705,50,35,15,50,1,1.0
3706,50,55,55,110,1,1.0
3707,50,12,21,33,1,1.0
3708,50,8,13,21,1,1.0
3709,50,25,38,63,1,1.0
3710,50,15,44,59,1,1.0
3711,50,32,32,64,1,1.0
3712,50,39,41,80,1,1.0
3713,50,3,8,11,1,1.0
3714,50,7,12,19,1,1.0
3715,50,63,85,148,1,1.0
3716,50,58,66,124,1,1.0
3717,50,40,35,75,1,1.0
3718,50,62,111,173,1,1.0
3719,50,6,127,133,1,1.0
3720,50,12,29,41,1,1.0
3721,50,37,72,109,1,1.0
3722,50,61,78,139,1,1.0
3723,50,10,16,26,1,1.0
3724,50,24,22,46,1,1.0
3725,50,34,42,76,1,1.0
3726,50,25,29,54,1,1.0
3727,50,116,118,234,1,1.0
3728,50,58,94,152,1,1.0
3729,50,42,47,89,1,1.0
3730,50,14,23,37,1,1.0
3731,50,45,82,127,1,1.0
3732,50,49,47,96,1,1.0
3733,50,6,20,26,1,1.0
3734,50,51,84,135,1,1.0
3735,50,24,47,71,1,1.0
3736,50,18,33,51,1,1.0
3737,50,22,55,77,1,1.0
3738,50,24,43,67,1,1.0
3739,50,18,31,49,1,1.0
3740,50,2,8,10,1,1.0
3741,50,22,30,52,1,1.0
3742,50,49,95,144,1,1.0
3743,50,74,80,154,1,1.0
3744,50,17,37,54,1,1.0
3745,50,31,72,103,1,1.0
3746,50,30,57,87,1,1.0
3747,50,43,66,109,1,1.0
3748,50,29,26,55,1,1.0
3749,50,21,41,62,1,1.0
3750,50,45,57,102,1,1.0
3751,50,7,24,31,1,1.0
3752,50,14,20,34,1,1.0
3753,50,8,27,35,1,1.0
3754,50,18,20,38,1,1.0
3755,50,41,39,80,1,1.0
3756,50,50,34,84,1,1.0
3757,50,38,44,82,1,1.0
3758,50,18,8,26,1,1.0
3759,50,29,26,55,1,1.0
3760,50,33,32,65,1,1.0
3761,50,46,50,96,1,1.0
3762,50,35,26,61,1,1.0
3763,50,52,71,123,1,1.0
3764,50,44,37,81,1,1.0
3765,50,74,96,170,1,1.0
3766,50,23,20,43,1,1.0
3767,50,3,5,8,1,1.0
3768,50,62,72,134,1,1.0
3769,50,39,42,81,1,1.0
3770,50,33,42,75,1,1.0
3771,50,38,54,92,1,1.0
3772,50,32,44,76,1,1.0
3773,50,24,37,61,1,1.0
3774,50,19,49,68,1,1.0
3775,50,37,32,69,1,1.0
3776,50,10,17,27,1,1.0
3777,50,40,55,95,1,1.0
3778,50,43,44,87,1,1.0
3779,50,23,42,65,1,1.0
3780,50,10,6,16,1,1.0
3781,50,2,5,7,1,1.0
3782,50,7,5,12,1,1.0
3783,50,53,86,139,1,1.0
3784,50,81,54,135,1,1.0
3785,50,57,74,131,1,1.0
3786,50,63,101,164,1,1.0
3787,50,53,99,152,1,1.0
3788,50,32,31,63,1,1.0
3789,50,29,41,70,1,1.0
3790,50,29,29,58,1,1.0
3791,50,3,12,15,1,1.0
3792,50,34,8,42,1,1.0
3793,50,91,124,215,1,1.0
3794,50,47,77,124,1,1.0
3795,50,16,10,26,1,1.0
3796,50,83,96,179,1,1.0
3797,50,50,52,102,1,1.0
3798,50,31,40,71,1,1.0
3799,50,22,37,59,1,1.0
3800,50,30,58,88,1,1.0
3801,50,26,32,58,1,1.0
3802,50,36,23,59,1,1.0
3803,50,18,17,35,1,1.0
3804,50,19,11,30,1,1.0
3805,50,148,168,316,1,1.0
3806,50,36,64,100,1,1.0
3807,50,40,9,49,1,1.0
3808,50,38,116,154,1,1.0
3809,50,36,11,47,1,1.0
3810,50,24,11,35,1,1.0
3811,50,24,27,51,1,1.0
3812,50,37,53,90,1,1.0
3813,50,48,56,104,1,1.0
3814,50,22,55,77,1,1.0
3815,50,45,22,67,1,1.0
3816,50,43,57,100,1,1.0
3817,50,8,6,14,1,1.0
3818,50,30,42,72,1,1.0
3819,50,11,20,31,1,1.0
3820,50,5,4,9,1,1.0
3821,50,40,69,109,1,1.0
3822,50,51,96,147,1,1.0
3823,50,53,95,148,1,1.0
3824,50,30,40,70,1,1.0
3825,50,82,119,201,1,1.0
3826,50,57,79,136,1,1.0
3827,50,9,14,23,1,1.0
3828,50,98,126,224,1,1.0
3829,50,36,21,57,1,1.0
3830,50,54,89,143,1,1.0
3831,50,82,56,138,1,1.0
3832,50,88,74,162,1,1.0
3833,50,97,122,219,1,1.0
3834,50,43,70,113,1,1.0
3835,50,163,183,346,1,1.0
3836,50,1,4,5,1,1.0
3837,50,46,36,82,1,1.0
3838,50,15,32,47,1,1.0
3839,50,43,38,81,1,1.0
3840,50,41,36,77,1,1.0
3841,50,85,123,208,1,1.0
3842,50,55,76,131,1,1.0
3843,50,55,85,140,1,1.0
3844,50,23,29,52,1,1.0
3845,50,50,99,149,1,1.0
3846,50,30,44,74,1,1.0
3847,50,60,53,113,1,1.0
3848,50,71,116,187,1,1.0
3849,50,60,72,132,1,1.0
3850,50,27,31,58,1,1.0
3851,50,19,39,58,1,1.0
3852,50,48,78,126,1,1.0
3853,50,35,54,89,1,1.0
3854,50,21,50,71,1,1.0
3855,50,13,20,33,1,1.0
3856,50,45,54,99,1,1.0
3857,50,19,40,59,1,1.0
3858,50,18,38,56,1,1.0
3859,50,36,75,111,1,1.0
3860,50,43,77,120,1,1.0
3861,50,51,59,110,1,1.0
3862,50,63,65,128,1,1.0
3863,50,27,54,81,1,1.0
3864,50,26,39,65,1,1.0
3865,50,39,64,103,1,1.0
3866,50,53,144,197,1,1.0
3867,50,53,55,108,1,1.0
3868,50,43,87,130,1,1.0
3869,50,74,114,188,1,1.0
3870,50,61,86,147,1,1.0
3871,50,8,24,32,1,1.0
3872,50,32,41,73,1,1.0
3873,50,30,36,66,1,1.0
3874,50,23,38,61,1,1.0
3875,50,47,75,122,1,1.0
3876,50,69,84,153,1,1.0
3877,50,35,66,101,1,1.0
3878,50,68,106,174,1,1.0
3879,50,41,76,117,1,1.0
3880,50,21,34,55,1,1.0
3881,50,15,38,53,1,1.0
3882,50,38,93,131,1,1.0
3883,50,13,76,89,1,1.0
3884,50,37,70,107,1,1.0
3885,50,19,47,66,1,1.0
3886,50,14,13,27,1,1.0
3887,50,18,21,39,1,1.0
3888,50,22,40,62,1,1.0
3889,50,21,27,48,1,1.0
3890,50,40,72,112,1,1.0
3891,50,55,66,121,1,1.0
3892,50,39,55,94,1,1.0
3893,50,80,114,194,1,1.0
3894,50,32,96,128,1,1.0
3895,50,44,54,98,1,1.0
3896,50,26,29,55,1,1.0
3897,50,39,26,65,1,1.0
3898,50,39,29,68,1,1.0
3899,50,27,46,73,1,1.0
3900,50,10,21,31,1,1.0
3901,50,80,110,190,1,1.0
3902,50,92,98,190,1,1.0
3903,50,41,29,70,1,1.0
3904,50,22,47,69,1,1.0
3905,50,45,68,113,1,1.0
3906,50,22,39,61,1,1.0
3907,50,11,17,28,1,1.0
3908,50,41,74,115,1,1.0
3909,50,10,14,24,1,1.0
3910,50,15,17,32,1,1.0
3911,50,5,2,7,1,1.0
3912,50,19,38,57,1,1.0
3913,50,20,38,58,1,1.0
3914,50,12,26,38,1,1.0
3915,50,12,40,52,1,1.0
3916,50,14,31,45,1,1.0
3917,50,0,3,3,1,1.0
3918,50,21,43,64,1,1.0
3919,50,10,26,36,1,1.0
3920,50,40,36,76,1,1.0
3921,50,31,42,73,1,1.0
3922,50,32,62,94,1,1.0
3923,50,33,47,80,1,1.0
3924,50,54,46,100,1,1.0
3925,50,37,58,95,1,1.0
3926,50,12,28,40,1,1.0
3927,50,31,41,72,1,1.0
3928,50,20,35,55,1,1.0
3929,50,21,45,66,1,1.0
3930,50,11,24,35,1,1.0
3931,50,20,24,44,1,1.0
3932,50,12,22,34,1,1.0
3933,50,75,104,179,1,1.0
3934,50,11,24,35,1,1.0
3935,50,25,22,47,1,1.0
3936,50,49,101,150,1,1.0
3937,50,29,50,79,1,1.0
3938,50,68,59,127,1,1.0
3939,50,15,31,46,1,1.0
3940,50,87,104,191,1,1.0
3941,50,41,69,110,1,1.0
3942,50,21,33,54,1,1.0
3943,50,80,94,174,1,1.0
3944,50,71,46,117,1,1.0
3945,50,64,115,179,1,1.0
3946,50,23,59,82,1,1.0
3947,50,102,129,231,1,1.0
3948,50,83,71,154,1,1.0
3949,50,33,34,67,1,1.0
3950,50,43,87,130,1,1.0
3951,50,45,81,126,1,1.0
3952,50,65,93,158,1,1.0
3953,50,41,46,87,1,1.0
3954,50,26,37,63,1,1.0
3955,50,20,18,38,1,1.0
3956,50,45,68,113,1,1.0
3957,50,21,39,60,1,1.0
3958,50,18,33,51,1,1.0
3959,50,5,13,18,1,1.0
3960,50,9,18,27,1,1.0
3961,50,1,8,9,1,1.0
3962,50,24,38,62,1,1.0
3963,50,12,24,36,1,1.0
3964,50,21,23,44,1,1.0
3965,50,25,54,79,1,1.0
3966,50,21,20,41,1,1.0
3967,50,36,70,106,1,1.0
3968,50,55,58,113,1,1.0
3969,50,44,68,112,1,1.0
3970,50,77,121,198,1,1.0
3971,50,31,92,123,1,1.0
3972,50,43,60,103,1,1.0
3973,50,31,33,64,1,1.0
3974,50,36,24,60,1,1.0
3975,50,32,31,63,1,1.0
3976,50,26,47,73,1,1.0
3977,50,17,50,67,1,1.0
3978,50,14,17,31,1,1.0
3979,50,62,102,164,1,1.0
3980,50,29,19,48,1,1.0
3981,50,73,112,185,1,1.0
3982,50,43,36,79,1,1.0
3983,50,51,89,140,1,1.0
3984,50,27,39,66,1,1.0
3985,50,27,49,76,1,1.0
3986,50,28,56,84,1,1.0
3987,50,25,32,57,1,1.0
3988,50,13,19,32,1,1.0
3989,50,16,39,55,1,1.0
3990,50,18,31,49,1,1.0
3991,50,29,64,93,1,1.0
3992,50,32,36,68,1,1.0
3993,50,23,21,44,1,1.0
3994,50,2,8,10,1,1.0
3995,50,11,9,20,1,1.0
3996,50,71,70,141,1,1.0
3997,50,86,88,174,1,1.0
3998,50,10,36,46,1,1.0
3999,50,24,19,43,1,1.0
4000,50,29,59,88,1,1.0
4001,50,41,32,73,1,1.0
4002,50,22,60,82,1,1.0
4003,50,53,98,151,1,1.0
4004,50,13,30,43,1,1.0
4005,50,46,63,109,1,1.0
4006,50,20,31,51,1,1.0
4007,50,12,8,20,1,1.0
4008,50,0,0,0,1,1.0
4009,50,2,13,15,1,1.0
4010,50,75,185,260,1,1.0
4011,50,77,178,255,1,1.0
4012,50,32,41,73,1,1.0
4013,50,58,71,129,1,1.0
4014,50,16,26,42,1,1.0
4015,50,31,34,65,1,1.0
4016,50,59,70,129,1,1.0
4017,50,22,24,46,1,1.0
4018,50,21,30,51,1,1.0
4019,50,10,22,32,1,1.0
4020,50,27,51,78,1,1.0
4021,50,65,100,165,1,1.0
4022,50,10,18,28,1,1.0
4023,50,8,25,33,1,1.0
4024,50,6,15,21,1,1.0
4025,50,11,16,27,1,1.0
4026,50,31,45,76,1,1.0
4027,50,93,123,216,1,1.0
4028,50,38,49,87,1,1.0
4029,50,26,32,58,1,1.0
4030,50,40,59,99,1,1.0
4031,50,58,73,131,1,1.0
4032,50,8,12,20,1,1.0
4033,50,68,68,136,1,1.0
4034,50,22,30,52,1,1.0
4035,50,50,50,100,1,1.0
4036,50,51,54,105,1,1.0
4037,50,23,25,48,1,1.0
4038,50,25,20,45,1,1.0
4039,50,51,46,97,1,1.0
4040,50,57,32,89,1,1.0
4041,50,7,19,26,1,1.0
4042,50,23,36,59,1,1.0
4043,50,46,74,120,1,1.0
4044,50,33,27,60,1,1.0
4045,50,15,18,33,1,1.0
4046,75,37,94,131,1,1.0
4047,75,25,38,63,1,1.0
4048,75,45,92,137,1,1.0
4049,75,61,82,143,1,1.0
4050,75,40,47,87,1,1.0
4051,75,49,47,96,1,1.0
4052,75,19,29,48,1,1.0
4053,75,50,75,125,1,1.0
4054,75,22,35,57,1,1.0
4055,75,13,51,64,1,1.0
4056,75,22,34,56,1,1.0
4057,75,2,39,41,1,1.0
4058,75,22,50,72,1,1.0
4059,75,21,32,53,1,1.0
4060,75,8,20,28,1,1.0
4061,75,3,11,14,1,1.0
4062,75,22,22,44,1,1.0
4063,75,4,9,13,1,1.0
4064,75,11,19,30,1,1.0
4065,75,77,87,164,1,1.0
4066,75,63,89,152,1,1.0
4067,75,47,89,136,1,1.0
4068,75,29,54,83,1,1.0
4069,75,16,13,29,1,1.0
4070,75,23,36,59,1,1.0
4071,75,23,64,87,1,1.0
4072,75,77,74,151,1,1.0
4073,75,27,48,75,1,1.0
4074,75,35,78,113,1,1.0
4075,75,20,27,47,1,1.0
4076,75,27,31,58,1,1.0
4077,75,8,15,23,1,1.0
4078,75,14,19,33,1,1.0
4079,75,113,176,289,1,1.0
4080,75,54,70,124,1,1.0
4081,75,24,46,70,1,1.0
4082,75,34,66,100,1,1.0
4083,75,8,23,31,1,1.0
4084,75,57,124,181,1,1.0
4085,75,25,39,64,1,1.0
4086,75,19,58,77,1,1.0
4087,75,1,16,17,1,1.0
4088,75,16,76,92,1,1.0
4089,75,101,156,257,1,1.0
4090,75,47,80,127,1,1.0
4091,75,31,40,71,1,1.0
4092,75,35,76,111,1,1.0
4093,75,83,123,206,1,1.0
4094,75,37,65,102,1,1.0
4095,75,22,48,70,1,1.0
4096,75,32,37,69,1,1.0
4097,75,80,119,199,1,1.0
4098,75,10,15,25,1,1.0
4099,75,26,111,137,1,1.0
4100,75,34,96,130,1,1.0
4101,75,48,106,154,1,1.0
4102,75,85,121,206,1,1.0
4103,75,25,42,67,1,1.0
4104,75,27,82,109,1,1.0
4105,75,56,90,146,1,1.0
4106,75,12,55,67,1,1.0
4107,75,11,20,31,1,1.0
4108,75,15,49,64,1,1.0
4109,75,4,23,27,1,1.0
4110,75,33,51,84,1,1.0
4111,75,19,52,71,1,1.0
4112,75,9,17,26,1,1.0
4113,75,5,3,8,1,1.0
4114,75,1,4,5,1,1.0
4115,75,10,9,19,1,1.0
4116,75,2,3,5,1,1.0
4117,75,5,3,8,1,1.0
4118,75,70,96,166,1,1.0
4119,75,41,49,90,1,1.0
4120,75,40,86,126,1,1.0
4121,75,48,97,145,1,1.0
4122,75,43,83,126,1,1.0
4123,75,28,73,101,1,1.0
4124,75,24,70,94,1,1.0
4125,75,37,73,110,1,1.0
4126,75,22,38,60,1,1.0
4127,75,37,39,76,1,1.0
4128,75,31,40,71,1,1.0
4129,75,28,50,78,1,1.0
4130,75,25,63,88,1,1.0
4131,75,52,130,182,1,1.0
4132,75,13,40,53,1,1.0
4133,75,22,26,48,1,1.0
4134,75,37,17,54,1,1.0
4135,75,61,177,238,1,1.0
4136,75,10,53,63,1,1.0
4137,75,76,101,177,1,1.0
4138,75,26,49,75,1,1.0
4139,75,33,58,91,1,1.0
4140,75,29,39,68,1,1.0
4141,75,16,27,43,1,1.0
4142,75,17,34,51,1,1.0
4143,75,17,38,55,1,1.0
4144,75,8,18,26,1,1.0
4145,75,18,26,44,1,1.0
4146,75,8,6,14,1,1.0
4147,75,12,25,37,1,1.0
4148,75,12,27,39,1,1.0
4149,75,32,79,111,1,1.0
4150,75,43,54,97,1,1.0
4151,75,63,86,149,1,1.0
4152,75,36,17,53,1,1.0
4153,75,21,27,48,1,1.0
4154,75,69,145,214,1,1.0
4155,75,30,88,118,1,1.0
4156,75,19,43,62,1,1.0
4157,75,38,62,100,1,1.0
4158,75,17,21,38,1,1.0
4159,75,32,35,67,1,1.0
4160,75,10,26,36,1,1.0
4161,75,14,15,29,1,1.0
4162,75,22,22,44,1,1.0
4163,75,11,9,20,1,1.0
4164,75,3,23,26,1,1.0
4165,75,16,50,66,1,1.0
4166,75,45,87,132,1,1.0
4167,75,115,241,356,1,1.0
4168,75,93,235,328,1,1.0
4169,75,48,99,147,1,1.0
4170,75,45,114,159,1,1.0
4171,75,43,131,174,1,1.0
4172,75,7,18,25,1,1.0
4173,75,21,59,80,1,1.0
4174,75,10,30,40,1,1.0
4175,75,12,26,38,1,1.0
4176,75,2,9,11,1,1.0
4177,75,8,10,18,1,1.0
4178,75,11,8,19,1,1.0
4179,75,17,27,44,1,1.0
4180,75,3,4,7,1,1.0
4181,75,58,46,104,1,1.0
4182,75,40,38,78,1,1.0
4183,75,23,43,66,1,1.0
4184,75,63,109,172,1,1.0
4185,75,7,18,25,1,1.0
4186,75,58,82,140,1,1.0
4187,75,14,45,59,1,1.0
4188,75,52,66,118,1,1.0
4189,75,25,22,47,1,1.0
4190,75,10,28,38,1,1.0
4191,75,26,41,67,1,1.0
4192,75,11,31,42,1,1.0
4193,75,18,23,41,1,1.0
4194,75,4,8,12,1,1.0
4195,75,14,25,39,1,1.0
4196,75,19,16,35,1,1.0
4197,75,49,44,93,1,1.0
4198,75,25,73,98,1,1.0
4199,75,9,17,26,1,1.0
4200,75,35,65,100,1,1.0
4201,75,29,32,61,1,1.0
4202,75,34,35,69,1,1.0
4203,75,22,34,56,1,1.0
4204,75,11,31,42,1,1.0
4205,75,35,34,69,1,1.0
4206,75,30,34,64,1,1.0
4207,75,62,135,197,1,1.0
4208,75,29,49,78,1,1.0
4209,75,6,28,34,1,1.0
4210,75,17,27,44,1,1.0
4211,75,12,17,29,1,1.0
4212,75,19,22,41,1,1.0
4213,75,17,23,40,1,1.0
4214,75,8,26,34,1,1.0
4215,75,52,71,123,1,1.0
4216,75,39,88,127,1,1.0
4217,75,63,51,114,1,1.0
4218,75,100,61,161,1,1.0
4219,75,86,120,206,1,1.0
4220,75,34,57,91,1,1.0
4221,75,51,100,151,1,1.0
4222,75,65,54,119,1,1.0
4223,75,52,82,134,1,1.0
4224,75,47,57,104,1,1.0
4225,75,20,40,60,1,1.0
4226,75,22,47,69,1,1.0
4227,75,16,40,56,1,1.0
4228,75,27,46,73,1,1.0
4229,75,20,21,41,1,1.0
4230,75,25,37,62,1,1.0
4231,75,60,61,121,1,1.0
4232,75,55,86,141,1,1.0
4233,75,21,22,43,1,1.0
4234,75,69,98,167,1,1.0
4235,75,44,57,101,1,1.0
4236,75,80,130,210,1,1.0
4237,75,25,58,83,1,1.0
4238,75,33,48,81,1,1.0
4239,75,38,39,77,1,1.0
4240,75,36,23,59,1,1.0
4241,75,22,14,36,1,1.0
4242,75,27,11,38,1,1.0
4243,75,11,19,30,1,1.0
4244,75,22,18,40,1,1.0
4245,75,4,10,14,1,1.0
4246,75,36,44,80,1,1.0
4247,75,26,40,66,1,1.0
4248,75,80,131,211,1,1.0
4249,75,9,23,32,1,1.0
4250,75,25,71,96,1,1.0
4251,75,35,31,66,1,1.0
4252,75,45,87,132,1,1.0
4253,75,7,38,45,1,1.0
4254,75,45,65,110,1,1.0
4255,75,14,23,37,1,1.0
4256,75,15,34,49,1,1.0
4257,75,12,21,33,1,1.0
4258,75,6,10,16,1,1.0
4259,75,33,83,116,1,1.0
4260,75,38,34,72,1,1.0
4261,75,38,55,93,1,1.0
4262,75,36,49,85,1,1.0
4263,75,34,65,99,1,1.0
4264,75,22,35,57,1,1.0
4265,75,129,217,346,1,1.0
4266,75,76,78,154,1,1.0
4267,75,21,41,62,1,1.0
4268,75,30,54,84,1,1.0
4269,75,8,4,12,1,1.0
4270,75,13,18,31,1,1.0
4271,75,14,21,35,1,1.0
4272,75,14,7,21,1,1.0
4273,75,47,90,137,1,1.0
4274,75,25,26,51,1,1.0
4275,75,41,71,112,1,1.0
4276,75,38,77,115,1,1.0
4277,75,18,41,59,1,1.0
4278,75,42,41,83,1,1.0
4279,75,65,124,189,1,1.0
4280,75,35,61,96,1,1.0
4281,75,52,67,119,1,1.0
4282,75,20,17,37,1,1.0
4283,75,30,27,57,1,1.0
4284,75,7,16,23,1,1.0
4285,75,9,20,29,1,1.0
4286,75,4,4,8,1,1.0
4287,75,11,6,17,1,1.0
4288,75,10,11,21,1,1.0
4289,75,3,3,6,1,1.0
4290,75,44,68,112,1,1.0
4291,75,11,27,38,1,1.0
4292,75,8,34,42,1,1.0
4293,75,27,72,99,1,1.0
4294,75,39,153,192,1,1.0
4295,75,13,40,53,1,1.0
4296,75,78,152,230,1,1.0
4297,75,41,103,144,1,1.0
4298,75,6,39,45,1,1.0
4299,75,15,33,48,1,1.0
4300,75,64,124,188,1,1.0
4301,75,37,76,113,1,1.0
4302,75,12,28,40,1,1.0
4303,75,13,27,40,1,1.0
4304,75,12,23,35,1,1.0
4305,75,2,5,7,1,1.0
4306,75,8,36,44,1,1.0
4307,75,12,8,20,1,1.0
4308,75,39,62,101,1,1.0
4309,75,56,83,139,1,1.0
4310,75,64,125,189,1,1.0
4311,75,15,46,61,1,1.0
4312,75,68,99,167,1,1.0
4313,75,39,36,75,1,1.0
4314,75,25,20,45,1,1.0
4315,75,97,135,232,1,1.0
4316,75,21,59,80,1,1.0
4317,75,16,33,49,1,1.0
4318,75,24,28,52,1,1.0
4319,75,5,17,22,1,1.0
4320,75,10,10,20,1,1.0
4321,75,10,26,36,1,1.0
4322,75,8,12,20,1,1.0
4323,75,10,24,34,1,1.0
4324,75,6,10,16,1,1.0
4325,75,4,9,13,1,1.0
4326,75,80,114,194,1,1.0
4327,75,88,109,197,1,1.0
4328,75,12,9,21,1,1.0
4329,75,21,27,48,1,1.0
4330,75,5,12,17,1,1.0
4331,75,27,28,55,1,1.0
4332,75,9,23,32,1,1.0
4333,75,25,68,93,1,1.0
4334,75,41,33,74,1,1.0
4335,75,1,5,6,1,1.0
4336,75,22,42,64,1,1.0
4337,75,15,21,36,1,1.0
4338,75,23,6,29,1,1.0
4339,75,24,15,39,1,1.0
4340,75,37,87,124,1,1.0
4341,75,40,74,114,1,1.0
4342,75,21,42,63,1,1.0
4343,75,26,44,70,1,1.0
4344,75,17,17,34,1,1.0
4345,75,35,25,60,1,1.0
4346,75,10,34,44,1,1.0
4347,75,19,45,64,1,1.0
4348,75,12,17,29,1,1.0
4349,75,19,19,38,1,1.0
4350,75,21,25,46,1,1.0
4351,75,37,59,96,1,1.0
4352,75,7,7,14,1,1.0
4353,75,40,76,116,1,1.0
4354,75,21,35,56,1,1.0
4355,75,36,37,73,1,1.0
4356,75,20,21,41,1,1.0
4357,75,96,161,257,1,1.0
4358,75,23,36,59,1,1.0
4359,75,38,72,110,1,1.0
4360,75,12,27,39,1,1.0
4361,75,61,104,165,1,1.0
4362,75,8,17,25,1,1.0
4363,75,18,30,48,1,1.0
4364,75,27,39,66,1,1.0
4365,75,9,9,18,1,1.0
4366,75,13,10,23,1,1.0
4367,75,32,8,40,1,1.0
4368,75,33,75,108,1,1.0
4369,75,69,97,166,1,1.0
4370,75,43,91,134,1,1.0
4371,75,32,13,45,1,1.0
4372,75,20,53,73,1,1.0
4373,75,49,119,168,1,1.0
4374,75,48,56,104,1,1.0
4375,75,34,56,90,1,1.0
4376,75,25,45,70,1,1.0
4377,75,13,34,47,1,1.0
4378,75,30,26,56,1,1.0
4379,75,13,20,33,1,1.0
4380,75,29,24,53,1,1.0
4381,75,55,40,95,1,1.0
4382,75,7,21,28,1,1.0
4383,75,33,66,99,1,1.0
4384,75,1,5,6,1,1.0
4385,75,90,119,209,1,1.0
4386,75,78,111,189,1,1.0
4387,75,37,48,85,1,1.0
4388,75,53,109,162,1,1.0
4389,75,16,41,57,1,1.0
4390,75,30,42,72,1,1.0
4391,75,23,41,64,1,1.0
4392,75,4,13,17,1,1.0
4393,75,9,40,49,1,1.0
4394,75,29,51,80,1,1.0
4395,75,50,63,113,1,1.0
4396,75,57,126,183,1,1.0
4397,75,23,44,67,1,1.0
4398,75,127,129,256,1,1.0
4399,75,74,134,208,1,1.0
4400,75,73,98,171,1,1.0
4401,75,41,62,103,1,1.0
4402,75,44,91,135,1,1.0
4403,75,23,39,62,1,1.0
4404,75,30,44,74,1,1.0
4405,75,8,24,32,1,1.0
4406,75,1,7,8,1,1.0
4407,75,10,32,42,1,1.0
4408,75,21,37,58,1,1.0
4409,75,15,56,71,1,1.0
4410,75,15,23,38,1,1.0
4411,75,22,123,145,1,1.0
4412,75,41,78,119,1,1.0
4413,75,38,33,71,1,1.0
4414,75,25,33,58,1,1.0
4415,75,29,57,86,1,1.0
4416,75,68,135,203,1,1.0
4417,75,44,56,100,1,1.0
4418,75,27,52,79,1,1.0
4419,75,25,28,53,1,1.0
4420,75,98,199,297,1,1.0
4421,75,31,60,91,1,1.0
4422,75,10,27,37,1,1.0
4423,75,6,27,33,1,1.0
4424,75,17,20,37,1,1.0
4425,75,28,28,56,1,1.0
4426,75,52,94,146,1,1.0
4427,75,103,158,261,1,1.0
4428,75,56,61,117,1,1.0
4429,75,47,63,110,1,1.0
4430,75,73,90,163,1,1.0
4431,75,43,67,110,1,1.0
4432,75,51,59,110,1,1.0
4433,75,49,47,96,1,1.0
4434,75,34,45,79,1,1.0
4435,75,6,19,25,1,1.0
4436,75,11,7,18,1,1.0
4437,75,7,6,13,1,1.0
4438,75,51,52,103,1,1.0
4439,75,73,86,159,1,1.0
4440,75,65,78,143,1,1.0
4441,75,43,73,116,1,1.0
4442,75,20,26,46,1,1.0
4443,75,42,75,117,1,1.0
4444,75,22,56,78,1,1.0
4445,75,11,27,38,1,1.0
4446,75,53,87,140,1,1.0
4447,75,13,9,22,1,1.0
4448,75,15,25,40,1,1.0
4449,75,10,5,15,1,1.0
4450,75,15,13,28,1,1.0
4451,75,5,21,26,1,1.0
4452,75,62,69,131,1,1.0
4453,75,41,56,97,1,1.0
4454,75,33,54,87,1,1.0
4455,75,30,49,79,1,1.0
4456,75,9,8,17,1,1.0
4457,75,21,60,81,1,1.0
4458,75,12,20,32,1,1.0
4459,75,23,43,66,1,1.0
4460,75,17,32,49,1,1.0
4461,75,8,17,25,1,1.0
4462,75,1,7,8,1,1.0
4463,75,4,3,7,1,1.0
4464,75,3,3,6,1,1.0
4465,75,32,22,54,1,1.0
4466,75,41,46,87,1,1.0
4467,75,20,45,65,1,1.0
4468,75,16,38,54,1,1.0
4469,75,20,38,58,1,1.0
4470,75,15,25,40,1,1.0
4471,75,15,22,37,1,1.0
4472,75,64,83,147,1,1.0
4473,75,30,24,54,1,1.0
4474,75,11,26,37,1,1.0
4475,75,8,24,32,1,1.0
4476,75,11,29,40,1,1.0
4477,75,0,4,4,1,1.0
4478,75,45,66,111,1,1.0
4479,75,37,82,119,1,1.0
4480,75,32,41,73,1,1.0
4481,75,35,48,83,1,1.0
4482,75,38,37,75,1,1.0
4483,75,22,14,36,1,1.0
4484,75,33,58,91,1,1.0
4485,75,7,34,41,1,1.0
4486,75,12,36,48,1,1.0
4487,75,9,26,35,1,1.0
4488,75,2,7,9,1,1.0
4489,90,47,38,85,1,1.0
4490,90,62,66,128,1,1.0
4491,90,92,97,189,1,1.0
4492,90,79,136,215,1,1.0
4493,90,48,94,142,1,1.0
4494,90,49,86,135,1,1.0
4495,90,34,56,90,1,1.0
4496,90,27,26,53,1,1.0
4497,90,96,77,173,1,1.0
4498,90,17,27,44,1,1.0
4499,90,20,46,66,1,1.0
4500,90,18,21,39,1,1.0
4501,90,21,24,45,1,1.0
4502,90,7,10,17,1,1.0
4503,90,14,17,31,1,1.0
4504,90,4,3,7,1,1.0
4505,90,3,5,8,1,1.0
4506,90,28,13,41,1,1.0
4507,90,84,96,180,1,1.0
4508,90,44,96,140,1,1.0
4509,90,76,120,196,1,1.0
4510,90,58,106,164,1,1.0
4511,90,32,56,88,1,1.0
4512,90,109,183,292,1,1.0
4513,90,54,65,119,1,1.0
4514,90,31,24,55,1,1.0
4515,90,42,49,91,1,1.0
4516,90,13,39,52,1,1.0
4517,90,9,20,29,1,1.0
4518,90,30,67,97,1,1.0
4519,90,32,52,84,1,1.0
4520,90,183,350,533,1,1.0
4521,90,44,65,109,1,1.0
4522,90,26,20,46,1,1.0
4523,90,78,102,180,1,1.0
4524,90,19,44,63,1,1.0
4525,90,32,43,75,1,1.0
4526,90,29,29,58,1,1.0
4527,90,60,55,115,1,1.0
4528,90,7,17,24,1,1.0
4529,90,41,77,118,1,1.0
4530,90,35,46,81,1,1.0
4531,90,42,81,123,1,1.0
4532,90,12,10,22,1,1.0
4533,90,5,1,6,1,1.0
4534,90,15,29,44,1,1.0
4535,90,21,49,70,1,1.0
4536,90,78,120,198,1,1.0
4537,90,38,35,73,1,1.0
4538,90,31,48,79,1,1.0
4539,90,26,50,76,1,1.0
4540,90,26,40,66,1,1.0
4541,90,9,22,31,1,1.0
4542,90,35,70,105,1,1.0
4543,90,36,54,90,1,1.0
4544,90,40,77,117,1,1.0
4545,90,18,23,41,1,1.0
4546,90,7,13,20,1,1.0
4547,90,6,9,15,1,1.0
4548,90,0,4,4,1,1.0
4549,90,48,64,112,1,1.0
4550,90,20,61,81,1,1.0
4551,90,48,119,167,1,1.0
4552,90,131,183,314,1,1.0
4553,90,55,52,107,1,1.0
4554,90,35,149,184,1,1.0
4555,90,62,103,165,1,1.0
4556,90,41,173,214,1,1.0
4557,90,23,8,31,1,1.0
4558,90,18,38,56,1,1.0
4559,90,29,35,64,1,1.0
4560,90,16,61,77,1,1.0
4561,90,36,41,77,1,1.0
4562,90,41,90,131,1,1.0
4563,90,30,52,82,1,1.0
4564,90,52,20,72,1,1.0
4565,90,8,12,20,1,1.0
4566,90,2,3,5,1,1.0
4567,90,62,153,215,1,1.0
4568,90,21,36,57,1,1.0
4569,90,16,50,66,1,1.0
4570,90,83,263,346,1,1.0
4571,90,27,78,105,1,1.0
4572,90,123,305,428,1,1.0
4573,90,35,68,103,1,1.0
4574,90,54,114,168,1,1.0
4575,90,76,211,287,1,1.0
4576,90,78,221,299,1,1.0
4577,90,45,54,99,1,1.0
4578,90,12,46,58,1,1.0
4579,90,13,39,52,1,1.0
4580,90,1,25,26,1,1.0
4581,90,30,45,75,1,1.0
4582,90,14,29,43,1,1.0
4583,90,7,22,29,1,1.0
4584,90,17,59,76,1,1.0
4585,90,33,74,107,1,1.0
4586,90,13,19,32,1,1.0
4587,90,41,54,95,1,1.0
4588,90,16,43,59,1,1.0
4589,90,26,58,84,1,1.0
4590,90,31,46,77,1,1.0
4591,90,30,36,66,1,1.0
4592,90,13,39,52,1,1.0
4593,90,25,28,53,1,1.0
4594,90,51,86,137,1,1.0
4595,90,4,7,11,1,1.0
4596,90,7,30,37,1,1.0
4597,90,10,15,25,1,1.0
4598,90,83,207,290,1,1.0
4599,90,63,136,199,1,1.0
4600,90,19,52,71,1,1.0
4601,90,51,83,134,1,1.0
4602,90,33,66,99,1,1.0
4603,90,58,85,143,1,1.0
4604,90,36,58,94,1,1.0
4605,90,26,34,60,1,1.0
4606,90,54,75,129,1,1.0
4607,90,15,28,43,1,1.0
4608,90,4,22,26,1,1.0
4609,90,6,23,29,1,1.0
4610,90,31,83,114,1,1.0
4611,90,40,63,103,1,1.0
4612,90,33,47,80,1,1.0
4613,90,34,46,80,1,1.0
4614,90,42,67,109,1,1.0
4615,90,29,20,49,1,1.0
4616,90,39,47,86,1,1.0
4617,90,20,23,43,1,1.0
4618,90,37,40,77,1,1.0
4619,90,15,36,51,1,1.0
4620,90,41,35,76,1,1.0
4621,90,11,27,38,1,1.0
4622,90,12,20,32,1,1.0
4623,90,9,26,35,1,1.0
4624,90,83,96,179,1,1.0
4625,90,23,21,44,1,1.0
4626,90,21,43,64,1,1.0
4627,90,27,42,69,1,1.0
4628,90,49,55,104,1,1.0
4629,90,28,45,73,1,1.0
4630,90,26,50,76,1,1.0
4631,90,38,38,76,1,1.0
4632,90,31,20,51,1,1.0
4633,90,20,34,54,1,1.0
4634,90,36,40,76,1,1.0
4635,90,68,105,173,1,1.0
4636,90,31,48,79,1,1.0
4637,90,41,66,107,1,1.0
4638,90,69,127,196,1,1.0
4639,90,39,86,125,1,1.0
4640,90,29,103,132,1,1.0
4641,90,38,60,98,1,1.0
4642,90,53,74,127,1,1.0
4643,90,69,92,161,1,1.0
4644,90,6,14,20,1,1.0
4645,90,56,203,259,1,1.0
4646,90,104,193,297,1,1.0
4647,90,73,137,210,1,1.0
4648,90,128,226,354,1,1.0
4649,90,63,110,173,1,1.0
4650,90,120,234,354,1,1.0
4651,90,101,140,241,1,1.0
4652,90,20,29,49,1,1.0
4653,90,42,105,147,1,1.0
4654,90,26,32,58,1,1.0
4655,90,1,3,4,1,1.0
4656,90,9,12,21,1,1.0
4657,90,62,75,137,1,1.0
4658,90,38,22,60,1,1.0
4659,90,35,100,135,1,1.0
4660,90,54,127,181,1,1.0
4661,90,34,57,91,1,1.0
4662,90,87,151,238,1,1.0
4663,90,33,26,59,1,1.0
4664,90,38,54,92,1,1.0
4665,90,37,57,94,1,1.0
4666,90,15,28,43,1,1.0
4667,90,55,81,136,1,1.0
4668,90,20,15,35,1,1.0
4669,90,92,139,231,1,1.0
4670,90,57,98,155,1,1.0
4671,90,53,50,103,1,1.0
4672,90,27,85,112,1,1.0
4673,90,61,117,178,1,1.0
4674,90,53,112,165,1,1.0
4675,90,24,31,55,1,1.0
4676,90,56,44,100,1,1.0
4677,90,83,194,277,1,1.0
4678,90,41,51,92,1,1.0
4679,90,22,40,62,1,1.0
4680,90,10,16,26,1,1.0
4681,90,27,43,70,1,1.0
4682,90,68,52,120,1,1.0
4683,90,36,23,59,1,1.0
4684,90,49,44,93,1,1.0
4685,90,15,62,77,1,1.0
4686,90,58,122,180,1,1.0
4687,90,37,50,87,1,1.0
4688,90,24,34,58,1,1.0
4689,90,78,118,196,1,1.0
4690,90,82,118,200,1,1.0
4691,90,75,103,178,1,1.0
4692,90,51,99,150,1,1.0
4693,90,6,4,10,1,1.0
4694,90,54,61,115,1,1.0
4695,90,43,62,105,1,1.0
4696,90,28,28,56,1,1.0
4697,90,23,13,36,1,1.0
4698,90,8,21,29,1,1.0
4699,90,126,294,420,1,1.0
4700,90,77,147,224,1,1.0
4701,90,48,151,199,1,1.0
4702,90,10,26,36,1,1.0
4703,90,56,85,141,1,1.0
4704,90,40,20,60,1,1.0
4705,90,9,34,43,1,1.0
4706,90,26,37,63,1,1.0
4707,90,11,10,21,1,1.0
4708,90,1,10,11,1,1.0
4709,90,4,8,12,1,1.0
4710,90,49,102,151,1,1.0
4711,90,40,42,82,1,1.0
4712,90,15,78,93,1,1.0
4713,90,31,65,96,1,1.0
4714,90,47,95,142,1,1.0
4715,90,24,52,76,1,1.0
4716,90,18,27,45,1,1.0
4717,90,77,76,153,1,1.0
4718,90,21,31,52,1,1.0
4719,90,16,10,26,1,1.0
4720,90,29,43,72,1,1.0
4721,90,18,30,48,1,1.0
4722,90,26,52,78,1,1.0
4723,90,29,59,88,1,1.0
4724,90,17,24,41,1,1.0
4725,90,37,68,105,1,1.0
4726,90,65,109,174,1,1.0
4727,90,22,57,79,1,1.0
4728,90,26,86,112,1,1.0
4729,90,35,76,111,1,1.0
4730,90,96,90,186,1,1.0
4731,90,43,96,139,1,1.0
4732,90,79,91,170,1,1.0
4733,90,15,18,33,1,1.0
4734,90,22,47,69,1,1.0
4735,90,44,57,101,1,1.0
4736,90,37,81,118,1,1.0
4737,90,64,66,130,1,1.0
4738,90,0,5,5,1,1.0
4739,90,53,69,122,1,1.0
4740,90,19,55,74,1,1.0
4741,90,44,62,106,1,1.0
4742,90,86,119,205,1,1.0
4743,90,92,78,170,1,1.0
4744,90,88,121,209,1,1.0
4745,90,66,97,163,1,1.0
4746,90,26,36,62,1,1.0
4747,90,33,50,83,1,1.0
4748,90,37,64,101,1,1.0
4749,90,28,65,93,1,1.0
4750,90,22,19,41,1,1.0
4751,90,21,58,79,1,1.0
4752,90,18,27,45,1,1.0
4753,90,54,80,134,1,1.0
4754,90,10,46,56,1,1.0
4755,90,71,107,178,1,1.0
4756,90,67,69,136,1,1.0
4757,90,29,55,84,1,1.0
4758,90,129,192,321,1,1.0
4759,90,56,84,140,1,1.0
4760,90,148,166,314,1,1.0
4761,90,53,75,128,1,1.0
4762,90,64,99,163,1,1.0
4763,90,45,41,86,1,1.0
4764,90,43,62,105,1,1.0
4765,90,40,47,87,1,1.0
4766,90,27,28,55,1,1.0
4767,90,52,69,121,1,1.0
4768,90,22,58,80,1,1.0
4769,90,16,37,53,1,1.0
4770,90,20,26,46,1,1.0
4771,90,59,23,82,1,1.0
4772,90,40,31,71,1,1.0
4773,90,46,46,92,1,1.0
4774,90,84,43,127,1,1.0
4775,90,48,79,127,1,1.0
4776,90,110,46,156,1,1.0
4777,90,21,32,53,1,1.0
4778,90,48,63,111,1,1.0
4779,90,34,55,89,1,1.0
4780,90,51,56,107,1,1.0
4781,90,41,57,98,1,1.0
4782,90,72,55,127,1,1.0
4783,90,11,28,39,1,1.0
4784,90,58,40,98,1,1.0
4785,90,45,50,95,1,1.0
4786,90,10,14,24,1,1.0
4787,90,20,16,36,1,1.0
4788,90,15,19,34,1,1.0
4789,90,4,7,11,1,1.0
4790,90,35,39,74,1,1.0
4791,90,37,85,122,1,1.0
4792,90,20,40,60,1,1.0
4793,90,18,23,41,1,1.0
4794,90,20,44,64,1,1.0
4795,90,27,46,73,1,1.0
4796,90,70,144,214,1,1.0
4797,90,8,10,18,1,1.0
4798,90,39,93,132,1,1.0
4799,90,14,19,33,1,1.0
4800,90,17,30,47,1,1.0
4801,90,26,38,64,1,1.0
4802,90,12,25,37,1,1.0
4803,90,41,48,89,1,1.0
4804,90,6,25,31,1,1.0
4805,90,33,60,93,1,1.0
4806,90,25,27,52,1,1.0
4807,90,13,41,54,1,1.0
4808,90,20,28,48,1,1.0
4809,90,23,35,58,1,1.0
4810,90,59,127,186,1,1.0
4811,90,50,99,149,1,1.0
4812,90,6,6,12,1,1.0
4813,90,31,37,68,1,1.0
4814,90,53,85,138,1,1.0
4815,90,51,66,117,1,1.0
4816,90,16,21,37,1,1.0
4817,90,44,72,116,1,1.0
4818,90,18,28,46,1,1.0
4819,90,25,54,79,1,1.0
4820,90,74,132,206,1,1.0
4821,90,78,156,234,1,1.0
4822,90,38,89,127,1,1.0
4823,90,18,26,44,1,1.0
4824,90,27,34,61,1,1.0
4825,90,30,65,95,1,1.0
4826,90,15,40,55,1,1.0
4827,90,22,19,41,1,1.0
4828,90,21,55,76,1,1.0
4829,90,43,98,141,1,1.0
4830,90,31,48,79,1,1.0
4831,90,46,46,92,1,1.0
4832,90,64,125,189,1,1.0
4833,90,19,21,40,1,1.0
4834,90,13,29,42,1,1.0
4835,90,59,92,151,1,1.0
4836,90,23,17,40,1,1.0
4837,90,20,14,34,1,1.0
4838,90,17,27,44,1,1.0
4839,90,26,24,50,1,1.0
4840,90,25,53,78,1,1.0
4841,90,34,39,73,1,1.0
4842,90,25,18,43,1,1.0
4843,90,16,34,50,1,1.0
4844,90,54,44,98,1,1.0
4845,90,10,31,41,1,1.0
4846,90,75,117,192,1,1.0
4847,90,53,64,117,1,1.0
4848,90,22,88,110,1,1.0
4849,90,35,78,113,1,1.0
4850,90,64,74,138,1,1.0
4851,90,31,74,105,1,1.0
4852,90,45,64,109,1,1.0
4853,90,22,27,49,1,1.0
4854,90,19,64,83,1,1.0
4855,90,32,65,97,1,1.0
4856,90,10,8,18,1,1.0
4857,90,38,73,111,1,1.0
4858,90,24,29,53,1,1.0
4859,90,34,69,103,1,1.0
4860,90,33,61,94,1,1.0
4861,90,60,66,126,1,1.0
4862,90,35,42,77,1,1.0
4863,90,65,64,129,1,1.0
4864,90,34,54,88,1,1.0
4865,90,38,16,54,1,1.0
4866,90,33,29,62,1,1.0
4867,90,29,30,59,1,1.0
4868,90,12,16,28,1,1.0
4869,90,4,8,12,1,1.0
4870,90,23,29,52,1,1.0
4871,90,11,9,20,1,1.0
4872,90,2,2,4,1,1.0
4873,90,41,46,87,1,1.0
4874,90,15,12,27,1,1.0
4875,90,74,100,174,1,1.0
4876,90,51,100,151,1,1.0
4877,90,63,74,137,1,1.0
4878,90,38,48,86,1,1.0
4879,90,5,25,30,1,1.0
4880,90,20,40,60,1,1.0
4881,90,24,39,63,1,1.0
4882,90,23,33,56,1,1.0
4883,90,43,68,111,1,1.0
4884,90,8,23,31,1,1.0
4885,90,27,57,84,1,1.0
4886,90,18,34,52,1,1.0
4887,90,20,27,47,1,1.0
4888,90,16,56,72,1,1.0
4889,90,41,67,108,1,1.0
4890,90,88,92,180,1,1.0
4891,90,17,63,80,1,1.0
4892,90,61,141,202,1,1.0
4893,90,39,73,112,1,1.0
4894,90,13,41,54,1,1.0
4895,90,67,78,145,1,1.0
4896,90,19,27,46,1,1.0
4897,90,19,50,69,1,1.0
4898,90,32,88,120,1,1.0
4899,90,31,32,63,1,1.0
4900,90,20,25,45,1,1.0
4901,90,6,9,15,1,1.0
4902,90,42,80,122,1,1.0
4903,90,91,111,202,1,1.0
4904,90,42,72,114,1,1.0
4905,90,20,49,69,1,1.0
4906,90,82,147,229,1,1.0
4907,90,134,201,335,1,1.0
4908,90,325,553,878,1,1.0
4909,90,99,152,251,1,1.0
4910,90,32,85,117,1,1.0
4911,90,56,80,136,1,1.0
4912,90,4,17,21,1,1.0
4913,90,24,62,86,1,1.0
4914,90,29,37,66,1,1.0
4915,90,33,111,144,1,1.0
4916,120,49,35,84,1,1.0
4917,120,87,129,216,1,1.0
4918,120,17,55,72,1,1.0
4919,120,76,79,155,1,1.0
4920,120,57,90,147,1,1.0
4921,120,62,145,207,1,1.0
4922,120,31,37,68,1,1.0
4923,120,91,83,174,1,1.0
4924,120,42,35,77,1,1.0
4925,120,78,146,224,1,1.0
4926,120,39,61,100,1,1.0
4927,120,42,123,165,1,1.0
4928,120,46,120,166,1,1.0
4929,120,36,47,83,1,1.0
4930,120,27,58,85,1,1.0
4931,120,18,9,27,1,1.0
4932,120,9,61,70,1,1.0
4933,120,46,92,138,1,1.0
4934,120,52,99,151,1,1.0
4935,120,17,45,62,1,1.0
4936,120,13,27,40,1,1.0
4937,120,51,61,112,1,1.0
4938,120,11,26,37,1,1.0
4939,120,55,58,113,1,1.0
4940,120,26,25,51,1,1.0
4941,120,19,34,53,1,1.0
4942,120,40,57,97,1,1.0
4943,120,56,83,139,1,1.0
4944,120,11,32,43,1,1.0
4945,120,20,55,75,1,1.0
4946,120,20,35,55,1,1.0
4947,120,46,53,99,1,1.0
4948,120,15,20,35,1,1.0
4949,120,10,17,27,1,1.0
4950,120,50,130,180,1,1.0
4951,120,94,138,232,1,1.0
4952,120,37,57,94,1,1.0
4953,120,48,33,81,1,1.0
4954,120,22,38,60,1,1.0
4955,120,24,34,58,1,1.0
4956,120,27,63,90,1,1.0
4957,120,43,64,107,1,1.0
4958,120,38,69,107,1,1.0
4959,120,23,28,51,1,1.0
4960,120,7,13,20,1,1.0
4961,120,9,27,36,1,1.0
4962,120,21,23,44,1,1.0
4963,120,35,57,92,1,1.0
4964,120,39,115,154,1,1.0
4965,120,28,78,106,1,1.0
4966,120,21,62,83,1,1.0
4967,120,43,85,128,1,1.0
4968,120,10,31,41,1,1.0
4969,120,8,16,24,1,1.0
4970,120,7,15,22,1,1.0
4971,120,16,21,37,1,1.0
4972,120,7,26,33,1,1.0
4973,120,24,21,45,1,1.0
4974,120,21,27,48,1,1.0
4975,120,35,41,76,1,1.0
4976,120,31,43,74,1,1.0
4977,120,71,68,139,1,1.0
4978,120,49,108,157,1,1.0
4979,120,30,56,86,1,1.0
4980,120,58,83,141,1,1.0
4981,120,51,78,129,1,1.0
4982,120,33,50,83,1,1.0
4983,120,35,51,86,1,1.0
4984,120,18,31,49,1,1.0
4985,120,3,16,19,1,1.0
4986,120,6,15,21,1,1.0
4987,120,30,73,103,1,1.0
4988,120,25,33,58,1,1.0
4989,120,31,55,86,1,1.0
4990,120,16,14,30,1,1.0
4991,120,73,96,169,1,1.0
4992,120,37,18,55,1,1.0
4993,120,10,19,29,1,1.0
4994,120,21,43,64,1,1.0
4995,120,34,65,99,1,1.0
4996,120,25,23,48,1,1.0
4997,120,16,11,27,1,1.0
4998,120,23,37,60,1,1.0
4999,120,27,69,96,1,1.0
5000,120,56,86,142,1,1.0
5001,120,63,52,115,1,1.0
5002,120,39,48,87,1,1.0
5003,120,29,25,54,1,1.0
5004,120,36,96,132,1,1.0
5005,120,31,122,153,1,1.0
5006,120,48,53,101,1,1.0
5007,120,34,31,65,1,1.0
5008,120,19,41,60,1,1.0
5009,120,22,39,61,1,1.0
5010,120,56,91,147,1,1.0
5011,120,85,167,252,1,1.0
5012,120,29,39,68,1,1.0
5013,120,24,43,67,1,1.0
5014,120,26,28,54,1,1.0
5015,120,13,9,22,1,1.0
5016,120,53,109,162,1,1.0
5017,120,15,11,26,1,1.0
5018,120,53,74,127,1,1.0
5019,120,30,43,73,1,1.0
5020,120,47,70,117,1,1.0
5021,120,37,59,96,1,1.0
5022,120,18,32,50,1,1.0
5023,120,42,36,78,1,1.0
5024,120,42,47,89,1,1.0
5025,120,12,36,48,1,1.0
5026,120,18,39,57,1,1.0
5027,120,19,28,47,1,1.0
5028,120,24,25,49,1,1.0
5029,120,7,11,18,1,1.0
5030,120,41,77,118,1,1.0
5031,120,36,78,114,1,1.0
5032,120,22,71,93,1,1.0
5033,120,66,144,210,1,1.0
5034,120,30,39,69,1,1.0
5035,120,70,72,142,1,1.0
5036,120,29,52,81,1,1.0
5037,120,32,47,79,1,1.0
5038,120,18,57,75,1,1.0
5039,120,25,59,84,1,1.0
5040,120,18,24,42,1,1.0
5041,120,10,29,39,1,1.0
5042,120,8,14,22,1,1.0
5043,120,45,46,91,1,1.0
5044,120,7,23,30,1,1.0
5045,120,50,64,114,1,1.0
5046,120,37,75,112,1,1.0
5047,120,32,65,97,1,1.0
5048,120,8,12,20,1,1.0
5049,120,43,81,124,1,1.0
5050,120,52,63,115,1,1.0
5051,120,27,22,49,1,1.0
5052,120,41,60,101,1,1.0
5053,120,37,40,77,1,1.0
5054,120,18,38,56,1,1.0
5055,120,14,14,28,1,1.0
5056,120,4,17,21,1,1.0
5057,120,3,8,11,1,1.0
5058,120,0,0,0,1,1.0
5059,120,34,39,73,1,1.0
5060,120,65,91,156,1,1.0
5061,120,42,45,87,1,1.0
5062,120,28,34,62,1,1.0
5063,120,28,32,60,1,1.0
5064,120,39,49,88,1,1.0
5065,120,61,48,109,1,1.0
5066,120,35,85,120,1,1.0
5067,120,18,41,59,1,1.0
5068,120,45,64,109,1,1.0
5069,120,22,38,60,1,1.0
5070,120,8,20,28,1,1.0
5071,120,19,27,46,1,1.0
5072,120,45,124,169,1,1.0
5073,120,47,49,96,1,1.0
5074,120,46,44,90,1,1.0
5075,120,54,118,172,1,1.0
5076,120,36,72,108,1,1.0
5077,120,62,54,116,1,1.0
5078,120,33,163,196,1,1.0
5079,120,21,34,55,1,1.0
5080,120,13,19,32,1,1.0
5081,120,30,69,99,1,1.0
5082,120,24,53,77,1,1.0
5083,120,15,25,40,1,1.0
5084,120,6,19,25,1,1.0
5085,120,32,50,82,1,1.0
5086,120,43,68,111,1,1.0
5087,120,32,12,44,1,1.0
5088,120,22,32,54,1,1.0
5089,120,43,82,125,1,1.0
5090,120,12,12,24,1,1.0
5091,120,44,42,86,1,1.0
5092,120,16,42,58,1,1.0
5093,120,63,83,146,1,1.0
5094,120,32,34,66,1,1.0
5095,120,23,40,63,1,1.0
5096,120,10,26,36,1,1.0
5097,120,6,18,24,1,1.0
5098,120,24,25,49,1,1.0
5099,120,24,13,37,1,1.0
5100,120,2,5,7,1,1.0
5101,120,8,38,46,1,1.0
5102,120,31,76,107,1,1.0
5103,120,20,68,88,1,1.0
5104,120,38,73,111,1,1.0
5105,120,38,27,65,1,1.0
5106,120,39,51,90,1,1.0
5107,120,89,104,193,1,1.0
5108,120,25,22,47,1,1.0
5109,120,32,47,79,1,1.0
5110,120,17,37,54,1,1.0
5111,120,40,77,117,1,1.0
5112,120,16,24,40,1,1.0
5113,120,22,41,63,1,1.0
5114,120,34,83,117,1,1.0
5115,120,26,75,101,1,1.0
5116,120,0,2,2,1,1.0
5117,120,12,9,21,1,1.0
5118,120,32,81,113,1,1.0
5119,120,148,244,392,1,1.0
5120,120,47,76,123,1,1.0
5121,120,47,23,70,1,1.0
5122,120,23,45,68,1,1.0
5123,120,172,354,526,1,1.0
5124,120,39,58,97,1,1.0
5125,120,51,74,125,1,1.0
5126,120,14,13,27,1,1.0
5127,120,25,36,61,1,1.0
5128,120,14,24,38,1,1.0
5129,120,10,33,43,1,1.0
5130,120,14,21,35,1,1.0
5131,120,3,2,5,1,1.0
5132,120,12,54,66,1,1.0
5133,120,28,31,59,1,1.0
5134,120,16,28,44,1,1.0
5135,120,24,50,74,1,1.0
5136,120,37,31,68,1,1.0
5137,120,52,55,107,1,1.0
5138,120,21,28,49,1,1.0
5139,120,57,69,126,1,1.0
5140,120,9,16,25,1,1.0
5141,120,35,35,70,1,1.0
5142,120,16,16,32,1,1.0
5143,120,22,28,50,1,1.0
5144,120,48,82,130,1,1.0
5145,120,13,15,28,1,1.0
5146,120,9,58,67,1,1.0
5147,120,7,8,15,1,1.0
5148,120,1,8,9,1,1.0
5149,120,11,11,22,1,1.0
5150,120,56,79,135,1,1.0
5151,120,26,44,70,1,1.0
5152,120,28,49,77,1,1.0
5153,120,39,63,102,1,1.0
5154,120,138,202,340,1,1.0
5155,120,56,87,143,1,1.0
5156,120,72,109,181,1,1.0
5157,120,23,101,124,1,1.0
5158,120,37,63,100,1,1.0
5159,120,34,60,94,1,1.0
5160,120,17,37,54,1,1.0
5161,120,6,24,30,1,1.0
5162,120,7,21,28,1,1.0
5163,120,13,14,27,1,1.0
5164,120,7,7,14,1,1.0
5165,120,20,47,67,1,1.0
5166,120,55,81,136,1,1.0
5167,120,66,76,142,1,1.0
5168,120,108,93,201,1,1.0
5169,120,42,50,92,1,1.0
5170,120,67,95,162,1,1.0
5171,120,60,84,144,1,1.0
5172,120,136,200,336,1,1.0
5173,120,104,127,231,1,1.0
5174,120,44,84,128,1,1.0
5175,120,33,69,102,1,1.0
5176,120,62,70,132,1,1.0
5177,120,42,70,112,1,1.0
5178,120,74,175,249,1,1.0
5179,120,26,61,87,1,1.0
5180,120,25,30,55,1,1.0
5181,120,25,39,64,1,1.0
5182,120,16,48,64,1,1.0
5183,120,6,8,14,1,1.0
5184,120,15,19,34,1,1.0
5185,120,58,96,154,1,1.0
5186,120,2,14,16,1,1.0
5187,120,36,80,116,1,1.0
5188,120,38,51,89,1,1.0
5189,120,30,48,78,1,1.0
5190,120,25,46,71,1,1.0
5191,120,14,19,33,1,1.0
5192,120,23,19,42,1,1.0
5193,120,38,94,132,1,1.0
5194,120,63,96,159,1,1.0
5195,120,54,57,111,1,1.0
5196,120,22,42,64,1,1.0
5197,120,42,70,112,1,1.0
5198,120,6,28,34,1,1.0
5199,120,15,9,24,1,1.0
5200,120,17,22,39,1,1.0
5201,120,23,28,51,1,1.0
5202,120,83,136,219,1,1.0
5203,120,16,23,39,1,1.0
5204,120,26,13,39,1,1.0
5205,120,34,72,106,1,1.0
5206,120,28,55,83,1,1.0
5207,120,42,61,103,1,1.0
5208,120,38,70,108,1,1.0
5209,120,52,104,156,1,1.0
5210,120,99,96,195,1,1.0
5211,120,40,109,149,1,1.0
5212,120,34,38,72,1,1.0
5213,120,9,10,19,1,1.0
5214,120,38,97,135,1,1.0
5215,120,11,20,31,1,1.0
5216,120,13,33,46,1,1.0
5217,120,7,3,10,1,1.0
5218,120,37,55,92,1,1.0
5219,120,31,62,93,1,1.0
5220,120,57,103,160,1,1.0
5221,120,23,32,55,1,1.0
5222,120,32,86,118,1,1.0
5223,120,52,52,104,1,1.0
5224,120,11,30,41,1,1.0
5225,120,7,18,25,1,1.0
5226,120,35,56,91,1,1.0
5227,120,6,10,16,1,1.0
5228,120,18,28,46,1,1.0
5229,120,9,11,20,1,1.0
5230,120,17,26,43,1,1.0
5231,120,4,10,14,1,1.0
5232,120,94,235,329,1,1.0
5233,120,50,111,161,1,1.0
5234,120,64,57,121,1,1.0
5235,120,78,160,238,1,1.0
5236,120,19,16,35,1,1.0
5237,120,60,105,165,1,1.0
5238,120,32,54,86,1,1.0
5239,120,15,32,47,1,1.0
5240,120,29,67,96,1,1.0
5241,120,24,20,44,1,1.0
5242,120,25,49,74,1,1.0
5243,120,4,4,8,1,1.0
5244,120,10,32,42,1,1.0
5245,120,14,21,35,1,1.0
5246,120,13,13,26,1,1.0
5247,120,18,14,32,1,1.0
5248,120,12,19,31,1,1.0
5249,120,69,49,118,1,1.0
5250,120,39,60,99,1,1.0
5251,120,32,56,88,1,1.0
5252,120,25,46,71,1,1.0
5253,120,56,62,118,1,1.0
5254,120,20,30,50,1,1.0
5255,120,47,79,126,1,1.0
5256,120,16,17,33,1,1.0
5257,120,14,17,31,1,1.0
5258,120,7,10,17,1,1.0
5259,120,22,21,43,1,1.0
5260,120,43,55,98,1,1.0
5261,120,22,60,82,1,1.0
5262,120,11,17,28,1,1.0
5263,120,1,3,4,1,1.0
5264,120,67,158,225,1,1.0
5265,120,46,77,123,1,1.0
5266,120,42,132,174,1,1.0
5267,120,21,54,75,1,1.0
5268,120,37,90,127,1,1.0
5269,120,58,127,185,1,1.0
5270,120,23,38,61,1,1.0
5271,120,24,58,82,1,1.0
5272,120,40,60,100,1,1.0
5273,120,14,25,39,1,1.0
5274,120,1,4,5,1,1.0
5275,120,3,6,9,1,1.0
5276,120,0,3,3,1,1.0
5277,120,66,92,158,1,1.0
5278,120,16,33,49,1,1.0
5279,120,11,27,38,1,1.0
5280,120,28,66,94,1,1.0
5281,120,46,53,99,1,1.0
5282,120,18,41,59,1,1.0
5283,120,15,14,29,1,1.0
5284,120,17,16,33,1,1.0
5285,120,7,24,31,1,1.0
5286,120,9,16,25,1,1.0
5287,120,2,8,10,1,1.0
5288,120,13,15,28,1,1.0
5289,120,4,17,21,1,1.0
5290,120,2,6,8,1,1.0
5291,120,58,93,151,1,1.0
5292,120,23,36,59,1,1.0
5293,120,27,42,69,1,1.0
5294,120,22,47,69,1,1.0
5295,120,83,95,178,1,1.0
5296,120,45,121,166,1,1.0
5297,120,21,30,51,1,1.0
5298,120,30,40,70,1,1.0
5299,120,31,63,94,1,1.0
5300,120,18,22,40,1,1.0
5301,120,11,3,14,1,1.0
5302,120,52,61,113,1,1.0
5303,120,16,19,35,1,1.0
5304,120,15,14,29,1,1.0
5305,120,9,12,21,1,1.0
5306,120,28,56,84,1,1.0
5307,120,32,71,103,1,1.0
5308,120,27,42,69,1,1.0
5309,120,25,51,76,1,1.0
5310,120,22,64,86,1,1.0
5311,120,30,67,97,1,1.0
5312,120,52,54,106,1,1.0
5313,120,18,19,37,1,1.0
5314,120,36,37,73,1,1.0
5315,120,16,29,45,1,1.0
5316,120,3,10,13,1,1.0
5317,120,28,22,50,1,1.0
5318,120,30,41,71,1,1.0
5319,120,15,27,42,1,1.0
5320,120,6,20,26,1,1.0
5321,120,27,37,64,1,1.0
5322,120,51,104,155,1,1.0
5323,120,57,91,148,1,1.0
5324,120,64,101,165,1,1.0
5325,120,72,136,208,1,1.0
5326,120,21,25,46,1,1.0
5327,120,17,28,45,1,1.0
5328,120,37,43,80,1,1.0
5329,120,42,74,116,1,1.0
5330,120,58,48,106,1,1.0
5331,120,10,13,23,1,1.0
5332,120,14,28,42,1,1.0
5333,120,2,16,18,1,1.0
5334,120,3,6,9,1,1.0
5335,120,4,6,10,1,1.0
5336,120,5,12,17,1,1.0
5337,120,1,6,7,1,1.0
5338,120,9,13,22,1,1.0
5339,120,19,121,140,1,1.0
5340,120,31,26,57,1,1.0
5341,120,28,62,90,1,1.0
5342,120,35,64,99,1,1.0
5343,120,29,42,71,1,1.0
5344,120,47,96,143,1,1.0
5345,120,29,26,55,1,1.0
5346,120,16,31,47,1,1.0
5347,120,76,122,198,1,1.0
5348,120,129,140,269,1,1.0
5349,120,35,63,98,1,1.0
5350,120,2,5,7,1,1.0
5351,120,12,24,36,1,1.0
5352,120,0,0,0,1,1.0
5353,120,2,2,4,1,1.0
5354,180,31,69,100,1,1.0
5355,180,22,10,32,1,1.0
5356,180,88,67,155,1,1.0
5357,180,57,57,114,1,1.0
5358,180,100,94,194,1,1.0
5359,180,47,96,143,1,1.0
5360,180,108,120,228,1,1.0
5361,180,111,119,230,1,1.0
5362,180,108,59,167,1,1.0
5363,180,43,54,97,1,1.0
5364,180,76,114,190,1,1.0
5365,180,84,121,205,1,1.0
5366,180,58,73,131,1,1.0
5367,180,24,41,65,1,1.0
5368,180,11,10,21,1,1.0
5369,180,46,80,126,1,1.0
5370,180,75,121,196,1,1.0
5371,180,36,31,67,1,1.0
5372,180,114,114,228,1,1.0
5373,180,80,66,146,1,1.0
5374,180,120,152,272,1,1.0
5375,180,171,286,457,1,1.0
5376,180,112,167,279,1,1.0
5377,180,50,63,113,1,1.0
5378,180,93,90,183,1,1.0
5379,180,66,88,154,1,1.0
5380,180,21,22,43,1,1.0
5381,180,85,138,223,1,1.0
5382,180,3,18,21,1,1.0
5383,180,7,19,26,1,1.0
5384,180,116,366,482,1,1.0
5385,180,86,142,228,1,1.0
5386,180,82,86,168,1,1.0
5387,180,113,115,228,1,1.0
5388,180,32,65,97,1,1.0
5389,180,51,100,151,1,1.0
5390,180,27,29,56,1,1.0
5391,180,104,98,202,1,1.0
5392,180,30,40,70,1,1.0
5393,180,8,25,33,1,1.0
5394,180,13,29,42,1,1.0
5395,180,25,49,74,1,1.0
5396,180,67,50,117,1,1.0
5397,180,34,61,95,1,1.0
5398,180,28,39,67,1,1.0
5399,180,49,51,100,1,1.0
5400,180,51,89,140,1,1.0
5401,180,94,118,212,1,1.0
5402,180,46,85,131,1,1.0
5403,180,63,83,146,1,1.0
5404,180,60,126,186,1,1.0
5405,180,110,242,352,1,1.0
5406,180,35,41,76,1,1.0
5407,180,89,241,330,1,1.0
5408,180,38,124,162,1,1.0
5409,180,15,31,46,1,1.0
5410,180,108,133,241,1,1.0
5411,180,74,103,177,1,1.0
5412,180,47,31,78,1,1.0
5413,180,73,72,145,1,1.0
5414,180,64,110,174,1,1.0
5415,180,49,80,129,1,1.0
5416,180,125,153,278,1,1.0
5417,180,38,37,75,1,1.0
5418,180,28,43,71,1,1.0
5419,180,27,39,66,1,1.0
5420,180,22,46,68,1,1.0
5421,180,13,12,25,1,1.0
5422,180,41,99,140,1,1.0
5423,180,22,28,50,1,1.0
5424,180,58,66,124,1,1.0
5425,180,53,65,118,1,1.0
5426,180,36,55,91,1,1.0
5427,180,18,27,45,1,1.0
5428,180,79,106,185,1,1.0
5429,180,30,35,65,1,1.0
5430,180,22,56,78,1,1.0
5431,180,56,82,138,1,1.0
5432,180,37,22,59,1,1.0
5433,180,39,64,103,1,1.0
5434,180,57,96,153,1,1.0
5435,180,57,34,91,1,1.0
5436,180,26,37,63,1,1.0
5437,180,141,169,310,1,1.0
5438,180,8,16,24,1,1.0
5439,180,145,192,337,1,1.0
5440,180,32,33,65,1,1.0
5441,180,56,85,141,1,1.0
5442,180,15,34,49,1,1.0
5443,180,86,138,224,1,1.0
5444,180,44,115,159,1,1.0
5445,180,37,67,104,1,1.0
5446,180,56,116,172,1,1.0
5447,180,17,45,62,1,1.0
5448,180,51,76,127,1,1.0
5449,180,13,14,27,1,1.0
5450,180,33,72,105,1,1.0
5451,180,54,137,191,1,1.0
5452,180,29,30,59,1,1.0
5453,180,81,111,192,1,1.0
5454,180,43,74,117,1,1.0
5455,180,65,124,189,1,1.0
5456,180,65,71,136,1,1.0
5457,180,40,60,100,1,1.0
5458,180,47,71,118,1,1.0
5459,180,19,29,48,1,1.0
5460,180,46,58,104,1,1.0
5461,180,39,65,104,1,1.0
5462,180,44,47,91,1,1.0
5463,180,3,11,14,1,1.0
5464,180,13,37,50,1,1.0
5465,180,23,36,59,1,1.0
5466,180,11,15,26,1,1.0
5467,180,43,71,114,1,1.0
5468,180,31,51,82,1,1.0
5469,180,30,46,76,1,1.0
5470,180,63,77,140,1,1.0
5471,180,27,42,69,1,1.0
5472,180,32,40,72,1,1.0
5473,180,12,8,20,1,1.0
5474,180,9,21,30,1,1.0
5475,180,16,32,48,1,1.0
5476,180,31,60,91,1,1.0
5477,180,41,42,83,1,1.0
5478,180,48,71,119,1,1.0
5479,180,23,15,38,1,1.0
5480,180,38,35,73,1,1.0
5481,180,67,125,192,1,1.0
5482,180,39,80,119,1,1.0
5483,180,61,117,178,1,1.0
5484,180,46,85,131,1,1.0
5485,180,77,104,181,1,1.0
5486,180,145,180,325,1,1.0
5487,180,46,155,201,1,1.0
5488,180,60,80,140,1,1.0
5489,180,14,33,47,1,1.0
5490,180,53,80,133,1,1.0
5491,180,39,29,68,1,1.0
5492,180,29,34,63,1,1.0
5493,180,51,146,197,1,1.0
5494,180,64,139,203,1,1.0
5495,180,54,91,145,1,1.0
5496,180,40,53,93,1,1.0
5497,180,42,69,111,1,1.0
5498,180,43,114,157,1,1.0
5499,180,43,50,93,1,1.0
5500,180,54,66,120,1,1.0
5501,180,18,27,45,1,1.0
5502,180,20,49,69,1,1.0
5503,180,23,43,66,1,1.0
5504,180,23,50,73,1,1.0
5505,180,72,130,202,1,1.0
5506,180,54,89,143,1,1.0
5507,180,32,106,138,1,1.0
5508,180,56,96,152,1,1.0
5509,180,11,28,39,1,1.0
5510,180,28,53,81,1,1.0
5511,180,16,16,32,1,1.0
5512,180,69,91,160,1,1.0
5513,180,28,50,78,1,1.0
5514,180,44,79,123,1,1.0
5515,180,66,131,197,1,1.0
5516,180,41,66,107,1,1.0
5517,180,64,75,139,1,1.0
5518,180,13,20,33,1,1.0
5519,180,76,168,244,1,1.0
5520,180,66,101,167,1,1.0
5521,180,43,61,104,1,1.0
5522,180,45,64,109,1,1.0
5523,180,58,60,118,1,1.0
5524,180,11,21,32,1,1.0
5525,180,15,17,32,1,1.0
5526,180,2,4,6,1,1.0
5527,180,21,43,64,1,1.0
5528,180,45,47,92,1,1.0
5529,180,26,37,63,1,1.0
5530,180,47,84,131,1,1.0
5531,180,20,42,62,1,1.0
5532,180,24,38,62,1,1.0
5533,180,46,73,119,1,1.0
5534,180,36,60,96,1,1.0
5535,180,28,51,79,1,1.0
5536,180,68,104,172,1,1.0
5537,180,23,30,53,1,1.0
5538,180,14,22,36,1,1.0
5539,180,31,73,104,1,1.0
5540,180,8,19,27,1,1.0
5541,180,9,13,22,1,1.0
5542,180,3,12,15,1,1.0
5543,180,25,26,51,1,1.0
5544,180,24,28,52,1,1.0
5545,180,47,37,84,1,1.0
5546,180,19,57,76,1,1.0
5547,180,30,36,66,1,1.0
5548,180,39,57,96,1,1.0
5549,180,55,92,147,1,1.0
5550,180,34,71,105,1,1.0
5551,180,18,7,25,1,1.0
5552,180,12,21,33,1,1.0
5553,180,84,90,174,1,1.0
5554,180,37,46,83,1,1.0
5555,180,18,20,38,1,1.0
5556,180,45,55,100,1,1.0
5557,180,22,83,105,1,1.0
5558,180,25,65,90,1,1.0
5559,180,20,35,55,1,1.0
5560,180,32,38,70,1,1.0
5561,180,6,4,10,1,1.0
5562,180,4,4,8,1,1.0
5563,180,39,50,89,1,1.0
5564,180,30,54,84,1,1.0
5565,180,120,178,298,1,1.0
5566,180,21,49,70,1,1.0
5567,180,13,36,49,1,1.0
5568,180,37,79,116,1,1.0
5569,180,55,44,99,1,1.0
5570,180,26,31,57,1,1.0
5571,180,57,77,134,1,1.0
5572,180,39,62,101,1,1.0
5573,180,30,53,83,1,1.0
5574,180,47,56,103,1,1.0
5575,180,22,30,52,1,1.0
5576,180,33,44,77,1,1.0
5577,180,2,17,19,1,1.0
5578,180,23,80,103,1,1.0
5579,180,23,107,130,1,1.0
5580,180,61,74,135,1,1.0
5581,180,64,86,150,1,1.0
5582,180,97,210,307,1,1.0
5583,180,59,99,158,1,1.0
5584,180,85,105,190,1,1.0
5585,180,131,273,404,1,1.0
5586,180,45,81,126,1,1.0
5587,180,70,155,225,1,1.0
5588,180,71,136,207,1,1.0
5589,180,10,40,50,1,1.0
5590,180,12,24,36,1,1.0
5591,180,15,41,56,1,1.0
5592,180,16,31,47,1,1.0
5593,180,21,54,75,1,1.0
5594,180,43,71,114,1,1.0
5595,180,67,76,143,1,1.0
5596,180,92,138,230,1,1.0
5597,180,43,52,95,1,1.0
5598,180,39,71,110,1,1.0
5599,180,33,95,128,1,1.0
5600,180,58,85,143,1,1.0
5601,180,7,16,23,1,1.0
5602,180,16,13,29,1,1.0
5603,180,31,22,53,1,1.0
5604,180,75,172,247,1,1.0
5605,180,87,117,204,1,1.0
5606,180,39,60,99,1,1.0
5607,180,100,208,308,1,1.0
5608,180,53,54,107,1,1.0
5609,180,36,68,104,1,1.0
5610,180,21,27,48,1,1.0
5611,180,34,29,63,1,1.0
5612,180,42,65,107,1,1.0
5613,180,28,27,55,1,1.0
5614,180,15,14,29,1,1.0
5615,180,60,55,115,1,1.0
5616,180,13,26,39,1,1.0
5617,180,30,29,59,1,1.0
5618,180,91,6,97,1,1.0
5619,180,19,12,31,1,1.0
5620,180,46,68,114,1,1.0
5621,180,57,68,125,1,1.0
5622,180,44,60,104,1,1.0
5623,180,15,39,54,1,1.0
5624,180,26,38,64,1,1.0
5625,180,49,62,111,1,1.0
5626,180,58,50,108,1,1.0
5627,180,37,28,65,1,1.0
5628,180,80,80,160,1,1.0
5629,180,41,85,126,1,1.0
5630,180,12,20,32,1,1.0
5631,180,12,23,35,1,1.0
5632,180,50,67,117,1,1.0
5633,180,31,47,78,1,1.0
5634,180,124,129,253,1,1.0
5635,180,36,41,77,1,1.0
5636,180,36,66,102,1,1.0
5637,180,65,100,165,1,1.0
5638,180,38,34,72,1,1.0
5639,180,106,97,203,1,1.0
5640,180,29,62,91,1,1.0
5641,180,16,18,34,1,1.0
5642,180,18,23,41,1,1.0
5643,180,19,20,39,1,1.0
5644,180,12,15,27,1,1.0
5645,180,3,10,13,1,1.0
5646,180,72,127,199,1,1.0
5647,180,32,46,78,1,1.0
5648,180,35,47,82,1,1.0
5649,180,82,147,229,1,1.0
5650,180,20,27,47,1,1.0
5651,180,82,125,207,1,1.0
5652,180,30,61,91,1,1.0
5653,180,38,75,113,1,1.0
5654,180,25,27,52,1,1.0
5655,180,29,76,105,1,1.0
5656,180,50,79,129,1,1.0
5657,180,9,25,34,1,1.0
5658,180,30,86,116,1,1.0
5659,180,93,97,190,1,1.0
5660,180,27,58,85,1,1.0
5661,180,50,81,131,1,1.0
5662,180,14,28,42,1,1.0
5663,180,37,57,94,1,1.0
5664,180,17,16,33,1,1.0
5665,180,12,18,30,1,1.0
5666,180,28,50,78,1,1.0
5667,180,10,5,15,1,1.0
5668,180,65,143,208,1,1.0
5669,180,10,28,38,1,1.0
5670,180,50,140,190,1,1.0
5671,180,23,12,35,1,1.0
5672,180,11,23,34,1,1.0
5673,180,17,25,42,1,1.0
5674,180,73,121,194,1,1.0
5675,180,8,36,44,1,1.0
5676,180,35,78,113,1,1.0
5677,180,43,79,122,1,1.0
5678,180,43,47,90,1,1.0
5679,180,21,47,68,1,1.0
5680,180,38,69,107,1,1.0
5681,180,14,38,52,1,1.0
5682,180,23,27,50,1,1.0
5683,180,15,31,46,1,1.0
5684,180,53,68,121,1,1.0
5685,180,8,19,27,1,1.0
5686,180,13,30,43,1,1.0
5687,180,14,16,30,1,1.0
5688,180,23,51,74,1,1.0
5689,180,30,13,43,1,1.0
5690,180,31,62,93,1,1.0
5691,180,64,140,204,1,1.0
5692,180,78,95,173,1,1.0
5693,180,32,65,97,1,1.0
5694,180,34,76,110,1,1.0
5695,180,41,58,99,1,1.0
5696,180,81,69,150,1,1.0
5697,180,63,96,159,1,1.0
5698,180,20,36,56,1,1.0
5699,180,14,38,52,1,1.0
5700,180,46,75,121,1,1.0
5701,180,14,26,40,1,1.0
5702,180,27,74,101,1,1.0
5703,180,5,9,14,1,1.0
5704,180,16,36,52,1,1.0
5705,180,34,52,86,1,1.0
5706,180,36,73,109,1,1.0
5707,180,34,34,68,1,1.0
5708,180,58,33,91,1,1.0
5709,180,46,64,110,1,1.0
5710,180,40,44,84,1,1.0
5711,180,25,65,90,1,1.0
5712,180,75,108,183,1,1.0
5713,180,31,42,73,1,1.0
5714,180,26,61,87,1,1.0
5715,180,46,66,112,1,1.0
5716,180,28,64,92,1,1.0
5717,180,4,17,21,1,1.0
5718,180,50,48,98,1,1.0
5719,180,45,81,126,1,1.0
5720,180,36,62,98,1,1.0
5721,180,56,94,150,1,1.0
5722,180,46,57,103,1,1.0
5723,180,29,32,61,1,1.0
5724,180,27,34,61,1,1.0
5725,180,30,62,92,1,1.0
5726,180,39,43,82,1,1.0
5727,180,23,36,59,1,1.0
5728,180,49,78,127,1,1.0
5729,180,15,40,55,1,1.0
5730,180,36,38,74,1,1.0
5731,180,9,10,19,1,1.0
5732,180,22,15,37,1,1.0
5733,180,30,64,94,1,1.0
5734,180,36,26,62,1,1.0
5735,180,49,119,168,1,1.0
5736,180,71,136,207,1,1.0
5737,180,18,47,65,1,1.0
5738,180,85,156,241,1,1.0
5739,180,34,78,112,1,1.0
5740,180,25,50,75,1,1.0
5741,180,45,94,139,1,1.0
5742,180,25,66,91,1,1.0
5743,180,10,10,20,1,1.0
5744,180,22,29,51,1,1.0
5745,180,9,19,28,1,1.0
5746,180,4,5,9,1,1.0
5747,180,72,90,162,1,1.0
5748,180,26,42,68,1,1.0
5749,180,92,130,222,1,1.0
5750,180,60,120,180,1,1.0
5751,180,57,80,137,1,1.0
5752,180,46,56,102,1,1.0
5753,180,34,64,98,1,1.0
5754,180,55,94,149,1,1.0
5755,180,56,119,175,1,1.0
5756,180,28,81,109,1,1.0
5757,180,28,52,80,1,1.0
5758,180,20,19,39,1,1.0
5759,180,51,66,117,1,1.0
5760,180,33,56,89,1,1.0
5761,180,55,103,158,1,1.0
5762,180,29,55,84,1,1.0
5763,180,83,122,205,1,1.0
5764,180,67,87,154,1,1.0
5765,180,35,14,49,1,1.0
5766,180,28,51,79,1,1.0
5767,180,44,109,153,1,1.0
5768,180,12,41,53,1,1.0
5769,180,43,45,88,1,1.0
5770,180,45,71,116,1,1.0
5771,180,9,31,40,1,1.0
5772,30,43,27,70,1,10.0
5773,30,63,30,93,1,10.0
5774,30,21,25,46,1,10.0
5775,30,12,32,44,1,10.0
5776,30,73,75,148,1,10.0
5777,30,93,55,148,1,10.0
5778,30,51,51,102,1,10.0
5779,30,55,63,118,1,10.0
5780,30,49,27,76,1,10.0
5781,30,46,38,84,1,10.0
5782,30,55,67,122,1,10.0
5783,30,23,24,47,1,10.0
5784,30,4,7,11,1,10.0
5785,30,93,100,193,1,10.0
5786,30,16,3,19,1,10.0
5787,30,18,13,31,1,10.0
5788,30,13,9,22,1,10.0
5789,30,49,64,113,1,10.0
5790,30,69,53,122,1,10.0
5791,30,91,109,200,1,10.0
5792,30,20,33,53,1,10.0
5793,30,64,78,142,1,10.0
5794,30,61,41,102,1,10.0
5795,30,56,66,122,1,10.0
5796,30,32,53,85,1,10.0
5797,30,23,20,43,1,10.0
5798,30,29,36,65,1,10.0
5799,30,76,61,137,1,10.0
5800,30,23,42,65,1,10.0
5801,30,39,45,84,1,10.0
5802,30,17,19,36,1,10.0
5803,30,4,7,11,1,10.0
5804,30,29,27,56,1,10.0
5805,30,70,99,169,1,10.0
5806,30,32,27,59,1,10.0
5807,30,86,102,188,1,10.0
5808,30,103,118,221,1,10.0
5809,30,55,46,101,1,10.0
5810,30,17,17,34,1,10.0
5811,30,84,60,144,1,10.0
5812,30,78,59,137,1,10.0
5813,30,30,23,53,1,10.0
5814,30,56,24,80,1,10.0
5815,30,48,54,102,1,10.0
5816,30,94,69,163,1,10.0
5817,30,26,37,63,1,10.0
5818,30,41,35,76,1,10.0
5819,30,30,29,59,1,10.0
5820,30,60,33,93,1,10.0
5821,30,31,74,105,1,10.0
5822,30,28,19,47,1,10.0
5823,30,42,56,98,1,10.0
5824,30,15,16,31,1,10.0
5825,30,54,55,109,1,10.0
5826,30,62,17,79,1,10.0
5827,30,25,53,78,1,10.0
5828,30,99,76,175,1,10.0
5829,30,37,60,97,1,10.0
5830,30,42,41,83,1,10.0
5831,30,56,61,117,1,10.0
5832,30,39,58,97,1,10.0
5833,30,4,15,19,1,10.0
5834,30,81,68,149,1,10.0
5835,30,57,59,116,1,10.0
5836,30,27,33,60,1,10.0
5837,30,66,40,106,1,10.0
5838,30,78,91,169,1,10.0
5839,30,53,56,109,1,10.0
5840,30,25,43,68,1,10.0
5841,30,65,109,174,1,10.0
5842,30,32,27,59,1,10.0
5843,30,37,44,81,1,10.0
5844,30,104,104,208,1,10.0
5845,30,109,54,163,1,10.0
5846,30,78,45,123,1,10.0
5847,30,24,44,68,1,10.0
5848,30,31,85,116,1,10.0
5849,30,1,11,12,1,10.0
5850,30,102,82,184,1,10.0
5851,30,83,85,168,1,10.0
5852,30,23,35,58,1,10.0
5853,30,37,59,96,1,10.0
5854,30,83,61,144,1,10.0
5855,30,71,66,137,1,10.0
5856,30,47,34,81,1,10.0
5857,30,31,41,72,1,10.0
5858,30,47,29,76,1,10.0
5859,30,26,39,65,1,10.0
5860,30,10,22,32,1,10.0
5861,30,19,7,26,1,10.0
5862,30,18,19,37,1,10.0
5863,30,15,10,25,1,10.0
5864,30,45,47,92,1,10.0
5865,30,40,30,70,1,10.0
5866,30,44,38,82,1,10.0
5867,30,23,16,39,1,10.0
5868,30,34,20,54,1,10.0
5869,30,31,28,59,1,10.0
5870,30,87,74,161,1,10.0
5871,30,34,34,68,1,10.0
5872,30,77,57,134,1,10.0
5873,30,94,93,187,1,10.0
5874,30,11,19,30,1,10.0
5875,30,37,20,57,1,10.0
5876,30,19,28,47,1,10.0
5877,30,4,7,11,1,10.0
5878,30,50,41,91,1,10.0
5879,30,22,21,43,1,10.0
5880,30,9,7,16,1,10.0
5881,30,4,7,11,1,10.0
5882,30,48,74,122,1,10.0
5883,30,64,58,122,1,10.0
5884,30,21,1,22,1,10.0
5885,30,12,34,46,1,10.0
5886,30,72,50,122,1,10.0
5887,30,65,106,171,1,10.0
5888,30,44,57,101,1,10.0
5889,30,39,26,65,1,10.0
5890,30,49,55,104,1,10.0
5891,30,7,36,43,1,10.0
5892,30,24,44,68,1,10.0
5893,30,24,20,44,1,10.0
5894,30,30,35,65,1,10.0
5895,30,27,18,45,1,10.0
5896,30,63,75,138,1,10.0
5897,30,21,46,67,1,10.0
5898,30,5,4,9,1,10.0
5899,30,56,92,148,1,10.0
5900,30,37,75,112,1,10.0
5901,30,36,64,100,1,10.0
5902,30,46,129,175,1,10.0
5903,30,77,108,185,1,10.0
5904,30,107,129,236,1,10.0
5905,30,39,59,98,1,10.0
5906,30,16,15,31,1,10.0
5907,30,35,36,71,1,10.0
5908,30,28,48,76,1,10.0
5909,30,45,36,81,1,10.0
5910,30,22,29,51,1,10.0
5911,30,10,13,23,1,10.0
5912,30,108,180,288,1,10.0
5913,30,67,106,173,1,10.0
5914,30,50,30,80,1,10.0
5915,30,59,81,140,1,10.0
5916,30,51,14,65,1,10.0
5917,30,29,20,49,1,10.0
5918,30,69,53,122,1,10.0
5919,30,51,43,94,1,10.0
5920,30,21,44,65,1,10.0
5921,30,106,126,232,1,10.0
5922,30,14,18,32,1,10.0
5923,30,25,27,52,1,10.0
5924,30,40,60,100,1,10.0
5925,30,67,54,121,1,10.0
5926,30,24,36,60,1,10.0
5927,30,13,26,39,1,10.0
5928,30,49,74,123,1,10.0
5929,30,93,91,184,1,10.0
5930,30,27,29,56,1,10.0
5931,30,41,46,87,1,10.0
5932,30,32,38,70,1,10.0
5933,30,21,31,52,1,10.0
5934,30,56,87,143,1,10.0
5935,30,110,133,243,1,10.0
5936,30,49,27,76,1,10.0
5937,30,37,15,52,1,10.0
5938,30,43,73,116,1,10.0
5939,30,56,34,90,1,10.0
5940,30,45,62,107,1,10.0
5941,30,84,54,138,1,10.0
5942,30,92,146,238,1,10.0
5943,30,41,57,98,1,10.0
5944,30,44,27,71,1,10.0
5945,30,26,40,66,1,10.0
5946,30,33,32,65,1,10.0
5947,30,25,39,64,1,10.0
5948,30,47,87,134,1,10.0
5949,30,63,74,137,1,10.0
5950,30,65,62,127,1,10.0
5951,30,53,67,120,1,10.0
5952,30,62,70,132,1,10.0
5953,30,71,83,154,1,10.0
5954,30,48,59,107,1,10.0
5955,30,34,34,68,1,10.0
5956,30,40,40,80,1,10.0
5957,30,43,42,85,1,10.0
5958,30,19,27,46,1,10.0
5959,30,48,52,100,1,10.0
5960,30,59,83,142,1,10.0
5961,30,44,48,92,1,10.0
5962,30,70,96,166,1,10.0
5963,30,42,40,82,1,10.0
5964,30,67,120,187,1,10.0
5965,30,44,107,151,1,10.0
5966,30,25,37,62,1,10.0
5967,30,28,39,67,1,10.0
5968,30,32,37,69,1,10.0
5969,30,33,24,57,1,10.0
5970,30,80,85,165,1,10.0
5971,30,59,80,139,1,10.0
5972,30,40,27,67,1,10.0
5973,30,60,58,118,1,10.0
5974,30,40,35,75,1,10.0
5975,30,6,6,12,1,10.0
5976,30,55,30,85,1,10.0
5977,30,73,91,164,1,10.0
5978,30,81,81,162,1,10.0
5979,30,14,21,35,1,10.0
5980,30,32,44,76,1,10.0
5981,30,48,22,70,1,10.0
5982,30,49,52,101,1,10.0
5983,30,15,16,31,1,10.0
5984,30,14,14,28,1,10.0
5985,30,31,36,67,1,10.0
5986,30,12,16,28,1,10.0
5987,30,21,5,26,1,10.0
5988,30,29,35,64,1,10.0
5989,30,9,10,19,1,10.0
5990,30,84,79,163,1,10.0
5991,30,15,23,38,1,10.0
5992,30,63,64,127,1,10.0
5993,30,65,78,143,1,10.0
5994,30,49,90,139,1,10.0
5995,30,91,63,154,1,10.0
5996,30,55,67,122,1,10.0
5997,30,70,53,123,1,10.0
5998,30,26,40,66,1,10.0
5999,30,56,30,86,1,10.0
6000,30,59,73,132,1,10.0
6001,30,44,71,115,1,10.0
6002,30,12,10,22,1,10.0
6003,30,54,65,119,1,10.0
6004,30,23,30,53,1,10.0
6005,30,10,6,16,1,10.0
6006,30,87,63,150,1,10.0
6007,30,35,25,60,1,10.0
6008,30,29,40,69,1,10.0
6009,30,66,69,135,1,10.0
6010,30,39,40,79,1,10.0
6011,30,73,73,146,1,10.0
6012,30,35,52,87,1,10.0
6013,30,59,67,126,1,10.0
6014,30,23,24,47,1,10.0
6015,30,38,52,90,1,10.0
6016,30,30,34,64,1,10.0
6017,30,55,46,101,1,10.0
6018,30,50,57,107,1,10.0
6019,30,17,48,65,1,10.0
6020,30,78,66,144,1,10.0
6021,30,17,19,36,1,10.0
6022,30,11,10,21,1,10.0
6023,30,63,50,113,1,10.0
6024,30,72,66,138,1,10.0
6025,30,52,64,116,1,10.0
6026,30,172,212,384,1,10.0
6027,30,64,71,135,1,10.0
6028,30,274,179,453,1,10.0
6029,30,62,57,119,1,10.0
6030,30,34,25,59,1,10.0
6031,30,20,18,38,1,10.0
6032,30,216,165,381,1,10.0
6033,30,133,122,255,1,10.0
6034,30,69,90,159,1,10.0
6035,30,25,37,62,1,10.0
6036,30,89,59,148,1,10.0
6037,30,93,35,128,1,10.0
6038,30,28,25,53,1,10.0
6039,30,7,13,20,1,10.0
6040,30,75,72,147,1,10.0
6041,30,27,16,43,1,10.0
6042,30,77,97,174,1,10.0
6043,30,53,21,74,1,10.0
6044,30,26,34,60,1,10.0
6045,30,16,26,42,1,10.0
6046,30,46,44,90,1,10.0
6047,30,57,69,126,1,10.0
6048,30,72,38,110,1,10.0
6049,30,38,38,76,1,10.0
6050,30,37,54,91,1,10.0
6051,30,71,51,122,1,10.0
6052,30,19,25,44,1,10.0
6053,30,27,54,81,1,10.0
6054,30,47,65,112,1,10.0
6055,30,38,42,80,1,10.0
6056,30,5,5,10,1,10.0
6057,30,37,56,93,1,10.0
6058,30,72,72,144,1,10.0
6059,30,41,39,80,1,10.0
6060,30,29,56,85,1,10.0
6061,30,65,72,137,1,10.0
6062,30,17,27,44,1,10.0
6063,30,82,90,172,1,10.0
6064,30,25,31,56,1,10.0
6065,30,41,36,77,1,10.0
6066,30,7,10,17,1,10.0
6067,30,28,29,57,1,10.0
6068,30,8,11,19,1,10.0
6069,30,41,46,87,1,10.0
6070,30,51,65,116,1,10.0
6071,30,47,47,94,1,10.0
6072,30,61,80,141,1,10.0
6073,30,39,61,100,1,10.0
6074,30,78,80,158,1,10.0
6075,30,12,36,48,1,10.0
6076,30,25,51,76,1,10.0
6077,30,71,55,126,1,10.0
6078,30,41,58,99,1,10.0
6079,30,37,39,76,1,10.0
6080,30,39,41,80,1,10.0
6081,30,49,61,110,1,10.0
6082,30,162,159,321,1,10.0
6083,30,40,34,74,1,10.0
6084,30,9,13,22,1,10.0
6085,30,42,45,87,1,10.0
6086,30,60,82,142,1,10.0
6087,30,50,35,85,1,10.0
6088,30,52,83,135,1,10.0
6089,30,53,52,105,1,10.0
6090,30,34,39,73,1,10.0
6091,30,12,25,37,1,10.0
6092,30,23,13,36,1,10.0
6093,30,15,19,34,1,10.0
6094,30,57,98,155,1,10.0
6095,30,45,40,85,1,10.0
6096,30,54,58,112,1,10.0
6097,30,127,137,264,1,10.0
6098,30,79,175,254,1,10.0
6099,30,64,96,160,1,10.0
6100,30,39,47,86,1,10.0
6101,30,39,45,84,1,10.0
6102,30,32,68,100,1,10.0
6103,30,18,47,65,1,10.0
6104,30,27,52,79,1,10.0
6105,30,16,13,29,1,10.0
6106,30,48,60,108,1,10.0
6107,30,113,95,208,1,10.0
6108,30,143,185,328,1,10.0
6109,30,86,105,191,1,10.0
6110,30,39,46,85,1,10.0
6111,30,60,54,114,1,10.0
6112,30,33,20,53,1,10.0
6113,30,29,21,50,1,10.0
6114,30,32,23,55,1,10.0
6115,30,46,31,77,1,10.0
6116,30,41,29,70,1,10.0
6117,30,42,37,79,1,10.0
6118,30,19,16,35,1,10.0
6119,30,6,11,17,1,10.0
6120,30,16,16,32,1,10.0
6121,30,8,20,28,1,10.0
6122,30,24,20,44,1,10.0
6123,30,149,173,322,1,10.0
6124,30,178,212,390,1,10.0
6125,30,123,179,302,1,10.0
6126,30,76,63,139,1,10.0
6127,30,13,19,32,1,10.0
6128,30,65,95,160,1,10.0
6129,30,40,47,87,1,10.0
6130,30,107,52,159,1,10.0
6131,30,34,41,75,1,10.0
6132,30,85,104,189,1,10.0
6133,30,64,72,136,1,10.0
6134,30,37,53,90,1,10.0
6135,30,49,61,110,1,10.0
6136,30,150,250,400,1,10.0
6137,30,68,84,152,1,10.0
6138,30,106,24,130,1,10.0
6139,30,122,98,220,1,10.0
6140,30,97,88,185,1,10.0
6141,30,87,111,198,1,10.0
6142,30,121,178,299,1,10.0
6143,30,86,105,191,1,10.0
6144,30,73,61,134,1,10.0
6145,30,53,68,121,1,10.0
6146,30,18,21,39,1,10.0
6147,30,91,98,189,1,10.0
6148,30,14,31,45,1,10.0
6149,30,130,77,207,1,10.0
6150,30,29,40,69,1,10.0
6151,30,24,67,91,1,10.0
6152,30,93,81,174,1,10.0
6153,30,141,173,314,1,10.0
6154,30,8,11,19,1,10.0
6155,30,23,35,58,1,10.0
6156,30,34,32,66,1,10.0
6157,30,65,71,136,1,10.0
6158,30,127,142,269,1,10.0
6159,30,15,21,36,1,10.0
6160,30,95,81,176,1,10.0
6161,30,113,79,192,1,10.0
6162,30,85,102,187,1,10.0
6163,30,98,81,179,1,10.0
6164,30,95,52,147,1,10.0
6165,30,87,43,130,1,10.0
6166,30,96,81,177,1,10.0
6167,30,98,113,211,1,10.0
6168,30,100,103,203,1,10.0
6169,30,149,166,315,1,10.0
6170,30,79,72,151,1,10.0
6171,30,86,78,164,1,10.0
6172,30,114,84,198,1,10.0
6173,30,42,42,84,1,10.0
6174,30,44,48,92,1,10.0
6175,30,68,94,162,1,10.0
6176,30,21,29,50,1,10.0
6177,30,52,47,99,1,10.0
6178,30,71,69,140,1,10.0
6179,30,74,106,180,1,10.0
6180,30,40,20,60,1,10.0
6181,30,42,35,77,1,10.0
6182,30,32,27,59,1,10.0
6183,30,50,56,106,1,10.0
6184,30,67,44,111,1,10.0
6185,30,24,37,61,1,10.0
6186,30,29,48,77,1,10.0
6187,30,51,43,94,1,10.0
6188,30,95,114,209,1,10.0
6189,30,9,18,27,1,10.0
6190,30,5,1,6,1,10.0
6191,30,52,33,85,1,10.0
6192,30,67,81,148,1,10.0
6193,30,28,38,66,1,10.0
6194,30,102,80,182,1,10.0
6195,30,41,57,98,1,10.0
6196,30,25,28,53,1,10.0
6197,30,95,110,205,1,10.0
6198,30,71,98,169,1,10.0
6199,30,8,17,25,1,10.0
6200,30,45,76,121,1,10.0
6201,30,12,14,26,1,10.0
6202,30,49,57,106,1,10.0
6203,30,82,91,173,1,10.0
6204,30,22,34,56,1,10.0
6205,30,38,37,75,1,10.0
6206,30,23,16,39,1,10.0
6207,30,89,130,219,1,10.0
6208,30,24,25,49,1,10.0
6209,30,10,19,29,1,10.0
6210,30,58,42,100,1,10.0
6211,30,34,31,65,1,10.0
6212,30,16,24,40,1,10.0
6213,30,25,28,53,1,10.0
6214,30,9,15,24,1,10.0
6215,30,55,77,132,1,10.0
6216,30,21,42,63,1,10.0
6217,30,7,4,11,1,10.0
6218,30,20,17,37,1,10.0
6219,30,43,81,124,1,10.0
6220,30,80,92,172,1,10.0
6221,30,29,39,68,1,10.0
6222,30,97,65,162,1,10.0
6223,30,48,44,92,1,10.0
6224,30,44,38,82,1,10.0
6225,30,45,63,108,1,10.0
6226,30,49,62,111,1,10.0
6227,30,1,14,15,1,10.0
6228,30,32,24,56,1,10.0
6229,30,15,14,29,1,10.0
6230,30,2,6,8,1,10.0
6231,50,25,74,99,1,10.0
6232,50,52,99,151,1,10.0
6233,50,36,62,98,1,10.0
6234,50,10,23,33,1,10.0
6235,50,117,269,386,1,10.0
6236,50,81,102,183,1,10.0
6237,50,27,51,78,1,10.0
6238,50,18,32,50,1,10.0
6239,50,72,105,177,1,10.0
6240,50,28,46,74,1,10.0
6241,50,78,131,209,1,10.0
6242,50,77,99,176,1,10.0
6243,50,18,14,32,1,10.0
6244,50,14,19,33,1,10.0
6245,50,40,62,102,1,10.0
6246,50,27,49,76,1,10.0
6247,50,62,83,145,1,10.0
6248,50,53,56,109,1,10.0
6249,50,60,65,125,1,10.0
6250,50,78,94,172,1,10.0
6251,50,89,113,202,1,10.0
6252,50,92,203,295,1,10.0
6253,50,76,76,152,1,10.0
6254,50,23,46,69,1,10.0
6255,50,103,189,292,1,10.0
6256,50,72,129,201,1,10.0
6257,50,32,49,81,1,10.0
6258,50,18,48,66,1,10.0
6259,50,29,73,102,1,10.0
6260,50,35,66,101,1,10.0
6261,50,15,28,43,1,10.0
6262,50,20,41,61,1,10.0
6263,50,14,26,40,1,10.0
6264,50,25,26,51,1,10.0
6265,50,49,32,81,1,10.0
6266,50,69,123,192,1,10.0
6267,50,32,82,114,1,10.0
6268,50,65,124,189,1,10.0
6269,50,73,84,157,1,10.0
6270,50,44,67,111,1,10.0
6271,50,155,270,425,1,10.0
6272,50,48,68,116,1,10.0
6273,50,40,22,62,1,10.0
6274,50,53,103,156,1,10.0
6275,50,43,65,108,1,10.0
6276,50,43,88,131,1,10.0
6277,50,37,78,115,1,10.0
6278,50,108,107,215,1,10.0
6279,50,9,9,18,1,10.0
6280,50,69,113,182,1,10.0
6281,50,95,214,309,1,10.0
6282,50,53,64,117,1,10.0
6283,50,78,127,205,1,10.0
6284,50,34,43,77,1,10.0
6285,50,32,76,108,1,10.0
6286,50,36,38,74,1,10.0
6287,50,41,41,82,1,10.0
6288,50,49,86,135,1,10.0
6289,50,20,35,55,1,10.0
6290,50,62,103,165,1,10.0
6291,50,48,56,104,1,10.0
6292,50,46,114,160,1,10.0
6293,50,22,33,55,1,10.0
6294,50,49,79,128,1,10.0
6295,50,19,37,56,1,10.0
6296,50,35,80,115,1,10.0
6297,50,114,132,246,1,10.0
6298,50,123,126,249,1,10.0
6299,50,77,153,230,1,10.0
6300,50,43,57,100,1,10.0
6301,50,54,111,165,1,10.0
6302,50,33,84,117,1,10.0
6303,50,53,56,109,1,10.0
6304,50,79,59,138,1,10.0
6305,50,34,65,99,1,10.0
6306,50,20,17,37,1,10.0
6307,50,80,63,143,1,10.0
6308,50,27,56,83,1,10.0
6309,50,69,134,203,1,10.0
6310,50,37,40,77,1,10.0
6311,50,85,111,196,1,10.0
6312,50,95,134,229,1,10.0
6313,50,147,198,345,1,10.0
6314,50,83,98,181,1,10.0
6315,50,50,40,90,1,10.0
6316,50,44,58,102,1,10.0
6317,50,15,21,36,1,10.0
6318,50,14,28,42,1,10.0
6319,50,68,71,139,1,10.0
6320,50,50,68,118,1,10.0
6321,50,15,32,47,1,10.0
6322,50,64,73,137,1,10.0
6323,50,49,52,101,1,10.0
6324,50,48,40,88,1,10.0
6325,50,102,140,242,1,10.0
6326,50,60,69,129,1,10.0
6327,50,100,105,205,1,10.0
6328,50,125,117,242,1,10.0
6329,50,55,86,141,1,10.0
6330,50,118,144,262,1,10.0
6331,50,112,164,276,1,10.0
6332,50,11,32,43,1,10.0
6333,50,57,37,94,1,10.0
6334,50,57,69,126,1,10.0
6335,50,24,68,92,1,10.0
6336,50,42,46,88,1,10.0
6337,50,36,48,84,1,10.0
6338,50,47,74,121,1,10.0
6339,50,78,77,155,1,10.0
6340,50,86,39,125,1,10.0
6341,50,89,91,180,1,10.0
6342,50,164,137,301,1,10.0
6343,50,42,120,162,1,10.0
6344,50,85,101,186,1,10.0
6345,50,60,68,128,1,10.0
6346,50,134,105,239,1,10.0
6347,50,111,135,246,1,10.0
6348,50,30,28,58,1,10.0
6349,50,43,86,129,1,10.0
6350,50,58,88,146,1,10.0
6351,50,59,59,118,1,10.0
6352,50,92,112,204,1,10.0
6353,50,19,22,41,1,10.0
6354,50,11,22,33,1,10.0
6355,50,20,37,57,1,10.0
6356,50,22,55,77,1,10.0
6357,50,10,21,31,1,10.0
6358,50,67,83,150,1,10.0
6359,50,86,73,159,1,10.0
6360,50,99,174,273,1,10.0
6361,50,142,157,299,1,10.0
6362,50,69,115,184,1,10.0
6363,50,120,195,315,1,10.0
6364,50,86,152,238,1,10.0
6365,50,43,42,85,1,10.0
6366,50,33,34,67,1,10.0
6367,50,43,65,108,1,10.0
6368,50,78,101,179,1,10.0
6369,50,9,27,36,1,10.0
6370,50,56,71,127,1,10.0
6371,50,9,10,19,1,10.0
6372,50,80,37,117,1,10.0
6373,50,100,141,241,1,10.0
6374,50,77,94,171,1,10.0
6375,50,21,79,100,1,10.0
6376,50,134,265,399,1,10.0
6377,50,7,16,23,1,10.0
6378,50,53,64,117,1,10.0
6379,50,50,72,122,1,10.0
6380,50,45,84,129,1,10.0
6381,50,47,90,137,1,10.0
6382,50,52,67,119,1,10.0
6383,50,31,71,102,1,10.0
6384,50,51,91,142,1,10.0
6385,50,56,67,123,1,10.0
6386,50,16,18,34,1,10.0
6387,50,18,11,29,1,10.0
6388,50,6,19,25,1,10.0
6389,50,7,25,32,1,10.0
6390,50,19,60,79,1,10.0
6391,50,17,30,47,1,10.0
6392,50,46,32,78,1,10.0
6393,50,53,53,106,1,10.0
6394,50,35,50,85,1,10.0
6395,50,149,236,385,1,10.0
6396,50,73,58,131,1,10.0
6397,50,55,81,136,1,10.0
6398,50,67,135,202,1,10.0
6399,50,65,84,149,1,10.0
6400,50,48,76,124,1,10.0
6401,50,29,40,69,1,10.0
6402,50,73,103,176,1,10.0
6403,50,33,58,91,1,10.0
6404,50,72,51,123,1,10.0
6405,50,28,70,98,1,10.0
6406,50,54,95,149,1,10.0
6407,50,82,43,125,1,10.0
6408,50,68,93,161,1,10.0
6409,50,43,70,113,1,10.0
6410,50,59,71,130,1,10.0
6411,50,40,71,111,1,10.0
6412,50,33,57,90,1,10.0
6413,50,84,141,225,1,10.0
6414,50,58,99,157,1,10.0
6415,50,14,36,50,1,10.0
6416,50,72,110,182,1,10.0
6417,50,86,106,192,1,10.0
6418,50,19,50,69,1,10.0
6419,50,47,55,102,1,10.0
6420,50,48,73,121,1,10.0
6421,50,30,58,88,1,10.0
6422,50,52,101,153,1,10.0
6423,50,37,57,94,1,10.0
6424,50,125,120,245,1,10.0
6425,50,63,93,156,1,10.0
6426,50,57,164,221,1,10.0
6427,50,56,88,144,1,10.0
6428,50,38,43,81,1,10.0
6429,50,111,200,311,1,10.0
6430,50,103,200,303,1,10.0
6431,50,98,102,200,1,10.0
6432,50,41,82,123,1,10.0
6433,50,54,64,118,1,10.0
6434,50,29,37,66,1,10.0
6435,50,37,52,89,1,10.0
6436,50,29,23,52,1,10.0
6437,50,70,72,142,1,10.0
6438,50,66,67,133,1,10.0
6439,50,67,42,109,1,10.0
6440,50,69,135,204,1,10.0
6441,50,87,130,217,1,10.0
6442,50,156,118,274,1,10.0
6443,50,37,45,82,1,10.0
6444,50,76,151,227,1,10.0
6445,50,40,74,114,1,10.0
6446,50,72,112,184,1,10.0
6447,50,12,18,30,1,10.0
6448,50,49,129,178,1,10.0
6449,50,30,81,111,1,10.0
6450,50,13,5,18,1,10.0
6451,50,130,146,276,1,10.0
6452,50,168,174,342,1,10.0
6453,50,63,71,134,1,10.0
6454,50,56,51,107,1,10.0
6455,50,92,95,187,1,10.0
6456,50,14,28,42,1,10.0
6457,50,61,120,181,1,10.0
6458,50,54,80,134,1,10.0
6459,50,44,76,120,1,10.0
6460,50,41,54,95,1,10.0
6461,50,16,26,42,1,10.0
6462,50,29,24,53,1,10.0
6463,50,73,81,154,1,10.0
6464,50,32,42,74,1,10.0
6465,50,88,143,231,1,10.0
6466,50,5,23,28,1,10.0
6467,50,46,58,104,1,10.0
6468,50,95,122,217,1,10.0
6469,50,109,131,240,1,10.0
6470,50,36,71,107,1,10.0
6471,50,100,153,253,1,10.0
6472,50,101,106,207,1,10.0
6473,50,49,46,95,1,10.0
6474,50,37,25,62,1,10.0
6475,50,71,22,93,1,10.0
6476,50,74,26,100,1,10.0
6477,50,26,35,61,1,10.0
6478,50,24,34,58,1,10.0
6479,50,34,57,91,1,10.0
6480,50,22,48,70,1,10.0
6481,50,71,50,121,1,10.0
6482,50,63,116,179,1,10.0
6483,50,102,93,195,1,10.0
6484,50,131,182,313,1,10.0
6485,50,42,23,65,1,10.0
6486,50,64,57,121,1,10.0
6487,50,57,74,131,1,10.0
6488,50,47,82,129,1,10.0
6489,50,46,21,67,1,10.0
6490,50,100,137,237,1,10.0
6491,50,33,59,92,1,10.0
6492,50,40,56,96,1,10.0
6493,50,62,170,232,1,10.0
6494,50,34,46,80,1,10.0
6495,50,4,7,11,1,10.0
6496,50,53,50,103,1,10.0
6497,50,34,42,76,1,10.0
6498,50,17,32,49,1,10.0
6499,50,91,121,212,1,10.0
6500,50,97,103,200,1,10.0
6501,50,55,108,163,1,10.0
6502,50,69,190,259,1,10.0
6503,50,46,90,136,1,10.0
6504,50,102,212,314,1,10.0
6505,50,30,87,117,1,10.0
6506,50,87,147,234,1,10.0
6507,50,57,68,125,1,10.0
6508,50,40,50,90,1,10.0
6509,50,9,19,28,1,10.0
6510,50,82,77,159,1,10.0
6511,50,94,105,199,1,10.0
6512,50,83,99,182,1,10.0
6513,50,103,110,213,1,10.0
6514,50,73,134,207,1,10.0
6515,50,95,164,259,1,10.0
6516,50,73,88,161,1,10.0
6517,50,70,57,127,1,10.0
6518,50,95,119,214,1,10.0
6519,50,74,58,132,1,10.0
6520,50,94,99,193,1,10.0
6521,50,3,14,17,1,10.0
6522,50,39,53,92,1,10.0
6523,50,40,48,88,1,10.0
6524,50,33,39,72,1,10.0
6525,50,17,20,37,1,10.0
6526,50,8,5,13,1,10.0
6527,50,97,198,295,1,10.0
6528,50,141,257,398,1,10.0
6529,50,121,130,251,1,10.0
6530,50,128,223,351,1,10.0
6531,50,120,94,214,1,10.0
6532,50,56,44,100,1,10.0
6533,50,67,90,157,1,10.0
6534,50,94,184,278,1,10.0
6535,50,53,83,136,1,10.0
6536,50,63,51,114,1,10.0
6537,50,69,159,228,1,10.0
6538,50,62,40,102,1,10.0
6539,50,21,42,63,1,10.0
6540,50,14,29,43,1,10.0
6541,50,18,13,31,1,10.0
6542,50,35,53,88,1,10.0
6543,50,76,94,170,1,10.0
6544,50,21,38,59,1,10.0
6545,50,102,145,247,1,10.0
6546,50,118,118,236,1,10.0
6547,50,75,119,194,1,10.0
6548,50,74,133,207,1,10.0
6549,50,154,327,481,1,10.0
6550,50,48,165,213,1,10.0
6551,50,102,125,227,1,10.0
6552,50,134,251,385,1,10.0
6553,50,176,196,372,1,10.0
6554,50,29,19,48,1,10.0
6555,50,63,162,225,1,10.0
6556,50,19,40,59,1,10.0
6557,50,4,9,13,1,10.0
6558,50,15,25,40,1,10.0
6559,50,39,52,91,1,10.0
6560,50,35,60,95,1,10.0
6561,50,4,2,6,1,10.0
6562,50,15,14,29,1,10.0
6563,50,89,127,216,1,10.0
6564,50,22,35,57,1,10.0
6565,50,64,78,142,1,10.0
6566,50,96,127,223,1,10.0
6567,50,21,20,41,1,10.0
6568,50,21,64,85,1,10.0
6569,50,44,62,106,1,10.0
6570,50,44,43,87,1,10.0
6571,50,31,87,118,1,10.0
6572,50,16,35,51,1,10.0
6573,50,62,69,131,1,10.0
6574,50,23,47,70,1,10.0
6575,50,67,105,172,1,10.0
6576,50,15,39,54,1,10.0
6577,50,36,62,98,1,10.0
6578,50,73,100,173,1,10.0
6579,50,107,95,202,1,10.0
6580,50,56,100,156,1,10.0
6581,50,73,127,200,1,10.0
6582,50,53,69,122,1,10.0
6583,50,60,143,203,1,10.0
6584,50,7,35,42,1,10.0
6585,50,54,108,162,1,10.0
6586,50,103,145,248,1,10.0
6587,50,34,92,126,1,10.0
6588,50,45,84,129,1,10.0
6589,50,19,23,42,1,10.0
6590,50,35,63,98,1,10.0
6591,50,14,20,34,1,10.0
6592,50,29,66,95,1,10.0
6593,50,33,22,55,1,10.0
6594,50,59,87,146,1,10.0
6595,50,52,120,172,1,10.0
6596,50,31,56,87,1,10.0
6597,50,44,27,71,1,10.0
6598,50,71,126,197,1,10.0
6599,50,113,132,245,1,10.0
6600,50,34,80,114,1,10.0
6601,50,47,57,104,1,10.0
6602,50,25,44,69,1,10.0
6603,50,64,92,156,1,10.0
6604,50,9,9,18,1,10.0
6605,50,38,38,76,1,10.0
6606,50,6,21,27,1,10.0
6607,50,82,94,176,1,10.0
6608,50,86,106,192,1,10.0
6609,50,69,126,195,1,10.0
6610,50,79,119,198,1,10.0
6611,50,64,73,137,1,10.0
6612,50,23,61,84,1,10.0
6613,50,54,88,142,1,10.0
6614,50,84,136,220,1,10.0
6615,50,112,99,211,1,10.0
6616,50,20,40,60,1,10.0
6617,50,46,54,100,1,10.0
6618,50,85,164,249,1,10.0
6619,50,10,3,13,1,10.0
6620,50,26,29,55,1,10.0
6621,50,31,29,60,1,10.0
6622,50,34,58,92,1,10.0
6623,50,47,49,96,1,10.0
6624,50,66,45,111,1,10.0
6625,50,173,193,366,1,10.0
6626,50,69,99,168,1,10.0
6627,50,82,112,194,1,10.0
6628,50,72,139,211,1,10.0
6629,50,75,124,199,1,10.0
6630,50,95,90,185,1,10.0
6631,50,146,188,334,1,10.0
6632,50,61,75,136,1,10.0
6633,50,32,73,105,1,10.0
6634,50,49,71,120,1,10.0
6635,50,34,76,110,1,10.0
6636,50,87,101,188,1,10.0
6637,50,56,37,93,1,10.0
6638,50,124,150,274,1,10.0
6639,50,18,44,62,1,10.0
6640,50,89,160,249,1,10.0
6641,50,53,109,162,1,10.0
6642,50,150,161,311,1,10.0
6643,50,57,90,147,1,10.0
6644,50,18,36,54,1,10.0
6645,50,83,118,201,1,10.0
6646,50,44,82,126,1,10.0
6647,50,18,24,42,1,10.0
6648,50,26,90,116,1,10.0
6649,50,78,134,212,1,10.0
6650,50,83,79,162,1,10.0
6651,50,112,168,280,1,10.0
6652,50,184,319,503,1,10.0
6653,50,22,36,58,1,10.0
6654,50,37,58,95,1,10.0
6655,50,69,88,157,1,10.0
6656,50,36,43,79,1,10.0
6657,50,69,97,166,1,10.0
6658,50,9,23,32,1,10.0
6659,50,42,63,105,1,10.0
6660,50,33,97,130,1,10.0
6661,50,29,57,86,1,10.0
6662,50,68,106,174,1,10.0
6663,50,62,155,217,1,10.0
6664,50,59,125,184,1,10.0
6665,50,162,266,428,1,10.0
6666,50,132,170,302,1,10.0
6667,50,60,101,161,1,10.0
6668,50,76,128,204,1,10.0
6669,50,31,59,90,1,10.0
6670,50,43,58,101,1,10.0
6671,50,33,50,83,1,10.0
6672,50,21,16,37,1,10.0
6673,50,62,65,127,1,10.0
6674,50,7,18,25,1,10.0
6675,50,30,46,76,1,10.0
6676,50,21,58,79,1,10.0
6677,50,72,123,195,1,10.0
6678,50,136,231,367,1,10.0
6679,50,143,194,337,1,10.0
6680,50,75,140,215,1,10.0
6681,50,104,203,307,1,10.0
6682,50,164,202,366,1,10.0
6683,50,183,233,416,1,10.0
6684,50,131,228,359,1,10.0
6685,50,102,100,202,1,10.0
6686,50,72,113,185,1,10.0
6687,50,73,95,168,1,10.0
6688,50,104,82,186,1,10.0
6689,75,110,187,297,1,10.0
6690,75,95,122,217,1,10.0
6691,75,79,125,204,1,10.0
6692,75,72,142,214,1,10.0
6693,75,117,133,250,1,10.0
6694,75,37,61,98,1,10.0
6695,75,51,73,124,1,10.0
6696,75,84,118,202,1,10.0
6697,75,64,106,170,1,10.0
6698,75,48,41,89,1,10.0
6699,75,80,117,197,1,10.0
6700,75,75,164,239,1,10.0
6701,75,36,65,101,1,10.0
6702,75,63,71,134,1,10.0
6703,75,43,89,132,1,10.0
6704,75,65,128,193,1,10.0
6705,75,87,119,206,1,10.0
6706,75,72,142,214,1,10.0
6707,75,36,66,102,1,10.0
6708,75,81,81,162,1,10.0
6709,75,47,92,139,1,10.0
6710,75,64,100,164,1,10.0
6711,75,54,61,115,1,10.0
6712,75,8,20,28,1,10.0
6713,75,8,9,17,1,10.0
6714,75,86,110,196,1,10.0
6715,75,103,72,175,1,10.0
6716,75,158,137,295,1,10.0
6717,75,50,98,148,1,10.0
6718,75,78,111,189,1,10.0
6719,75,72,101,173,1,10.0
6720,75,112,145,257,1,10.0
6721,75,112,116,228,1,10.0
6722,75,128,193,321,1,10.0
6723,75,112,179,291,1,10.0
6724,75,53,85,138,1,10.0
6725,75,82,60,142,1,10.0
6726,75,99,141,240,1,10.0
6727,75,63,111,174,1,10.0
6728,75,43,92,135,1,10.0
6729,75,122,143,265,1,10.0
6730,75,117,112,229,1,10.0
6731,75,54,74,128,1,10.0
6732,75,130,241,371,1,10.0
6733,75,38,51,89,1,10.0
6734,75,47,59,106,1,10.0
6735,75,69,116,185,1,10.0
6736,75,64,103,167,1,10.0
6737,75,43,61,104,1,10.0
6738,75,74,107,181,1,10.0
6739,75,36,50,86,1,10.0
6740,75,32,27,59,1,10.0
6741,75,7,18,25,1,10.0
6742,75,31,66,97,1,10.0
6743,75,31,66,97,1,10.0
6744,75,25,109,134,1,10.0
6745,75,47,75,122,1,10.0
6746,75,124,128,252,1,10.0
6747,75,71,70,141,1,10.0
6748,75,45,91,136,1,10.0
6749,75,80,84,164,1,10.0
6750,75,57,87,144,1,10.0
6751,75,150,129,279,1,10.0
6752,75,98,136,234,1,10.0
6753,75,66,89,155,1,10.0
6754,75,32,49,81,1,10.0
6755,75,23,35,58,1,10.0
6756,75,15,23,38,1,10.0
6757,75,67,101,168,1,10.0
6758,75,105,143,248,1,10.0
6759,75,78,132,210,1,10.0
6760,75,88,128,216,1,10.0
6761,75,211,224,435,1,10.0
6762,75,77,93,170,1,10.0
6763,75,55,89,144,1,10.0
6764,75,110,167,277,1,10.0
6765,75,57,100,157,1,10.0
6766,75,123,127,250,1,10.0
6767,75,177,210,387,1,10.0
6768,75,57,93,150,1,10.0
6769,75,57,132,189,1,10.0
6770,75,33,93,126,1,10.0
6771,75,85,140,225,1,10.0
6772,75,22,45,67,1,10.0
6773,75,89,280,369,1,10.0
6774,75,82,140,222,1,10.0
6775,75,59,96,155,1,10.0
6776,75,134,169,303,1,10.0
6777,75,56,102,158,1,10.0
6778,75,60,99,159,1,10.0
6779,75,75,241,316,1,10.0
6780,75,64,77,141,1,10.0
6781,75,93,192,285,1,10.0
6782,75,18,38,56,1,10.0
6783,75,46,86,132,1,10.0
6784,75,21,31,52,1,10.0
6785,75,27,59,86,1,10.0
6786,75,1,3,4,1,10.0
6787,75,28,49,77,1,10.0
6788,75,154,333,487,1,10.0
6789,75,100,238,338,1,10.0
6790,75,145,434,579,1,10.0
6791,75,63,192,255,1,10.0
6792,75,34,72,106,1,10.0
6793,75,35,102,137,1,10.0
6794,75,4,23,27,1,10.0
6795,75,54,170,224,1,10.0
6796,75,27,165,192,1,10.0
6797,75,13,33,46,1,10.0
6798,75,29,57,86,1,10.0
6799,75,13,25,38,1,10.0
6800,75,19,71,90,1,10.0
6801,75,113,181,294,1,10.0
6802,75,21,26,47,1,10.0
6803,75,47,172,219,1,10.0
6804,75,109,244,353,1,10.0
6805,75,80,148,228,1,10.0
6806,75,61,95,156,1,10.0
6807,75,60,134,194,1,10.0
6808,75,9,35,44,1,10.0
6809,75,29,96,125,1,10.0
6810,75,86,110,196,1,10.0
6811,75,67,126,193,1,10.0
6812,75,23,55,78,1,10.0
6813,75,10,50,60,1,10.0
6814,75,26,22,48,1,10.0
6815,75,100,107,207,1,10.0
6816,75,100,170,270,1,10.0
6817,75,91,132,223,1,10.0
6818,75,42,57,99,1,10.0
6819,75,16,19,35,1,10.0
6820,75,55,66,121,1,10.0
6821,75,47,129,176,1,10.0
6822,75,15,22,37,1,10.0
6823,75,7,15,22,1,10.0
6824,75,7,21,28,1,10.0
6825,75,8,12,20,1,10.0
6826,75,96,201,297,1,10.0
6827,75,66,117,183,1,10.0
6828,75,109,184,293,1,10.0
6829,75,47,90,137,1,10.0
6830,75,39,100,139,1,10.0
6831,75,65,128,193,1,10.0
6832,75,67,106,173,1,10.0
6833,75,80,143,223,1,10.0
6834,75,27,41,68,1,10.0
6835,75,43,49,92,1,10.0
6836,75,43,64,107,1,10.0
6837,75,24,54,78,1,10.0
6838,75,50,60,110,1,10.0
6839,75,30,39,69,1,10.0
6840,75,28,34,62,1,10.0
6841,75,13,39,52,1,10.0
6842,75,41,25,66,1,10.0
6843,75,6,15,21,1,10.0
6844,75,66,146,212,1,10.0
6845,75,48,99,147,1,10.0
6846,75,21,20,41,1,10.0
6847,75,105,326,431,1,10.0
6848,75,23,13,36,1,10.0
6849,75,132,215,347,1,10.0
6850,75,53,94,147,1,10.0
6851,75,104,172,276,1,10.0
6852,75,87,164,251,1,10.0
6853,75,76,88,164,1,10.0
6854,75,41,110,151,1,10.0
6855,75,86,127,213,1,10.0
6856,75,80,179,259,1,10.0
6857,75,51,59,110,1,10.0
6858,75,44,90,134,1,10.0
6859,75,68,101,169,1,10.0
6860,75,99,158,257,1,10.0
6861,75,34,120,154,1,10.0
6862,75,60,58,118,1,10.0
6863,75,98,210,308,1,10.0
6864,75,25,39,64,1,10.0
6865,75,161,272,433,1,10.0
6866,75,116,211,327,1,10.0
6867,75,41,51,92,1,10.0
6868,75,5,20,25,1,10.0
6869,75,62,170,232,1,10.0
6870,75,20,42,62,1,10.0
6871,75,90,179,269,1,10.0
6872,75,50,74,124,1,10.0
6873,75,129,267,396,1,10.0
6874,75,79,150,229,1,10.0
6875,75,95,95,190,1,10.0
6876,75,95,130,225,1,10.0
6877,75,62,90,152,1,10.0
6878,75,49,120,169,1,10.0
6879,75,44,105,149,1,10.0
6880,75,124,99,223,1,10.0
6881,75,117,251,368,1,10.0
6882,75,23,38,61,1,10.0
6883,75,75,98,173,1,10.0
6884,75,46,69,115,1,10.0
6885,75,46,134,180,1,10.0
6886,75,225,173,398,1,10.0
6887,75,131,183,314,1,10.0
6888,75,90,78,168,1,10.0
6889,75,104,204,308,1,10.0
6890,75,69,108,177,1,10.0
6891,75,52,69,121,1,10.0
6892,75,91,181,272,1,10.0
6893,75,94,174,268,1,10.0
6894,75,51,95,146,1,10.0
6895,75,63,101,164,1,10.0
6896,75,43,89,132,1,10.0
6897,75,115,12,127,1,10.0
6898,75,52,96,148,1,10.0
6899,75,116,54,170,1,10.0
6900,75,44,89,133,1,10.0
6901,75,35,77,112,1,10.0
6902,75,45,92,137,1,10.0
6903,75,10,14,24,1,10.0
6904,75,132,199,331,1,10.0
6905,75,111,166,277,1,10.0
6906,75,121,138,259,1,10.0
6907,75,112,128,240,1,10.0
6908,75,13,28,41,1,10.0
6909,75,100,131,231,1,10.0
6910,75,27,57,84,1,10.0
6911,75,34,84,118,1,10.0
6912,75,110,154,264,1,10.0
6913,75,31,32,63,1,10.0
6914,75,112,178,290,1,10.0
6915,75,100,98,198,1,10.0
6916,75,14,58,72,1,10.0
6917,75,12,5,17,1,10.0
6918,75,10,22,32,1,10.0
6919,75,57,43,100,1,10.0
6920,75,59,82,141,1,10.0
6921,75,111,71,182,1,10.0
6922,75,47,105,152,1,10.0
6923,75,98,96,194,1,10.0
6924,75,73,93,166,1,10.0
6925,75,42,67,109,1,10.0
6926,75,110,206,316,1,10.0
6927,75,88,72,160,1,10.0
6928,75,45,40,85,1,10.0
6929,75,114,175,289,1,10.0
6930,75,155,244,399,1,10.0
6931,75,51,18,69,1,10.0
6932,75,106,158,264,1,10.0
6933,75,56,127,183,1,10.0
6934,75,22,32,54,1,10.0
6935,75,22,33,55,1,10.0
6936,75,171,183,354,1,10.0
6937,75,110,140,250,1,10.0
6938,75,90,201,291,1,10.0
6939,75,64,105,169,1,10.0
6940,75,121,92,213,1,10.0
6941,75,40,63,103,1,10.0
6942,75,195,217,412,1,10.0
6943,75,64,106,170,1,10.0
6944,75,28,34,62,1,10.0
6945,75,137,86,223,1,10.0
6946,75,80,94,174,1,10.0
6947,75,27,56,83,1,10.0
6948,75,66,73,139,1,10.0
6949,75,100,145,245,1,10.0
6950,75,120,164,284,1,10.0
6951,75,74,94,168,1,10.0
6952,75,98,109,207,1,10.0
6953,75,138,183,321,1,10.0
6954,75,36,87,123,1,10.0
6955,75,98,174,272,1,10.0
6956,75,109,187,296,1,10.0
6957,75,71,130,201,1,10.0
6958,75,65,83,148,1,10.0
6959,75,22,47,69,1,10.0
6960,75,47,51,98,1,10.0
6961,75,2,11,13,1,10.0
6962,75,48,94,142,1,10.0
6963,75,128,182,310,1,10.0
6964,75,76,132,208,1,10.0
6965,75,144,172,316,1,10.0
6966,75,52,58,110,1,10.0
6967,75,45,75,120,1,10.0
6968,75,150,243,393,1,10.0
6969,75,47,68,115,1,10.0
6970,75,19,81,100,1,10.0
6971,75,114,286,400,1,10.0
6972,75,84,144,228,1,10.0
6973,75,39,83,122,1,10.0
6974,75,47,45,92,1,10.0
6975,75,62,116,178,1,10.0
6976,75,10,36,46,1,10.0
6977,75,43,122,165,1,10.0
6978,75,124,250,374,1,10.0
6979,75,72,160,232,1,10.0
6980,75,35,40,75,1,10.0
6981,75,49,62,111,1,10.0
6982,75,51,82,133,1,10.0
6983,75,22,44,66,1,10.0
6984,75,47,83,130,1,10.0
6985,75,31,61,92,1,10.0
6986,75,32,40,72,1,10.0
6987,75,45,49,94,1,10.0
6988,75,49,54,103,1,10.0
6989,75,164,255,419,1,10.0
6990,75,202,222,424,1,10.0
6991,75,23,49,72,1,10.0
6992,75,116,229,345,1,10.0
6993,75,66,151,217,1,10.0
6994,75,35,77,112,1,10.0
6995,75,73,110,183,1,10.0
6996,75,44,105,149,1,10.0
6997,75,93,76,169,1,10.0
6998,75,53,84,137,1,10.0
6999,75,34,87,121,1,10.0
7000,75,67,53,120,1,10.0
7001,75,113,101,214,1,10.0
7002,75,120,149,269,1,10.0
7003,75,119,203,322,1,10.0
7004,75,76,180,256,1,10.0
7005,75,136,103,239,1,10.0
7006,75,50,101,151,1,10.0
7007,75,83,194,277,1,10.0
7008,75,45,59,104,1,10.0
7009,75,70,73,143,1,10.0
7010,75,56,51,107,1,10.0
7011,75,67,156,223,1,10.0
7012,75,30,87,117,1,10.0
7013,75,72,88,160,1,10.0
7014,75,64,67,131,1,10.0
7015,75,21,50,71,1,10.0
7016,75,18,40,58,1,10.0
7017,75,65,87,152,1,10.0
7018,75,50,157,207,1,10.0
7019,75,85,170,255,1,10.0
7020,75,17,45,62,1,10.0
7021,75,47,126,173,1,10.0
7022,75,58,34,92,1,10.0
7023,75,70,137,207,1,10.0
7024,75,66,158,224,1,10.0
7025,75,46,115,161,1,10.0
7026,75,37,150,187,1,10.0
7027,75,39,38,77,1,10.0
7028,75,27,66,93,1,10.0
7029,75,29,75,104,1,10.0
7030,75,54,69,123,1,10.0
7031,75,39,74,113,1,10.0
7032,75,84,149,233,1,10.0
7033,75,122,155,277,1,10.0
7034,75,144,227,371,1,10.0
7035,75,120,341,461,1,10.0
7036,75,71,120,191,1,10.0
7037,75,64,113,177,1,10.0
7038,75,63,127,190,1,10.0
7039,75,82,111,193,1,10.0
7040,75,49,77,126,1,10.0
7041,75,64,118,182,1,10.0
7042,75,97,197,294,1,10.0
7043,75,155,233,388,1,10.0
7044,75,122,122,244,1,10.0
7045,75,76,158,234,1,10.0
7046,75,99,130,229,1,10.0
7047,75,74,168,242,1,10.0
7048,75,82,162,244,1,10.0
7049,75,97,79,176,1,10.0
7050,75,58,104,162,1,10.0
7051,75,19,56,75,1,10.0
7052,75,69,162,231,1,10.0
7053,75,71,156,227,1,10.0
7054,75,5,11,16,1,10.0
7055,75,35,29,64,1,10.0
7056,75,99,224,323,1,10.0
7057,75,141,230,371,1,10.0
7058,75,152,164,316,1,10.0
7059,75,46,72,118,1,10.0
7060,75,252,353,605,1,10.0
7061,75,57,115,172,1,10.0
7062,75,72,127,199,1,10.0
7063,75,10,54,64,1,10.0
7064,75,20,46,66,1,10.0
7065,75,52,77,129,1,10.0
7066,75,73,166,239,1,10.0
7067,75,53,50,103,1,10.0
7068,75,42,71,113,1,10.0
7069,75,11,8,19,1,10.0
7070,75,92,134,226,1,10.0
7071,75,122,165,287,1,10.0
7072,75,118,179,297,1,10.0
7073,75,62,58,120,1,10.0
7074,75,152,205,357,1,10.0
7075,75,96,162,258,1,10.0
7076,75,72,103,175,1,10.0
7077,75,60,68,128,1,10.0
7078,75,115,194,309,1,10.0
7079,75,72,69,141,1,10.0
7080,75,7,32,39,1,10.0
7081,75,29,46,75,1,10.0
7082,75,53,100,153,1,10.0
7083,75,18,54,72,1,10.0
7084,75,66,63,129,1,10.0
7085,75,63,80,143,1,10.0
7086,75,39,69,108,1,10.0
7087,75,23,46,69,1,10.0
7088,75,72,156,228,1,10.0
7089,75,102,137,239,1,10.0
7090,75,29,66,95,1,10.0
7091,75,103,145,248,1,10.0
7092,75,80,150,230,1,10.0
7093,75,172,205,377,1,10.0
7094,75,87,90,177,1,10.0
7095,75,58,32,90,1,10.0
7096,75,19,53,72,1,10.0
7097,75,60,82,142,1,10.0
7098,75,42,48,90,1,10.0
7099,75,21,40,61,1,10.0
7100,75,37,29,66,1,10.0
7101,75,57,67,124,1,10.0
7102,75,70,96,166,1,10.0
7103,75,30,40,70,1,10.0
7104,75,49,77,126,1,10.0
7105,75,51,64,115,1,10.0
7106,75,97,128,225,1,10.0
7107,75,147,195,342,1,10.0
7108,75,21,44,65,1,10.0
7109,75,102,111,213,1,10.0
7110,75,46,45,91,1,10.0
7111,75,45,58,103,1,10.0
7112,75,79,112,191,1,10.0
7113,75,83,134,217,1,10.0
7114,75,28,35,63,1,10.0
7115,75,21,22,43,1,10.0
7116,75,31,58,89,1,10.0
7117,75,1,6,7,1,10.0
7118,75,33,63,96,1,10.0
7119,90,104,136,240,1,10.0
7120,90,63,40,103,1,10.0
7121,90,98,143,241,1,10.0
7122,90,58,98,156,1,10.0
7123,90,66,98,164,1,10.0
7124,90,76,156,232,1,10.0
7125,90,173,197,370,1,10.0
7126,90,94,161,255,1,10.0
7127,90,80,72,152,1,10.0
7128,90,41,67,108,1,10.0
7129,90,22,44,66,1,10.0
7130,90,16,35,51,1,10.0
7131,90,125,268,393,1,10.0
7132,90,89,100,189,1,10.0
7133,90,28,61,89,1,10.0
7134,90,115,162,277,1,10.0
7135,90,77,137,214,1,10.0
7136,90,31,68,99,1,10.0
7137,90,117,62,179,1,10.0
7138,90,72,111,183,1,10.0
7139,90,78,103,181,1,10.0
7140,90,102,157,259,1,10.0
7141,90,51,110,161,1,10.0
7142,90,80,150,230,1,10.0
7143,90,107,152,259,1,10.0
7144,90,72,114,186,1,10.0
7145,90,95,114,209,1,10.0
7146,90,121,211,332,1,10.0
7147,90,49,92,141,1,10.0
7148,90,65,102,167,1,10.0
7149,90,88,111,199,1,10.0
7150,90,35,51,86,1,10.0
7151,90,103,214,317,1,10.0
7152,90,27,82,109,1,10.0
7153,90,35,75,110,1,10.0
7154,90,69,90,159,1,10.0
7155,90,20,31,51,1,10.0
7156,90,62,74,136,1,10.0
7157,90,43,57,100,1,10.0
7158,90,115,157,272,1,10.0
7159,90,66,94,160,1,10.0
7160,90,146,213,359,1,10.0
7161,90,17,29,46,1,10.0
7162,90,61,91,152,1,10.0
7163,90,43,48,91,1,10.0
7164,90,26,54,80,1,10.0
7165,90,71,76,147,1,10.0
7166,90,35,36,71,1,10.0
7167,90,34,52,86,1,10.0
7168,90,33,37,70,1,10.0
7169,90,3,9,12,1,10.0
7170,90,13,20,33,1,10.0
7171,90,85,77,162,1,10.0
7172,90,68,103,171,1,10.0
7173,90,14,32,46,1,10.0
7174,90,125,190,315,1,10.0
7175,90,139,314,453,1,10.0
7176,90,64,80,144,1,10.0
7177,90,55,55,110,1,10.0
7178,90,68,104,172,1,10.0
7179,90,31,68,99,1,10.0
7180,90,53,86,139,1,10.0
7181,90,69,98,167,1,10.0
7182,90,56,116,172,1,10.0
7183,90,63,78,141,1,10.0
7184,90,94,139,233,1,10.0
7185,90,32,63,95,1,10.0
7186,90,27,58,85,1,10.0
7187,90,110,124,234,1,10.0
7188,90,48,95,143,1,10.0
7189,90,53,73,126,1,10.0
7190,90,166,219,385,1,10.0
7191,90,102,157,259,1,10.0
7192,90,52,92,144,1,10.0
7193,90,67,127,194,1,10.0
7194,90,63,100,163,1,10.0
7195,90,39,69,108,1,10.0
7196,90,45,53,98,1,10.0
7197,90,60,125,185,1,10.0
7198,90,46,95,141,1,10.0
7199,90,98,152,250,1,10.0
7200,90,94,162,256,1,10.0
7201,90,15,28,43,1,10.0
7202,90,49,78,127,1,10.0
7203,90,35,47,82,1,10.0
7204,90,12,7,19,1,10.0
7205,90,91,160,251,1,10.0
7206,90,101,213,314,1,10.0
7207,90,113,286,399,1,10.0
7208,90,12,39,51,1,10.0
7209,90,75,160,235,1,10.0
7210,90,67,89,156,1,10.0
7211,90,149,269,418,1,10.0
7212,90,49,137,186,1,10.0
7213,90,69,122,191,1,10.0
7214,90,28,51,79,1,10.0
7215,90,50,58,108,1,10.0
7216,90,72,90,162,1,10.0
7217,90,35,59,94,1,10.0
7218,90,4,10,14,1,10.0
7219,90,76,54,130,1,10.0
7220,90,101,321,422,1,10.0
7221,90,44,77,121,1,10.0
7222,90,94,259,353,1,10.0
7223,90,38,38,76,1,10.0
7224,90,92,146,238,1,10.0
7225,90,11,20,31,1,10.0
7226,90,47,103,150,1,10.0
7227,90,72,86,158,1,10.0
7228,90,49,103,152,1,10.0
7229,90,41,75,116,1,10.0
7230,90,31,66,97,1,10.0
7231,90,22,32,54,1,10.0
7232,90,72,106,178,1,10.0
7233,90,33,72,105,1,10.0
7234,90,14,28,42,1,10.0
7235,90,80,153,233,1,10.0
7236,90,50,70,120,1,10.0
7237,90,89,147,236,1,10.0
7238,90,67,162,229,1,10.0
7239,90,138,109,247,1,10.0
7240,90,110,128,238,1,10.0
7241,90,141,296,437,1,10.0
7242,90,43,51,94,1,10.0
7243,90,60,99,159,1,10.0
7244,90,28,64,92,1,10.0
7245,90,53,80,133,1,10.0
7246,90,47,42,89,1,10.0
7247,90,4,12,16,1,10.0
7248,90,74,108,182,1,10.0
7249,90,35,61,96,1,10.0
7250,90,52,75,127,1,10.0
7251,90,54,95,149,1,10.0
7252,90,66,130,196,1,10.0
7253,90,43,84,127,1,10.0
7254,90,34,70,104,1,10.0
7255,90,53,74,127,1,10.0
7256,90,136,177,313,1,10.0
7257,90,74,101,175,1,10.0
7258,90,36,63,99,1,10.0
7259,90,27,55,82,1,10.0
7260,90,7,37,44,1,10.0
7261,90,43,97,140,1,10.0
7262,90,36,95,131,1,10.0
7263,90,29,102,131,1,10.0
7264,90,60,86,146,1,10.0
7265,90,69,79,148,1,10.0
7266,90,43,47,90,1,10.0
7267,90,84,86,170,1,10.0
7268,90,74,117,191,1,10.0
7269,90,72,125,197,1,10.0
7270,90,33,60,93,1,10.0
7271,90,49,36,85,1,10.0
7272,90,31,57,88,1,10.0
7273,90,18,19,37,1,10.0
7274,90,57,100,157,1,10.0
7275,90,43,56,99,1,10.0
7276,90,40,56,96,1,10.0
7277,90,26,77,103,1,10.0
7278,90,23,56,79,1,10.0
7279,90,163,359,522,1,10.0
7280,90,99,244,343,1,10.0
7281,90,56,115,171,1,10.0
7282,90,119,202,321,1,10.0
7283,90,19,33,52,1,10.0
7284,90,72,120,192,1,10.0
7285,90,63,136,199,1,10.0
7286,90,61,86,147,1,10.0
7287,90,34,102,136,1,10.0
7288,90,5,4,9,1,10.0
7289,90,10,27,37,1,10.0
7290,90,37,103,140,1,10.0
7291,90,61,138,199,1,10.0
7292,90,51,79,130,1,10.0
7293,90,52,80,132,1,10.0
7294,90,111,150,261,1,10.0
7295,90,63,151,214,1,10.0
7296,90,113,181,294,1,10.0
7297,90,93,90,183,1,10.0
7298,90,10,5,15,1,10.0
7299,90,34,51,85,1,10.0
7300,90,48,65,113,1,10.0
7301,90,29,73,102,1,10.0
7302,90,50,61,111,1,10.0
7303,90,37,40,77,1,10.0
7304,90,48,54,102,1,10.0
7305,90,75,147,222,1,10.0
7306,90,86,125,211,1,10.0
7307,90,32,20,52,1,10.0
7308,90,89,22,111,1,10.0
7309,90,139,242,381,1,10.0
7310,90,181,197,378,1,10.0
7311,90,198,49,247,1,10.0
7312,90,135,178,313,1,10.0
7313,90,91,128,219,1,10.0
7314,90,64,116,180,1,10.0
7315,90,18,50,68,1,10.0
7316,90,17,49,66,1,10.0
7317,90,69,99,168,1,10.0
7318,90,103,158,261,1,10.0
7319,90,89,70,159,1,10.0
7320,90,169,248,417,1,10.0
7321,90,81,71,152,1,10.0
7322,90,96,132,228,1,10.0
7323,90,25,12,37,1,10.0
7324,90,89,187,276,1,10.0
7325,90,20,66,86,1,10.0
7326,90,53,118,171,1,10.0
7327,90,75,107,182,1,10.0
7328,90,40,73,113,1,10.0
7329,90,66,134,200,1,10.0
7330,90,90,132,222,1,10.0
7331,90,38,84,122,1,10.0
7332,90,71,171,242,1,10.0
7333,90,62,45,107,1,10.0
7334,90,85,129,214,1,10.0
7335,90,73,104,177,1,10.0
7336,90,21,42,63,1,10.0
7337,90,46,81,127,1,10.0
7338,90,39,31,70,1,10.0
7339,90,63,76,139,1,10.0
7340,90,75,118,193,1,10.0
7341,90,87,148,235,1,10.0
7342,90,62,114,176,1,10.0
7343,90,65,90,155,1,10.0
7344,90,58,135,193,1,10.0
7345,90,90,136,226,1,10.0
7346,90,10,9,19,1,10.0
7347,90,54,70,124,1,10.0
7348,90,37,37,74,1,10.0
7349,90,39,55,94,1,10.0
7350,90,26,14,40,1,10.0
7351,90,55,45,100,1,10.0
7352,90,134,57,191,1,10.0
7353,90,63,62,125,1,10.0
7354,90,142,221,363,1,10.0
7355,90,90,188,278,1,10.0
7356,90,101,161,262,1,10.0
7357,90,108,144,252,1,10.0
7358,90,104,123,227,1,10.0
7359,90,62,139,201,1,10.0
7360,90,88,114,202,1,10.0
7361,90,51,62,113,1,10.0
7362,90,58,83,141,1,10.0
7363,90,77,115,192,1,10.0
7364,90,59,57,116,1,10.0
7365,90,88,181,269,1,10.0
7366,90,21,15,36,1,10.0
7367,90,30,25,55,1,10.0
7368,90,153,207,360,1,10.0
7369,90,72,186,258,1,10.0
7370,90,99,139,238,1,10.0
7371,90,80,114,194,1,10.0
7372,90,69,65,134,1,10.0
7373,90,51,63,114,1,10.0
7374,90,68,92,160,1,10.0
7375,90,30,43,73,1,10.0
7376,90,55,67,122,1,10.0
7377,90,20,13,33,1,10.0
7378,90,29,51,80,1,10.0
7379,90,63,99,162,1,10.0
7380,90,55,80,135,1,10.0
7381,90,36,81,117,1,10.0
7382,90,77,119,196,1,10.0
7383,90,114,212,326,1,10.0
7384,90,61,116,177,1,10.0
7385,90,111,148,259,1,10.0
7386,90,66,101,167,1,10.0
7387,90,101,101,202,1,10.0
7388,90,105,159,264,1,10.0
7389,90,32,10,42,1,10.0
7390,90,98,125,223,1,10.0
7391,90,30,84,114,1,10.0
7392,90,45,45,90,1,10.0
7393,90,132,189,321,1,10.0
7394,90,45,84,129,1,10.0
7395,90,142,164,306,1,10.0
7396,90,161,238,399,1,10.0
7397,90,56,111,167,1,10.0
7398,90,95,139,234,1,10.0
7399,90,44,55,99,1,10.0
7400,90,76,100,176,1,10.0
7401,90,60,87,147,1,10.0
7402,90,104,125,229,1,10.0
7403,90,70,168,238,1,10.0
7404,90,49,80,129,1,10.0
7405,90,10,30,40,1,10.0
7406,90,34,66,100,1,10.0
7407,90,58,126,184,1,10.0
7408,90,267,320,587,1,10.0
7409,90,54,87,141,1,10.0
7410,90,116,165,281,1,10.0
7411,90,49,57,106,1,10.0
7412,90,49,92,141,1,10.0
7413,90,47,52,99,1,10.0
7414,90,89,131,220,1,10.0
7415,90,20,21,41,1,10.0
7416,90,83,84,167,1,10.0
7417,90,27,60,87,1,10.0
7418,90,66,48,114,1,10.0
7419,90,26,67,93,1,10.0
7420,90,34,57,91,1,10.0
7421,90,120,73,193,1,10.0
7422,90,116,182,298,1,10.0
7423,90,72,78,150,1,10.0
7424,90,151,124,275,1,10.0
7425,90,103,96,199,1,10.0
7426,90,118,262,380,1,10.0
7427,90,106,132,238,1,10.0
7428,90,155,229,384,1,10.0
7429,90,39,60,99,1,10.0
7430,90,140,188,328,1,10.0
7431,90,97,110,207,1,10.0
7432,90,46,57,103,1,10.0
7433,90,4,24,28,1,10.0
7434,90,9,7,16,1,10.0
7435,90,10,27,37,1,10.0
7436,90,79,91,170,1,10.0
7437,90,81,121,202,1,10.0
7438,90,23,23,46,1,10.0
7439,90,77,134,211,1,10.0
7440,90,37,77,114,1,10.0
7441,90,79,111,190,1,10.0
7442,90,16,22,38,1,10.0
7443,90,140,176,316,1,10.0
7444,90,40,81,121,1,10.0
7445,90,46,105,151,1,10.0
7446,90,88,120,208,1,10.0
7447,90,20,34,54,1,10.0
7448,90,38,43,81,1,10.0
7449,90,109,206,315,1,10.0
7450,90,16,25,41,1,10.0
7451,90,46,98,144,1,10.0
7452,90,38,47,85,1,10.0
7453,90,78,124,202,1,10.0
7454,90,68,111,179,1,10.0
7455,90,70,68,138,1,10.0
7456,90,88,58,146,1,10.0
7457,90,57,109,166,1,10.0
7458,90,61,105,166,1,10.0
7459,90,61,66,127,1,10.0
7460,90,120,133,253,1,10.0
7461,90,98,127,225,1,10.0
7462,90,94,187,281,1,10.0
7463,90,13,26,39,1,10.0
7464,90,14,48,62,1,10.0
7465,90,35,61,96,1,10.0
7466,90,130,184,314,1,10.0
7467,90,78,139,217,1,10.0
7468,90,126,159,285,1,10.0
7469,90,65,102,167,1,10.0
7470,90,103,199,302,1,10.0
7471,90,61,58,119,1,10.0
7472,90,52,116,168,1,10.0
7473,90,72,188,260,1,10.0
7474,90,26,58,84,1,10.0
7475,90,32,43,75,1,10.0
7476,90,103,153,256,1,10.0
7477,90,82,99,181,1,10.0
7478,90,61,81,142,1,10.0
7479,90,87,94,181,1,10.0
7480,90,33,59,92,1,10.0
7481,90,6,8,14,1,10.0
7482,90,97,218,315,1,10.0
7483,90,70,86,156,1,10.0
7484,90,147,225,372,1,10.0
7485,90,179,256,435,1,10.0
7486,90,113,161,274,1,10.0
7487,90,111,147,258,1,10.0
7488,90,88,126,214,1,10.0
7489,90,9,109,118,1,10.0
7490,90,37,97,134,1,10.0
7491,90,53,63,116,1,10.0
7492,90,60,88,148,1,10.0
7493,90,20,30,50,1,10.0
7494,90,9,9,18,1,10.0
7495,90,49,118,167,1,10.0
7496,90,36,135,171,1,10.0
7497,90,115,111,226,1,10.0
7498,90,121,138,259,1,10.0
7499,90,156,178,334,1,10.0
7500,90,33,22,55,1,10.0
7501,90,42,122,164,1,10.0
7502,90,66,115,181,1,10.0
7503,90,61,116,177,1,10.0
7504,90,32,92,124,1,10.0
7505,90,32,72,104,1,10.0
7506,90,63,143,206,1,10.0
7507,90,59,111,170,1,10.0
7508,90,74,92,166,1,10.0
7509,90,63,207,270,1,10.0
7510,90,57,111,168,1,10.0
7511,90,118,187,305,1,10.0
7512,90,84,170,254,1,10.0
7513,90,86,115,201,1,10.0
7514,90,33,107,140,1,10.0
7515,90,56,111,167,1,10.0
7516,90,111,191,302,1,10.0
7517,90,67,114,181,1,10.0
7518,90,37,95,132,1,10.0
7519,90,49,54,103,1,10.0
7520,90,60,81,141,1,10.0
7521,90,32,81,113,1,10.0
7522,90,27,49,76,1,10.0
7523,90,29,62,91,1,10.0
7524,90,14,35,49,1,10.0
7525,90,121,197,318,1,10.0
7526,90,28,67,95,1,10.0
7527,90,109,151,260,1,10.0
7528,90,110,131,241,1,10.0
7529,90,89,218,307,1,10.0
7530,90,20,49,69,1,10.0
7531,90,85,109,194,1,10.0
7532,90,67,176,243,1,10.0
7533,90,15,71,86,1,10.0
7534,90,105,159,264,1,10.0
7535,90,156,196,352,1,10.0
7536,90,20,50,70,1,10.0
7537,90,30,82,112,1,10.0
7538,90,8,42,50,1,10.0
7539,90,21,21,42,1,10.0
7540,90,37,75,112,1,10.0
7541,90,104,204,308,1,10.0
7542,90,30,88,118,1,10.0
7543,90,48,76,124,1,10.0
7544,90,42,107,149,1,10.0
7545,90,91,183,274,1,10.0
7546,90,112,158,270,1,10.0
7547,90,150,66,216,1,10.0
7548,90,72,96,168,1,10.0
7549,90,36,72,108,1,10.0
7550,90,50,100,150,1,10.0
7551,90,54,55,109,1,10.0
7552,120,27,39,66,1,10.0
7553,120,108,157,265,1,10.0
7554,120,146,185,331,1,10.0
7555,120,88,103,191,1,10.0
7556,120,91,166,257,1,10.0
7557,120,122,122,244,1,10.0
7558,120,10,9,19,1,10.0
7559,120,72,52,124,1,10.0
7560,120,72,70,142,1,10.0
7561,120,108,101,209,1,10.0
7562,120,86,59,145,1,10.0
7563,120,18,29,47,1,10.0
7564,120,78,79,157,1,10.0
7565,120,70,101,171,1,10.0
7566,120,25,16,41,1,10.0
7567,120,4,19,23,1,10.0
7568,120,83,97,180,1,10.0
7569,120,5,23,28,1,10.0
7570,120,25,57,82,1,10.0
7571,120,79,184,263,1,10.0
7572,120,15,23,38,1,10.0
7573,120,157,332,489,1,10.0
7574,120,61,92,153,1,10.0
7575,120,29,41,70,1,10.0
7576,120,105,129,234,1,10.0
7577,120,50,79,129,1,10.0
7578,120,43,83,126,1,10.0
7579,120,41,77,118,1,10.0
7580,120,14,41,55,1,10.0
7581,120,16,39,55,1,10.0
7582,120,7,17,24,1,10.0
7583,120,33,86,119,1,10.0
7584,120,88,134,222,1,10.0
7585,120,86,165,251,1,10.0
7586,120,85,157,242,1,10.0
7587,120,60,121,181,1,10.0
7588,120,48,47,95,1,10.0
7589,120,73,129,202,1,10.0
7590,120,25,52,77,1,10.0
7591,120,45,131,176,1,10.0
7592,120,58,68,126,1,10.0
7593,120,54,94,148,1,10.0
7594,120,70,35,105,1,10.0
7595,120,60,71,131,1,10.0
7596,120,82,151,233,1,10.0
7597,120,71,104,175,1,10.0
7598,120,93,151,244,1,10.0
7599,120,75,174,249,1,10.0
7600,120,47,83,130,1,10.0
7601,120,110,204,314,1,10.0
7602,120,43,66,109,1,10.0
7603,120,33,39,72,1,10.0
7604,120,64,65,129,1,10.0
7605,120,6,17,23,1,10.0
7606,120,38,39,77,1,10.0
7607,120,56,99,155,1,10.0
7608,120,105,48,153,1,10.0
7609,120,8,7,15,1,10.0
7610,120,42,111,153,1,10.0
7611,120,30,35,65,1,10.0
7612,120,161,376,537,1,10.0
7613,120,26,53,79,1,10.0
7614,120,53,51,104,1,10.0
7615,120,60,122,182,1,10.0
7616,120,52,70,122,1,10.0
7617,120,46,64,110,1,10.0
7618,120,53,68,121,1,10.0
7619,120,91,120,211,1,10.0
7620,120,59,104,163,1,10.0
7621,120,40,77,117,1,10.0
7622,120,29,72,101,1,10.0
7623,120,16,32,48,1,10.0
7624,120,6,9,15,1,10.0
7625,120,20,40,60,1,10.0
7626,120,35,41,76,1,10.0
7627,120,53,34,87,1,10.0
7628,120,110,97,207,1,10.0
7629,120,73,91,164,1,10.0
7630,120,78,140,218,1,10.0
7631,120,61,95,156,1,10.0
7632,120,108,174,282,1,10.0
7633,120,86,143,229,1,10.0
7634,120,34,89,123,1,10.0
7635,120,45,88,133,1,10.0
7636,120,63,63,126,1,10.0
7637,120,25,81,106,1,10.0
7638,120,41,74,115,1,10.0
7639,120,13,23,36,1,10.0
7640,120,14,37,51,1,10.0
7641,120,33,134,167,1,10.0
7642,120,50,61,111,1,10.0
7643,120,70,66,136,1,10.0
7644,120,125,217,342,1,10.0
7645,120,30,62,92,1,10.0
7646,120,86,98,184,1,10.0
7647,120,7,18,25,1,10.0
7648,120,97,131,228,1,10.0
7649,120,140,153,293,1,10.0
7650,120,120,169,289,1,10.0
7651,120,66,103,169,1,10.0
7652,120,71,113,184,1,10.0
7653,120,20,54,74,1,10.0
7654,120,42,75,117,1,10.0
7655,120,12,21,33,1,10.0
7656,120,4,4,8,1,10.0
7657,120,7,26,33,1,10.0
7658,120,62,104,166,1,10.0
7659,120,51,114,165,1,10.0
7660,120,43,84,127,1,10.0
7661,120,27,42,69,1,10.0
7662,120,44,72,116,1,10.0
7663,120,45,115,160,1,10.0
7664,120,86,147,233,1,10.0
7665,120,132,178,310,1,10.0
7666,120,78,89,167,1,10.0
7667,120,40,42,82,1,10.0
7668,120,56,58,114,1,10.0
7669,120,71,104,175,1,10.0
7670,120,45,46,91,1,10.0
7671,120,75,63,138,1,10.0
7672,120,69,152,221,1,10.0
7673,120,69,105,174,1,10.0
7674,120,72,123,195,1,10.0
7675,120,63,160,223,1,10.0
7676,120,26,61,87,1,10.0
7677,120,36,72,108,1,10.0
7678,120,24,49,73,1,10.0
7679,120,6,15,21,1,10.0
7680,120,176,229,405,1,10.0
7681,120,68,117,185,1,10.0
7682,120,98,130,228,1,10.0
7683,120,84,138,222,1,10.0
7684,120,57,106,163,1,10.0
7685,120,35,40,75,1,10.0
7686,120,176,200,376,1,10.0
7687,120,48,70,118,1,10.0
7688,120,109,133,242,1,10.0
7689,120,11,31,42,1,10.0
7690,120,49,62,111,1,10.0
7691,120,26,43,69,1,10.0
7692,120,31,59,90,1,10.0
7693,120,13,41,54,1,10.0
7694,120,6,14,20,1,10.0
7695,120,96,114,210,1,10.0
7696,120,123,101,224,1,10.0
7697,120,196,330,526,1,10.0
7698,120,28,59,87,1,10.0
7699,120,80,137,217,1,10.0
7700,120,151,189,340,1,10.0
7701,120,56,124,180,1,10.0
7702,120,54,67,121,1,10.0
7703,120,81,81,162,1,10.0
7704,120,76,90,166,1,10.0
7705,120,28,62,90,1,10.0
7706,120,8,17,25,1,10.0
7707,120,29,45,74,1,10.0
7708,120,35,39,74,1,10.0
7709,120,7,9,16,1,10.0
7710,120,48,84,132,1,10.0
7711,120,1,11,12,1,10.0
7712,120,76,126,202,1,10.0
7713,120,28,75,103,1,10.0
7714,120,32,57,89,1,10.0
7715,120,7,24,31,1,10.0
7716,120,68,122,190,1,10.0
7717,120,64,84,148,1,10.0
7718,120,69,68,137,1,10.0
7719,120,98,115,213,1,10.0
7720,120,57,61,118,1,10.0
7721,120,90,94,184,1,10.0
7722,120,27,29,56,1,10.0
7723,120,75,91,166,1,10.0
7724,120,35,40,75,1,10.0
7725,120,54,110,164,1,10.0
7726,120,20,64,84,1,10.0
7727,120,33,57,90,1,10.0
7728,120,60,47,107,1,10.0
7729,120,172,323,495,1,10.0
7730,120,37,67,104,1,10.0
7731,120,62,105,167,1,10.0
7732,120,71,74,145,1,10.0
7733,120,44,82,126,1,10.0
7734,120,89,94,183,1,10.0
7735,120,29,69,98,1,10.0
7736,120,35,48,83,1,10.0
7737,120,58,80,138,1,10.0
7738,120,18,24,42,1,10.0
7739,120,11,21,32,1,10.0
7740,120,175,159,334,1,10.0
7741,120,45,33,78,1,10.0
7742,120,17,12,29,1,10.0
7743,120,49,83,132,1,10.0
7744,120,45,73,118,1,10.0
7745,120,63,93,156,1,10.0
7746,120,43,66,109,1,10.0
7747,120,30,30,60,1,10.0
7748,120,114,169,283,1,10.0
7749,120,84,72,156,1,10.0
7750,120,53,96,149,1,10.0
7751,120,45,12,57,1,10.0
7752,120,58,98,156,1,10.0
7753,120,62,116,178,1,10.0
7754,120,16,22,38,1,10.0
7755,120,164,247,411,1,10.0
7756,120,112,188,300,1,10.0
7757,120,83,137,220,1,10.0
7758,120,41,67,108,1,10.0
7759,120,69,83,152,1,10.0
7760,120,61,63,124,1,10.0
7761,120,110,151,261,1,10.0
7762,120,62,88,150,1,10.0
7763,120,89,119,208,1,10.0
7764,120,38,64,102,1,10.0
7765,120,86,112,198,1,10.0
7766,120,26,57,83,1,10.0
7767,120,30,47,77,1,10.0
7768,120,35,37,72,1,10.0
7769,120,24,42,66,1,10.0
7770,120,43,51,94,1,10.0
7771,120,17,21,38,1,10.0
7772,120,18,14,32,1,10.0
7773,120,78,64,142,1,10.0
7774,120,41,56,97,1,10.0
7775,120,115,204,319,1,10.0
7776,120,66,158,224,1,10.0
7777,120,91,157,248,1,10.0
7778,120,30,78,108,1,10.0
7779,120,22,40,62,1,10.0
7780,120,86,157,243,1,10.0
7781,120,114,177,291,1,10.0
7782,120,74,98,172,1,10.0
7783,120,77,102,179,1,10.0
7784,120,47,83,130,1,10.0
7785,120,55,118,173,1,10.0
7786,120,21,47,68,1,10.0
7787,120,40,90,130,1,10.0
7788,120,13,33,46,1,10.0
7789,120,55,65,120,1,10.0
7790,120,55,115,170,1,10.0
7791,120,48,101,149,1,10.0
7792,120,78,160,238,1,10.0
7793,120,137,159,296,1,10.0
7794,120,148,200,348,1,10.0
7795,120,93,118,211,1,10.0
7796,120,72,148,220,1,10.0
7797,120,77,85,162,1,10.0
7798,120,32,122,154,1,10.0
7799,120,26,42,68,1,10.0
7800,120,13,34,47,1,10.0
7801,120,56,63,119,1,10.0
7802,120,145,112,257,1,10.0
7803,120,61,108,169,1,10.0
7804,120,142,153,295,1,10.0
7805,120,105,164,269,1,10.0
7806,120,62,56,118,1,10.0
7807,120,65,134,199,1,10.0
7808,120,64,131,195,1,10.0
7809,120,23,54,77,1,10.0
7810,120,52,66,118,1,10.0
7811,120,76,86,162,1,10.0
7812,120,99,170,269,1,10.0
7813,120,90,196,286,1,10.0
7814,120,18,27,45,1,10.0
7815,120,3,13,16,1,10.0
7816,120,46,122,168,1,10.0
7817,120,76,142,218,1,10.0
7818,120,75,126,201,1,10.0
7819,120,92,138,230,1,10.0
7820,120,53,85,138,1,10.0
7821,120,58,56,114,1,10.0
7822,120,59,133,192,1,10.0
7823,120,40,31,71,1,10.0
7824,120,94,129,223,1,10.0
7825,120,30,36,66,1,10.0
7826,120,19,99,118,1,10.0
7827,120,25,57,82,1,10.0
7828,120,22,60,82,1,10.0
7829,120,23,17,40,1,10.0
7830,120,37,59,96,1,10.0
7831,120,52,135,187,1,10.0
7832,120,62,63,125,1,10.0
7833,120,93,139,232,1,10.0
7834,120,65,92,157,1,10.0
7835,120,65,88,153,1,10.0
7836,120,42,49,91,1,10.0
7837,120,73,86,159,1,10.0
7838,120,149,221,370,1,10.0
7839,120,99,134,233,1,10.0
7840,120,60,96,156,1,10.0
7841,120,6,32,38,1,10.0
7842,120,55,59,114,1,10.0
7843,120,30,38,68,1,10.0
7844,120,31,62,93,1,10.0
7845,120,5,12,17,1,10.0
7846,120,10,26,36,1,10.0
7847,120,9,15,24,1,10.0
7848,120,91,205,296,1,10.0
7849,120,61,74,135,1,10.0
7850,120,24,19,43,1,10.0
7851,120,45,90,135,1,10.0
7852,120,64,117,181,1,10.0
7853,120,159,295,454,1,10.0
7854,120,101,147,248,1,10.0
7855,120,73,108,181,1,10.0
7856,120,107,121,228,1,10.0
7857,120,31,35,66,1,10.0
7858,120,57,34,91,1,10.0
7859,120,35,62,97,1,10.0
7860,120,75,69,144,1,10.0
7861,120,80,139,219,1,10.0
7862,120,13,24,37,1,10.0
7863,120,39,28,67,1,10.0
7864,120,7,3,10,1,10.0
7865,120,24,30,54,1,10.0
7866,120,49,82,131,1,10.0
7867,120,77,69,146,1,10.0
7868,120,122,153,275,1,10.0
7869,120,31,41,72,1,10.0
7870,120,43,111,154,1,10.0
7871,120,106,161,267,1,10.0
7872,120,35,75,110,1,10.0
7873,120,177,377,554,1,10.0
7874,120,59,77,136,1,10.0
7875,120,24,75,99,1,10.0
7876,120,37,67,104,1,10.0
7877,120,7,11,18,1,10.0
7878,120,33,28,61,1,10.0
7879,120,49,61,110,1,10.0
7880,120,103,138,241,1,10.0
7881,120,54,77,131,1,10.0
7882,120,85,48,133,1,10.0
7883,120,62,119,181,1,10.0
7884,120,41,25,66,1,10.0
7885,120,145,233,378,1,10.0
7886,120,70,109,179,1,10.0
7887,120,79,142,221,1,10.0
7888,120,70,141,211,1,10.0
7889,120,43,62,105,1,10.0
7890,120,34,41,75,1,10.0
7891,120,54,97,151,1,10.0
7892,120,108,101,209,1,10.0
7893,120,22,61,83,1,10.0
7894,120,83,102,185,1,10.0
7895,120,22,78,100,1,10.0
7896,120,86,112,198,1,10.0
7897,120,27,22,49,1,10.0
7898,120,41,45,86,1,10.0
7899,120,42,72,114,1,10.0
7900,120,33,76,109,1,10.0
7901,120,123,120,243,1,10.0
7902,120,35,61,96,1,10.0
7903,120,68,89,157,1,10.0
7904,120,54,79,133,1,10.0
7905,120,117,152,269,1,10.0
7906,120,55,49,104,1,10.0
7907,120,20,17,37,1,10.0
7908,120,105,98,203,1,10.0
7909,120,142,155,297,1,10.0
7910,120,38,42,80,1,10.0
7911,120,93,149,242,1,10.0
7912,120,97,125,222,1,10.0
7913,120,19,30,49,1,10.0
7914,120,54,109,163,1,10.0
7915,120,24,12,36,1,10.0
7916,120,77,94,171,1,10.0
7917,120,89,104,193,1,10.0
7918,120,45,53,98,1,10.0
7919,120,59,97,156,1,10.0
7920,120,190,410,600,1,10.0
7921,120,60,54,114,1,10.0
7922,120,106,137,243,1,10.0
7923,120,94,161,255,1,10.0
7924,120,29,54,83,1,10.0
7925,120,71,89,160,1,10.0
7926,120,43,85,128,1,10.0
7927,120,13,11,24,1,10.0
7928,120,117,98,215,1,10.0
7929,120,30,61,91,1,10.0
7930,120,68,104,172,1,10.0
7931,120,75,124,199,1,10.0
7932,120,76,91,167,1,10.0
7933,120,49,63,112,1,10.0
7934,120,51,50,101,1,10.0
7935,120,44,120,164,1,10.0
7936,120,78,95,173,1,10.0
7937,120,86,88,174,1,10.0
7938,120,23,91,114,1,10.0
7939,120,76,139,215,1,10.0
7940,120,67,104,171,1,10.0
7941,120,22,58,80,1,10.0
7942,120,30,51,81,1,10.0
7943,120,84,153,237,1,10.0
7944,120,155,149,304,1,10.0
7945,120,90,109,199,1,10.0
7946,120,78,129,207,1,10.0
7947,120,104,194,298,1,10.0
7948,120,185,228,413,1,10.0
7949,120,183,291,474,1,10.0
7950,120,154,168,322,1,10.0
7951,120,62,94,156,1,10.0
7952,120,67,49,116,1,10.0
7953,120,87,257,344,1,10.0
7954,120,58,48,106,1,10.0
7955,120,88,133,221,1,10.0
7956,120,7,28,35,1,10.0
7957,120,54,89,143,1,10.0
7958,120,76,134,210,1,10.0
7959,120,82,152,234,1,10.0
7960,120,98,141,239,1,10.0
7961,120,35,87,122,1,10.0
7962,120,35,90,125,1,10.0
7963,120,62,140,202,1,10.0
7964,120,163,199,362,1,10.0
7965,120,144,307,451,1,10.0
7966,120,71,176,247,1,10.0
7967,120,29,59,88,1,10.0
7968,120,49,61,110,1,10.0
7969,120,36,79,115,1,10.0
7970,120,79,149,228,1,10.0
7971,120,131,218,349,1,10.0
7972,120,77,139,216,1,10.0
7973,120,83,121,204,1,10.0
7974,120,95,133,228,1,10.0
7975,120,108,138,246,1,10.0
7976,120,55,78,133,1,10.0
7977,120,121,183,304,1,10.0
7978,120,52,139,191,1,10.0
7979,120,85,119,204,1,10.0
7980,120,54,86,140,1,10.0
7981,120,38,76,114,1,10.0
7982,120,34,73,107,1,10.0
7983,120,141,102,243,1,10.0
7984,120,49,96,145,1,10.0
7985,120,63,83,146,1,10.0
7986,120,67,126,193,1,10.0
7987,120,113,152,265,1,10.0
7988,120,74,100,174,1,10.0
7989,120,75,125,200,1,10.0
7990,120,37,42,79,1,10.0
7991,120,32,49,81,1,10.0
7992,120,73,104,177,1,10.0
7993,120,24,45,69,1,10.0
7994,120,28,26,54,1,10.0
7995,120,62,82,144,1,10.0
7996,180,23,50,73,1,10.0
7997,180,136,222,358,1,10.0
7998,180,97,80,177,1,10.0
7999,180,159,178,337,1,10.0
8000,180,59,80,139,1,10.0
8001,180,93,149,242,1,10.0
8002,180,110,164,274,1,10.0
8003,180,63,82,145,1,10.0
8004,180,85,100,185,1,10.0
8005,180,68,115,183,1,10.0
8006,180,59,126,185,1,10.0
8007,180,27,41,68,1,10.0
8008,180,96,106,202,1,10.0
8009,180,47,52,99,1,10.0
8010,180,94,135,229,1,10.0
8011,180,67,107,174,1,10.0
8012,180,157,244,401,1,10.0
8013,180,67,96,163,1,10.0
8014,180,111,189,300,1,10.0
8015,180,89,85,174,1,10.0
8016,180,37,31,68,1,10.0
8017,180,21,33,54,1,10.0
8018,180,49,69,118,1,10.0
8019,180,53,71,124,1,10.0
8020,180,20,24,44,1,10.0
8021,180,23,33,56,1,10.0
8022,180,8,24,32,1,10.0
8023,180,49,77,126,1,10.0
8024,180,62,116,178,1,10.0
8025,180,52,114,166,1,10.0
8026,180,32,25,57,1,10.0
8027,180,77,145,222,1,10.0
8028,180,50,42,92,1,10.0
8029,180,251,241,492,1,10.0
8030,180,113,186,299,1,10.0
8031,180,38,52,90,1,10.0
8032,180,108,95,203,1,10.0
8033,180,32,48,80,1,10.0
8034,180,77,67,144,1,10.0
8035,180,35,63,98,1,10.0
8036,180,44,66,110,1,10.0
8037,180,56,48,104,1,10.0
8038,180,39,84,123,1,10.0
8039,180,63,97,160,1,10.0
8040,180,93,128,221,1,10.0
8041,180,125,110,235,1,10.0
8042,180,44,124,168,1,10.0
8043,180,50,68,118,1,10.0
8044,180,76,104,180,1,10.0
8045,180,14,21,35,1,10.0
8046,180,72,74,146,1,10.0
8047,180,125,215,340,1,10.0
8048,180,53,66,119,1,10.0
8049,180,81,103,184,1,10.0
8050,180,41,70,111,1,10.0
8051,180,30,36,66,1,10.0
8052,180,6,79,85,1,10.0
8053,180,69,54,123,1,10.0
8054,180,26,76,102,1,10.0
8055,180,20,26,46,1,10.0
8056,180,56,84,140,1,10.0
8057,180,41,66,107,1,10.0
8058,180,63,91,154,1,10.0
8059,180,73,119,192,1,10.0
8060,180,115,104,219,1,10.0
8061,180,72,143,215,1,10.0
8062,180,78,71,149,1,10.0
8063,180,139,147,286,1,10.0
8064,180,74,228,302,1,10.0
8065,180,134,152,286,1,10.0
8066,180,19,51,70,1,10.0
8067,180,150,219,369,1,10.0
8068,180,24,55,79,1,10.0
8069,180,98,150,248,1,10.0
8070,180,91,183,274,1,10.0
8071,180,33,51,84,1,10.0
8072,180,30,52,82,1,10.0
8073,180,63,84,147,1,10.0
8074,180,69,132,201,1,10.0
8075,180,134,192,326,1,10.0
8076,180,26,79,105,1,10.0
8077,180,34,68,102,1,10.0
8078,180,67,95,162,1,10.0
8079,180,75,97,172,1,10.0
8080,180,42,82,124,1,10.0
8081,180,30,32,62,1,10.0
8082,180,80,151,231,1,10.0
8083,180,28,36,64,1,10.0
8084,180,22,38,60,1,10.0
8085,180,64,120,184,1,10.0
8086,180,38,63,101,1,10.0
8087,180,23,26,49,1,10.0
8088,180,37,57,94,1,10.0
8089,180,68,93,161,1,10.0
8090,180,108,172,280,1,10.0
8091,180,168,260,428,1,10.0
8092,180,23,21,44,1,10.0
8093,180,65,89,154,1,10.0
8094,180,17,46,63,1,10.0
8095,180,133,159,292,1,10.0
8096,180,96,132,228,1,10.0
8097,180,54,60,114,1,10.0
8098,180,47,52,99,1,10.0
8099,180,26,42,68,1,10.0
8100,180,45,64,109,1,10.0
8101,180,54,80,134,1,10.0
8102,180,92,126,218,1,10.0
8103,180,151,196,347,1,10.0
8104,180,24,19,43,1,10.0
8105,180,86,138,224,1,10.0
8106,180,145,141,286,1,10.0
8107,180,67,105,172,1,10.0
8108,180,50,66,116,1,10.0
8109,180,112,134,246,1,10.0
8110,180,31,22,53,1,10.0
8111,180,52,52,104,1,10.0
8112,180,36,70,106,1,10.0
8113,180,47,47,94,1,10.0
8114,180,6,13,19,1,10.0
8115,180,72,64,136,1,10.0
8116,180,160,210,370,1,10.0
8117,180,139,181,320,1,10.0
8118,180,129,176,305,1,10.0
8119,180,123,163,286,1,10.0
8120,180,49,68,117,1,10.0
8121,180,51,74,125,1,10.0
8122,180,72,87,159,1,10.0
8123,180,133,188,321,1,10.0
8124,180,96,162,258,1,10.0
8125,180,13,12,25,1,10.0
8126,180,109,166,275,1,10.0
8127,180,79,290,369,1,10.0
8128,180,11,21,32,1,10.0
8129,180,44,45,89,1,10.0
8130,180,106,185,291,1,10.0
8131,180,150,273,423,1,10.0
8132,180,121,208,329,1,10.0
8133,180,139,202,341,1,10.0
8134,180,29,27,56,1,10.0
8135,180,94,163,257,1,10.0
8136,180,68,144,212,1,10.0
8137,180,39,59,98,1,10.0
8138,180,25,35,60,1,10.0
8139,180,77,111,188,1,10.0
8140,180,26,25,51,1,10.0
8141,180,115,171,286,1,10.0
8142,180,52,34,86,1,10.0
8143,180,112,140,252,1,10.0
8144,180,68,68,136,1,10.0
8145,180,36,102,138,1,10.0
8146,180,33,119,152,1,10.0
8147,180,100,153,253,1,10.0
8148,180,35,38,73,1,10.0
8149,180,72,104,176,1,10.0
8150,180,55,90,145,1,10.0
8151,180,76,95,171,1,10.0
8152,180,40,47,87,1,10.0
8153,180,123,114,237,1,10.0
8154,180,62,86,148,1,10.0
8155,180,22,48,70,1,10.0
8156,180,71,150,221,1,10.0
8157,180,21,20,41,1,10.0
8158,180,115,136,251,1,10.0
8159,180,105,116,221,1,10.0
8160,180,64,69,133,1,10.0
8161,180,115,156,271,1,10.0
8162,180,45,48,93,1,10.0
8163,180,50,54,104,1,10.0
8164,180,114,95,209,1,10.0
8165,180,46,60,106,1,10.0
8166,180,191,110,301,1,10.0
8167,180,191,118,309,1,10.0
8168,180,30,38,68,1,10.0
8169,180,39,81,120,1,10.0
8170,180,27,45,72,1,10.0
8171,180,16,18,34,1,10.0
8172,180,31,32,63,1,10.0
8173,180,20,23,43,1,10.0
8174,180,27,36,63,1,10.0
8175,180,16,16,32,1,10.0
8176,180,111,132,243,1,10.0
8177,180,93,121,214,1,10.0
8178,180,106,88,194,1,10.0
8179,180,157,164,321,1,10.0
8180,180,152,199,351,1,10.0
8181,180,105,133,238,1,10.0
8182,180,56,87,143,1,10.0
8183,180,43,58,101,1,10.0
8184,180,71,101,172,1,10.0
8185,180,41,51,92,1,10.0
8186,180,82,119,201,1,10.0
8187,180,44,29,73,1,10.0
8188,180,51,118,169,1,10.0
8189,180,85,108,193,1,10.0
8190,180,128,172,300,1,10.0
8191,180,126,190,316,1,10.0
8192,180,90,124,214,1,10.0
8193,180,116,150,266,1,10.0
8194,180,56,84,140,1,10.0
8195,180,98,120,218,1,10.0
8196,180,47,53,100,1,10.0
8197,180,30,66,96,1,10.0
8198,180,51,96,147,1,10.0
8199,180,4,12,16,1,10.0
8200,180,20,38,58,1,10.0
8201,180,29,58,87,1,10.0
8202,180,51,46,97,1,10.0
8203,180,49,57,106,1,10.0
8204,180,167,155,322,1,10.0
8205,180,62,53,115,1,10.0
8206,180,103,192,295,1,10.0
8207,180,41,49,90,1,10.0
8208,180,177,210,387,1,10.0
8209,180,24,41,65,1,10.0
8210,180,95,137,232,1,10.0
8211,180,19,27,46,1,10.0
8212,180,5,18,23,1,10.0
8213,180,119,199,318,1,10.0
8214,180,44,81,125,1,10.0
8215,180,32,35,67,1,10.0
8216,180,62,114,176,1,10.0
8217,180,124,202,326,1,10.0
8218,180,77,124,201,1,10.0
8219,180,76,102,178,1,10.0
8220,180,44,51,95,1,10.0
8221,180,106,195,301,1,10.0
8222,180,61,44,105,1,10.0
8223,180,47,70,117,1,10.0
8224,180,92,155,247,1,10.0
8225,180,76,36,112,1,10.0
8226,180,23,74,97,1,10.0
8227,180,12,16,28,1,10.0
8228,180,35,56,91,1,10.0
8229,180,29,43,72,1,10.0
8230,180,75,93,168,1,10.0
8231,180,27,43,70,1,10.0
8232,180,58,88,146,1,10.0
8233,180,47,86,133,1,10.0
8234,180,106,70,176,1,10.0
8235,180,123,188,311,1,10.0
8236,180,16,25,41,1,10.0
8237,180,60,132,192,1,10.0
8238,180,133,170,303,1,10.0
8239,180,13,16,29,1,10.0
8240,180,64,115,179,1,10.0
8241,180,43,63,106,1,10.0
8242,180,106,123,229,1,10.0
8243,180,44,99,143,1,10.0
8244,180,62,132,194,1,10.0
8245,180,123,136,259,1,10.0
8246,180,73,124,197,1,10.0
8247,180,127,158,285,1,10.0
8248,180,31,34,65,1,10.0
8249,180,120,164,284,1,10.0
8250,180,74,85,159,1,10.0
8251,180,165,221,386,1,10.0
8252,180,86,144,230,1,10.0
8253,180,63,85,148,1,10.0
8254,180,83,151,234,1,10.0
8255,180,118,163,281,1,10.0
8256,180,32,76,108,1,10.0
8257,180,32,65,97,1,10.0
8258,180,91,117,208,1,10.0
8259,180,111,98,209,1,10.0
8260,180,49,108,157,1,10.0
8261,180,45,68,113,1,10.0
8262,180,73,111,184,1,10.0
8263,180,15,26,41,1,10.0
8264,180,72,95,167,1,10.0
8265,180,110,206,316,1,10.0
8266,180,59,72,131,1,10.0
8267,180,50,78,128,1,10.0
8268,180,76,89,165,1,10.0
8269,180,13,96,109,1,10.0
8270,180,36,37,73,1,10.0
8271,180,78,58,136,1,10.0
8272,180,37,65,102,1,10.0
8273,180,33,41,74,1,10.0
8274,180,23,22,45,1,10.0
8275,180,14,16,30,1,10.0
8276,180,9,31,40,1,10.0
8277,180,62,106,168,1,10.0
8278,180,66,124,190,1,10.0
8279,180,46,57,103,1,10.0
8280,180,154,178,332,1,10.0
8281,180,83,82,165,1,10.0
8282,180,68,71,139,1,10.0
8283,180,76,126,202,1,10.0
8284,180,119,107,226,1,10.0
8285,180,40,33,73,1,10.0
8286,180,6,16,22,1,10.0
8287,180,80,83,163,1,10.0
8288,180,35,59,94,1,10.0
8289,180,80,113,193,1,10.0
8290,180,85,90,175,1,10.0
8291,180,19,36,55,1,10.0
8292,180,8,21,29,1,10.0
8293,180,32,133,165,1,10.0
8294,180,173,235,408,1,10.0
8295,180,61,74,135,1,10.0
8296,180,124,199,323,1,10.0
8297,180,190,223,413,1,10.0
8298,180,100,112,212,1,10.0
8299,180,56,69,125,1,10.0
8300,180,67,70,137,1,10.0
8301,180,133,183,316,1,10.0
8302,180,55,73,128,1,10.0
8303,180,177,91,268,1,10.0
8304,180,99,88,187,1,10.0
8305,180,76,155,231,1,10.0
8306,180,79,55,134,1,10.0
8307,180,8,34,42,1,10.0
8308,180,96,130,226,1,10.0
8309,180,50,75,125,1,10.0
8310,180,84,138,222,1,10.0
8311,180,49,87,136,1,10.0
8312,180,71,110,181,1,10.0
8313,180,149,266,415,1,10.0
8314,180,89,235,324,1,10.0
8315,180,116,139,255,1,10.0
8316,180,62,102,164,1,10.0
8317,180,75,93,168,1,10.0
8318,180,99,126,225,1,10.0
8319,180,56,113,169,1,10.0
8320,180,61,48,109,1,10.0
8321,180,24,30,54,1,10.0
8322,180,18,33,51,1,10.0
8323,180,56,21,77,1,10.0
8324,180,113,39,152,1,10.0
8325,180,67,77,144,1,10.0
8326,180,64,54,118,1,10.0
8327,180,63,107,170,1,10.0
8328,180,35,50,85,1,10.0
8329,180,76,84,160,1,10.0
8330,180,92,193,285,1,10.0
8331,180,67,68,135,1,10.0
8332,180,78,105,183,1,10.0
8333,180,58,80,138,1,10.0
8334,180,222,396,618,1,10.0
8335,180,93,141,234,1,10.0
8336,180,88,171,259,1,10.0
8337,180,7,26,33,1,10.0
8338,180,73,100,173,1,10.0
8339,180,77,112,189,1,10.0
8340,180,98,112,210,1,10.0
8341,180,89,174,263,1,10.0
8342,180,51,76,127,1,10.0
8343,180,82,168,250,1,10.0
8344,180,29,69,98,1,10.0
8345,180,124,221,345,1,10.0
8346,180,45,97,142,1,10.0
8347,180,99,50,149,1,10.0
8348,180,60,126,186,1,10.0
8349,180,30,49,79,1,10.0
8350,180,52,67,119,1,10.0
8351,180,59,115,174,1,10.0
8352,180,9,14,23,1,10.0
8353,180,21,37,58,1,10.0
8354,180,139,124,263,1,10.0
8355,180,69,94,163,1,10.0
8356,180,81,148,229,1,10.0
8357,180,71,106,177,1,10.0
8358,180,66,85,151,1,10.0
8359,180,49,56,105,1,10.0
8360,180,81,90,171,1,10.0
8361,180,44,56,100,1,10.0
8362,180,110,89,199,1,10.0
8363,180,30,94,124,1,10.0
8364,180,23,32,55,1,10.0
8365,180,34,26,60,1,10.0
8366,180,39,29,68,1,10.0
8367,180,49,92,141,1,10.0
8368,180,95,200,295,1,10.0
8369,180,91,177,268,1,10.0
8370,180,74,136,210,1,10.0
8371,180,42,57,99,1,10.0
8372,180,66,143,209,1,10.0
8373,180,20,52,72,1,10.0
8374,180,33,73,106,1,10.0
8375,180,47,49,96,1,10.0
8376,180,18,57,75,1,10.0
8377,180,21,23,44,1,10.0
8378,180,46,80,126,1,10.0
8379,180,43,27,70,1,10.0
8380,180,47,115,162,1,10.0
8381,180,16,34,50,1,10.0
8382,180,74,127,201,1,10.0
8383,180,51,64,115,1,10.0
8384,180,64,91,155,1,10.0
8385,180,68,107,175,1,10.0
8386,180,90,96,186,1,10.0
8387,180,104,125,229,1,10.0
8388,180,105,174,279,1,10.0
8389,180,62,109,171,1,10.0
8390,180,29,34,63,1,10.0
8391,180,59,76,135,1,10.0
8392,180,5,11,16,1,10.0
8393,180,56,71,127,1,10.0
8394,180,4,4,8,1,10.0
8395,180,67,42,109,1,10.0
8396,180,73,80,153,1,10.0
8397,180,95,89,184,1,10.0
8398,180,71,143,214,1,10.0
8399,180,66,72,138,1,10.0
8400,180,75,116,191,1,10.0
8401,180,45,42,87,1,10.0
8402,180,63,139,202,1,10.0
8403,180,47,30,77,1,10.0
8404,180,46,48,94,1,10.0
8405,180,46,36,82,1,10.0
8406,180,56,50,106,1,10.0
8407,180,54,99,153,1,10.0
8408,180,33,48,81,1,10.0
8409,180,98,97,195,1,10.0
8410,180,91,82,173,1,10.0
8411,180,54,58,112,1,10.0
8412,180,6,21,27,1,10.0
8413,180,8,10,18,1,10.0
8414,180,125,140,265,1,10.0
8415,180,146,173,319,1,10.0
8416,180,32,16,48,1,10.0
8417,180,43,62,105,1,10.0
8418,180,62,65,127,1,10.0
8419,180,140,160,300,1,10.0
8420,180,21,29,50,1,10.0
8421,180,60,57,117,1,10.0
8422,180,85,81,166,1,10.0
8423,180,50,55,105,1,10.0
8424,180,22,42,64,1,10.0
8425,180,68,119,187,1,10.0
8426,180,31,22,53,1,10.0
8427,180,81,131,212,1,10.0
8428,180,72,91,163,1,10.0
8429,180,15,3,18,1,10.0
8430,180,84,110,194,1,10.0
8431,180,49,59,108,1,10.0
8432,180,67,40,107,1,10.0
8433,180,113,154,267,1,10.0
8434,180,79,152,231,1,10.0
8435,180,151,144,295,1,10.0
8436,180,103,147,250,1,10.0
8437,180,71,98,169,1,10.0
8438,180,64,62,126,1,10.0
8439,180,49,74,123,1,10.0
8440,180,42,50,92,1,10.0
8441,180,24,30,54,1,10.0
8442,180,23,36,59,1,10.0
8443,180,7,5,12,1,10.0
0,0,17,22,39,2,0.0
1,0,21,45,66,2,0.0
2,0,5,19,24,2,0.0
3,0,24,55,79,2,0.0
4,0,7,11,18,2,0.0
5,0,30,85,115,2,0.0
6,0,27,63,90,2,0.0
7,0,18,25,43,2,0.0
8,0,41,98,139,2,0.0
9,0,24,34,58,2,0.0
10,0,14,11,25,2,0.0
11,0,12,29,41,2,0.0
12,0,13,18,31,2,0.0
13,0,15,13,28,2,0.0
14,0,1,8,9,2,0.0
15,0,9,25,34,2,0.0
16,0,17,46,63,2,0.0
17,0,19,22,41,2,0.0
18,0,53,56,109,2,0.0
19,0,20,53,73,2,0.0
20,0,23,78,101,2,0.0
21,0,20,46,66,2,0.0
22,0,21,54,75,2,0.0
23,0,44,71,115,2,0.0
24,0,34,25,59,2,0.0
25,0,22,30,52,2,0.0
26,0,19,13,32,2,0.0
27,0,13,41,54,2,0.0
28,0,14,29,43,2,0.0
29,0,23,36,59,2,0.0
30,0,69,74,143,2,0.0
31,0,24,63,87,2,0.0
32,0,27,37,64,2,0.0
33,0,40,62,102,2,0.0
34,0,77,122,199,2,0.0
35,0,50,58,108,2,0.0
36,0,39,86,125,2,0.0
37,0,14,23,37,2,0.0
38,0,21,60,81,2,0.0
39,0,11,43,54,2,0.0
40,0,17,41,58,2,0.0
41,0,9,11,20,2,0.0
42,0,7,29,36,2,0.0
43,0,19,48,67,2,0.0
44,0,8,3,11,2,0.0
45,0,31,47,78,2,0.0
46,0,28,25,53,2,0.0
47,0,10,36,46,2,0.0
48,0,52,90,142,2,0.0
49,0,26,28,54,2,0.0
50,0,26,32,58,2,0.0
51,0,11,41,52,2,0.0
52,0,27,42,69,2,0.0
53,0,15,19,34,2,0.0
54,0,6,18,24,2,0.0
55,0,11,29,40,2,0.0
56,0,0,3,3,2,0.0
57,0,8,25,33,2,0.0
58,0,37,88,125,2,0.0
59,0,25,52,77,2,0.0
60,0,64,73,137,2,0.0
61,0,30,74,104,2,0.0
62,0,12,66,78,2,0.0
63,0,27,70,97,2,0.0
64,0,26,31,57,2,0.0
65,0,11,23,34,2,0.0
66,0,15,19,34,2,0.0
67,0,7,22,29,2,0.0
68,0,12,27,39,2,0.0
69,0,15,31,46,2,0.0
70,0,5,13,18,2,0.0
71,0,9,8,17,2,0.0
72,0,38,52,90,2,0.0
73,0,19,64,83,2,0.0
74,0,38,119,157,2,0.0
75,0,21,42,63,2,0.0
76,0,33,74,107,2,0.0
77,0,40,56,96,2,0.0
78,0,20,83,103,2,0.0
79,0,16,14,30,2,0.0
80,0,17,40,57,2,0.0
81,0,4,21,25,2,0.0
82,0,15,37,52,2,0.0
83,0,20,23,43,2,0.0
84,0,10,38,48,2,0.0
85,0,15,28,43,2,0.0
86,0,24,77,101,2,0.0
87,0,16,50,66,2,0.0
88,0,18,44,62,2,0.0
89,0,33,75,108,2,0.0
90,0,20,22,42,2,0.0
91,0,12,22,34,2,0.0
92,0,17,70,87,2,0.0
93,0,35,21,56,2,0.0
94,0,7,24,31,2,0.0
95,0,7,16,23,2,0.0
96,0,29,45,74,2,0.0
97,0,10,26,36,2,0.0
98,0,10,10,20,2,0.0
99,0,9,22,31,2,0.0
100,0,2,4,6,2,0.0
101,0,5,7,12,2,0.0
102,0,41,84,125,2,0.0
103,0,33,96,129,2,0.0
104,0,11,46,57,2,0.0
105,0,62,102,164,2,0.0
106,0,56,140,196,2,0.0
107,0,38,84,122,2,0.0
108,0,40,35,75,2,0.0
109,0,25,21,46,2,0.0
110,0,30,38,68,2,0.0
111,0,2,4,6,2,0.0
112,0,11,30,41,2,0.0
113,0,41,39,80,2,0.0
114,0,10,17,27,2,0.0
115,0,20,27,47,2,0.0
116,0,33,87,120,2,0.0
117,0,28,37,65,2,0.0
118,0,17,36,53,2,0.0
119,0,19,79,98,2,0.0
120,0,40,49,89,2,0.0
121,0,57,159,216,2,0.0
122,0,13,30,43,2,0.0
123,0,40,72,112,2,0.0
124,0,2,5,7,2,0.0
125,0,17,22,39,2,0.0
126,0,68,75,143,2,0.0
127,0,20,39,59,2,0.0
128,0,49,60,109,2,0.0
129,0,57,68,125,2,0.0
130,0,94,153,247,2,0.0
131,0,57,62,119,2,0.0
132,0,25,35,60,2,0.0
133,0,37,64,101,2,0.0
134,0,46,47,93,2,0.0
135,0,6,14,20,2,0.0
136,0,6,7,13,2,0.0
137,0,2,12,14,2,0.0
138,0,4,11,15,2,0.0
139,0,21,51,72,2,0.0
140,0,23,44,67,2,0.0
141,0,29,54,83,2,0.0
142,0,44,55,99,2,0.0
143,0,43,114,157,2,0.0
144,0,44,75,119,2,0.0
145,0,46,82,128,2,0.0
146,0,21,34,55,2,0.0
147,0,12,39,51,2,0.0
148,0,14,15,29,2,0.0
149,0,16,47,63,2,0.0
150,0,11,26,37,2,0.0
151,0,9,28,37,2,0.0
152,0,8,15,23,2,0.0
153,0,53,81,134,2,0.0
154,0,3,6,9,2,0.0
155,0,65,122,187,2,0.0
156,0,11,26,37,2,0.0
157,0,43,116,159,2,0.0
158,0,10,27,37,2,0.0
159,0,39,87,126,2,0.0
160,0,15,22,37,2,0.0
161,0,27,55,82,2,0.0
162,0,15,77,92,2,0.0
163,0,13,12,25,2,0.0
164,0,15,21,36,2,0.0
165,0,9,26,35,2,0.0
166,0,5,0,5,2,0.0
167,0,95,160,255,2,0.0
168,0,30,41,71,2,0.0
169,0,75,68,143,2,0.0
170,0,25,62,87,2,0.0
171,0,21,40,61,2,0.0
172,0,44,70,114,2,0.0
173,0,16,32,48,2,0.0
174,0,26,45,71,2,0.0
175,0,38,69,107,2,0.0
176,0,20,44,64,2,0.0
177,0,11,18,29,2,0.0
178,0,6,13,19,2,0.0
179,0,9,17,26,2,0.0
180,0,12,28,40,2,0.0
181,0,24,63,87,2,0.0
182,0,32,82,114,2,0.0
183,0,53,102,155,2,0.0
184,0,7,3,10,2,0.0
185,0,21,22,43,2,0.0
186,0,33,38,71,2,0.0
187,0,30,40,70,2,0.0
188,0,11,52,63,2,0.0
189,0,54,92,146,2,0.0
190,0,15,28,43,2,0.0
191,0,9,8,17,2,0.0
192,0,10,28,38,2,0.0
193,0,28,77,105,2,0.0
194,0,31,99,130,2,0.0
195,0,79,101,180,2,0.0
196,0,70,138,208,2,0.0
197,0,39,71,110,2,0.0
198,0,20,48,68,2,0.0
199,0,33,32,65,2,0.0
200,0,8,22,30,2,0.0
201,0,22,41,63,2,0.0
202,0,4,20,24,2,0.0
203,0,11,23,34,2,0.0
204,0,10,18,28,2,0.0
205,0,10,6,16,2,0.0
206,0,13,26,39,2,0.0
207,0,14,29,43,2,0.0
208,0,17,28,45,2,0.0
209,0,64,118,182,2,0.0
210,0,24,27,51,2,0.0
211,0,22,54,76,2,0.0
212,0,4,10,14,2,0.0
213,0,25,54,79,2,0.0
214,0,19,63,82,2,0.0
215,0,3,16,19,2,0.0
216,0,15,27,42,2,0.0
217,0,9,12,21,2,0.0
218,0,9,13,22,2,0.0
219,0,6,2,8,2,0.0
220,0,22,32,54,2,0.0
221,0,2,6,8,2,0.0
222,0,20,15,35,2,0.0
223,0,15,9,24,2,0.0
224,0,66,175,241,2,0.0
225,0,8,8,16,2,0.0
226,0,11,26,37,2,0.0
227,0,66,171,237,2,0.0
228,0,33,67,100,2,0.0
229,0,6,16,22,2,0.0
230,0,28,72,100,2,0.0
231,0,33,76,109,2,0.0
232,0,29,27,56,2,0.0
233,0,10,39,49,2,0.0
234,0,20,24,44,2,0.0
235,0,6,7,13,2,0.0
236,0,12,18,30,2,0.0
237,0,5,12,17,2,0.0
238,0,9,23,32,2,0.0
239,0,3,12,15,2,0.0
240,0,15,22,37,2,0.0
241,0,46,138,184,2,0.0
242,0,9,20,29,2,0.0
243,0,36,57,93,2,0.0
244,0,20,56,76,2,0.0
245,0,86,88,174,2,0.0
246,0,46,90,136,2,0.0
247,0,40,35,75,2,0.0
248,0,12,12,24,2,0.0
249,0,36,48,84,2,0.0
250,0,73,124,197,2,0.0
251,0,44,60,104,2,0.0
252,0,15,21,36,2,0.0
253,0,77,131,208,2,0.0
254,0,61,102,163,2,0.0
255,0,37,74,111,2,0.0
256,0,34,49,83,2,0.0
257,0,9,36,45,2,0.0
258,0,9,24,33,2,0.0
259,0,11,24,35,2,0.0
260,0,26,84,110,2,0.0
261,0,6,15,21,2,0.0
262,0,41,45,86,2,0.0
263,0,5,21,26,2,0.0
264,0,7,22,29,2,0.0
265,0,8,31,39,2,0.0
266,0,27,29,56,2,0.0
267,0,34,61,95,2,0.0
268,0,10,32,42,2,0.0
269,0,13,20,33,2,0.0
270,0,4,50,54,2,0.0
271,0,19,44,63,2,0.0
272,0,12,28,40,2,0.0
273,0,9,16,25,2,0.0
274,0,7,11,18,2,0.0
275,0,12,15,27,2,0.0
276,0,19,22,41,2,0.0
277,0,15,23,38,2,0.0
278,0,9,13,22,2,0.0
279,0,15,32,47,2,0.0
280,0,30,51,81,2,0.0
281,0,21,64,85,2,0.0
282,0,42,69,111,2,0.0
283,0,57,56,113,2,0.0
284,0,27,43,70,2,0.0
285,0,8,22,30,2,0.0
286,0,51,93,144,2,0.0
287,0,20,31,51,2,0.0
288,0,54,104,158,2,0.0
289,0,20,20,40,2,0.0
290,0,10,11,21,2,0.0
291,0,6,12,18,2,0.0
292,0,21,31,52,2,0.0
293,0,15,27,42,2,0.0
294,0,33,58,91,2,0.0
295,0,22,40,62,2,0.0
296,0,22,53,75,2,0.0
297,0,26,42,68,2,0.0
298,0,20,26,46,2,0.0
299,0,9,11,20,2,0.0
300,0,24,43,67,2,0.0
301,0,16,29,45,2,0.0
302,0,36,90,126,2,0.0
303,0,1,4,5,2,0.0
304,0,11,9,20,2,0.0
305,0,5,18,23,2,0.0
306,0,3,1,4,2,0.0
307,0,6,34,40,2,0.0
308,0,10,23,33,2,0.0
309,0,41,98,139,2,0.0
310,0,15,23,38,2,0.0
311,0,12,13,25,2,0.0
312,0,20,39,59,2,0.0
313,0,48,47,95,2,0.0
314,0,37,61,98,2,0.0
315,0,15,32,47,2,0.0
316,0,5,9,14,2,0.0
317,0,11,16,27,2,0.0
318,0,15,24,39,2,0.0
319,0,14,16,30,2,0.0
320,0,3,2,5,2,0.0
321,0,19,60,79,2,0.0
322,0,6,22,28,2,0.0
323,0,17,43,60,2,0.0
324,0,23,40,63,2,0.0
325,0,10,9,19,2,0.0
326,0,14,19,33,2,0.0
327,0,13,31,44,2,0.0
328,0,17,55,72,2,0.0
329,0,10,41,51,2,0.0
330,0,28,48,76,2,0.0
331,0,12,36,48,2,0.0
332,0,10,17,27,2,0.0
333,0,16,6,22,2,0.0
334,0,3,5,8,2,0.0
335,0,12,40,52,2,0.0
336,0,55,84,139,2,0.0
337,0,12,24,36,2,0.0
338,0,21,31,52,2,0.0
339,0,15,26,41,2,0.0
340,0,16,34,50,2,0.0
341,0,2,8,10,2,0.0
342,0,4,29,33,2,0.0
343,0,30,38,68,2,0.0
344,0,12,27,39,2,0.0
345,0,3,5,8,2,0.0
346,0,10,16,26,2,0.0
347,0,7,14,21,2,0.0
348,0,5,18,23,2,0.0
349,0,3,9,12,2,0.0
350,0,5,10,15,2,0.0
351,0,33,42,75,2,0.0
352,0,4,11,15,2,0.0
353,0,23,28,51,2,0.0
354,0,27,30,57,2,0.0
355,0,35,33,68,2,0.0
356,0,12,50,62,2,0.0
357,0,14,22,36,2,0.0
358,0,18,33,51,2,0.0
359,0,17,15,32,2,0.0
360,0,10,14,24,2,0.0
361,0,4,21,25,2,0.0
362,0,14,14,28,2,0.0
363,0,8,11,19,2,0.0
364,0,7,34,41,2,0.0
365,0,26,59,85,2,0.0
366,0,13,10,23,2,0.0
367,0,32,45,77,2,0.0
368,0,13,36,49,2,0.0
369,0,15,30,45,2,0.0
370,0,13,55,68,2,0.0
371,0,34,62,96,2,0.0
372,0,31,42,73,2,0.0
373,0,7,14,21,2,0.0
374,0,15,21,36,2,0.0
375,0,5,8,13,2,0.0
376,0,5,8,13,2,0.0
377,0,0,3,3,2,0.0
378,0,10,28,38,2,0.0
379,0,10,23,33,2,0.0
380,0,41,82,123,2,0.0
381,0,10,60,70,2,0.0
382,0,44,34,78,2,0.0
383,0,19,16,35,2,0.0
384,0,24,57,81,2,0.0
385,0,31,46,77,2,0.0
386,0,43,57,100,2,0.0
387,0,10,26,36,2,0.0
388,0,19,51,70,2,0.0
389,0,13,20,33,2,0.0
390,0,21,23,44,2,0.0
391,0,16,45,61,2,0.0
392,0,23,38,61,2,0.0
393,0,17,44,61,2,0.0
394,0,4,13,17,2,0.0
395,0,32,110,142,2,0.0
396,0,26,54,80,2,0.0
397,0,23,52,75,2,0.0
398,0,17,66,83,2,0.0
399,0,19,11,30,2,0.0
400,0,16,34,50,2,0.0
401,0,45,64,109,2,0.0
402,0,7,12,19,2,0.0
403,0,22,57,79,2,0.0
404,0,3,19,22,2,0.0
405,0,5,31,36,2,0.0
406,0,7,18,25,2,0.0
407,0,14,14,28,2,0.0
408,0,4,14,18,2,0.0
409,0,28,45,73,2,0.0
410,0,22,28,50,2,0.0
411,0,20,52,72,2,0.0
412,0,30,43,73,2,0.0
413,0,35,60,95,2,0.0
414,0,9,52,61,2,0.0
415,0,6,12,18,2,0.0
416,0,8,30,38,2,0.0
417,0,9,32,41,2,0.0
418,0,13,16,29,2,0.0
419,0,2,7,9,2,0.0
420,0,8,15,23,2,0.0
421,0,1,4,5,2,0.0
422,30,27,51,78,2,0.3
423,30,37,61,98,2,0.3
424,30,73,77,150,2,0.3
425,30,41,108,149,2,0.3
426,30,25,61,86,2,0.3
427,30,9,20,29,2,0.3
428,30,26,56,82,2,0.3
429,30,13,8,21,2,0.3
430,30,21,37,58,2,0.3
431,30,27,41,68,2,0.3
432,30,24,47,71,2,0.3
433,30,2,14,16,2,0.3
434,30,84,240,324,2,0.3
435,30,34,64,98,2,0.3
436,30,59,192,251,2,0.3
437,30,40,88,128,2,0.3
438,30,23,85,108,2,0.3
439,30,35,102,137,2,0.3
440,30,15,21,36,2,0.3
441,30,4,9,13,2,0.3
442,30,18,49,67,2,0.3
443,30,28,34,62,2,0.3
444,30,15,43,58,2,0.3
445,30,16,17,33,2,0.3
446,30,6,5,11,2,0.3
447,30,19,26,45,2,0.3
448,30,5,11,16,2,0.3
449,30,1,6,7,2,0.3
450,30,5,4,9,2,0.3
451,30,34,88,122,2,0.3
452,30,13,25,38,2,0.3
453,30,4,13,17,2,0.3
454,30,17,22,39,2,0.3
455,30,33,110,143,2,0.3
456,30,47,34,81,2,0.3
457,30,33,60,93,2,0.3
458,30,46,43,89,2,0.3
459,30,49,82,131,2,0.3
460,30,15,13,28,2,0.3
461,30,11,17,28,2,0.3
462,30,2,8,10,2,0.3
463,30,19,26,45,2,0.3
464,30,8,10,18,2,0.3
465,30,11,18,29,2,0.3
466,30,28,80,108,2,0.3
467,30,36,65,101,2,0.3
468,30,39,117,156,2,0.3
469,30,12,21,33,2,0.3
470,30,32,58,90,2,0.3
471,30,15,17,32,2,0.3
472,30,8,23,31,2,0.3
473,30,7,34,41,2,0.3
474,30,22,70,92,2,0.3
475,30,4,10,14,2,0.3
476,30,11,21,32,2,0.3
477,30,4,17,21,2,0.3
478,30,8,20,28,2,0.3
479,30,7,15,22,2,0.3
480,30,3,3,6,2,0.3
481,30,14,26,40,2,0.3
482,30,9,52,61,2,0.3
483,30,29,66,95,2,0.3
484,30,26,33,59,2,0.3
485,30,9,14,23,2,0.3
486,30,10,37,47,2,0.3
487,30,20,71,91,2,0.3
488,30,7,16,23,2,0.3
489,30,16,59,75,2,0.3
490,30,7,10,17,2,0.3
491,30,4,6,10,2,0.3
492,30,0,3,3,2,0.3
493,30,6,13,19,2,0.3
494,30,6,40,46,2,0.3
495,30,46,47,93,2,0.3
496,30,33,88,121,2,0.3
497,30,19,42,61,2,0.3
498,30,19,41,60,2,0.3
499,30,17,46,63,2,0.3
500,30,69,96,165,2,0.3
501,30,15,39,54,2,0.3
502,30,38,32,70,2,0.3
503,30,6,13,19,2,0.3
504,30,19,34,53,2,0.3
505,30,7,17,24,2,0.3
506,30,9,25,34,2,0.3
507,30,4,17,21,2,0.3
508,30,6,10,16,2,0.3
509,30,5,6,11,2,0.3
510,30,5,6,11,2,0.3
511,30,14,17,31,2,0.3
512,30,16,43,59,2,0.3
513,30,6,21,27,2,0.3
514,30,9,26,35,2,0.3
515,30,22,41,63,2,0.3
516,30,17,19,36,2,0.3
517,30,17,29,46,2,0.3
518,30,20,21,41,2,0.3
519,30,8,15,23,2,0.3
520,30,8,6,14,2,0.3
521,30,10,17,27,2,0.3
522,30,3,0,3,2,0.3
523,30,5,16,21,2,0.3
524,30,10,18,28,2,0.3
525,30,6,12,18,2,0.3
526,30,20,52,72,2,0.3
527,30,20,59,79,2,0.3
528,30,9,20,29,2,0.3
529,30,6,10,16,2,0.3
530,30,36,77,113,2,0.3
531,30,23,42,65,2,0.3
532,30,8,30,38,2,0.3
533,30,16,36,52,2,0.3
534,30,9,17,26,2,0.3
535,30,6,42,48,2,0.3
536,30,4,15,19,2,0.3
537,30,5,12,17,2,0.3
538,30,8,11,19,2,0.3
539,30,45,18,63,2,0.3
540,30,30,30,60,2,0.3
541,30,6,19,25,2,0.3
542,30,23,31,54,2,0.3
543,30,45,59,104,2,0.3
544,30,22,34,56,2,0.3
545,30,24,54,78,2,0.3
546,30,17,44,61,2,0.3
547,30,11,11,22,2,0.3
548,30,32,86,118,2,0.3
549,30,7,27,34,2,0.3
550,30,20,76,96,2,0.3
551,30,27,39,66,2,0.3
552,30,6,20,26,2,0.3
553,30,5,9,14,2,0.3
554,30,9,9,18,2,0.3
555,30,5,8,13,2,0.3
556,30,2,16,18,2,0.3
557,30,15,31,46,2,0.3
558,30,2,1,3,2,0.3
559,30,29,36,65,2,0.3
560,30,19,19,38,2,0.3
561,30,5,2,7,2,0.3
562,30,28,36,64,2,0.3
563,30,19,50,69,2,0.3
564,30,10,22,32,2,0.3
565,30,20,54,74,2,0.3
566,30,19,7,26,2,0.3
567,30,39,46,85,2,0.3
568,30,28,47,75,2,0.3
569,30,14,38,52,2,0.3
570,30,49,26,75,2,0.3
571,30,8,23,31,2,0.3
572,30,82,142,224,2,0.3
573,30,8,17,25,2,0.3
574,30,0,3,3,2,0.3
575,30,17,29,46,2,0.3
576,30,5,6,11,2,0.3
577,30,10,30,40,2,0.3
578,30,17,53,70,2,0.3
579,30,2,5,7,2,0.3
580,30,27,64,91,2,0.3
581,30,18,41,59,2,0.3
582,30,9,14,23,2,0.3
583,30,25,56,81,2,0.3
584,30,14,23,37,2,0.3
585,30,31,60,91,2,0.3
586,30,17,53,70,2,0.3
587,30,16,52,68,2,0.3
588,30,11,40,51,2,0.3
589,30,14,18,32,2,0.3
590,30,8,16,24,2,0.3
591,30,2,7,9,2,0.3
592,30,16,39,55,2,0.3
593,30,6,10,16,2,0.3
594,30,22,65,87,2,0.3
595,30,16,10,26,2,0.3
596,30,70,93,163,2,0.3
597,30,36,50,86,2,0.3
598,30,33,75,108,2,0.3
599,30,32,71,103,2,0.3
600,30,19,54,73,2,0.3
601,30,5,16,21,2,0.3
602,30,3,13,16,2,0.3
603,30,2,1,3,2,0.3
604,30,6,2,8,2,0.3
605,30,39,49,88,2,0.3
606,30,34,44,78,2,0.3
607,30,42,151,193,2,0.3
608,30,12,32,44,2,0.3
609,30,28,31,59,2,0.3
610,30,11,24,35,2,0.3
611,30,7,17,24,2,0.3
612,30,4,14,18,2,0.3
613,30,12,29,41,2,0.3
614,30,2,12,14,2,0.3
615,30,23,50,73,2,0.3
616,30,11,28,39,2,0.3
617,30,48,104,152,2,0.3
618,30,13,21,34,2,0.3
619,30,24,67,91,2,0.3
620,30,26,49,75,2,0.3
621,30,30,64,94,2,0.3
622,30,10,19,29,2,0.3
623,30,28,26,54,2,0.3
624,30,17,21,38,2,0.3
625,30,2,14,16,2,0.3
626,30,3,5,8,2,0.3
627,30,7,12,19,2,0.3
628,30,3,14,17,2,0.3
629,30,25,46,71,2,0.3
630,30,55,76,131,2,0.3
631,30,73,111,184,2,0.3
632,30,39,134,173,2,0.3
633,30,40,77,117,2,0.3
634,30,14,20,34,2,0.3
635,30,46,74,120,2,0.3
636,30,46,53,99,2,0.3
637,30,25,63,88,2,0.3
638,30,22,26,48,2,0.3
639,30,22,34,56,2,0.3
640,30,17,25,42,2,0.3
641,30,16,19,35,2,0.3
642,30,2,9,11,2,0.3
643,30,24,30,54,2,0.3
644,30,5,9,14,2,0.3
645,30,2,2,4,2,0.3
646,30,8,21,29,2,0.3
647,30,3,10,13,2,0.3
648,30,32,120,152,2,0.3
649,30,21,62,83,2,0.3
650,30,5,21,26,2,0.3
651,30,6,15,21,2,0.3
652,30,4,13,17,2,0.3
653,30,15,52,67,2,0.3
654,30,20,40,60,2,0.3
655,30,25,48,73,2,0.3
656,30,11,23,34,2,0.3
657,30,11,14,25,2,0.3
658,30,4,7,11,2,0.3
659,30,19,53,72,2,0.3
660,30,25,54,79,2,0.3
661,30,30,50,80,2,0.3
662,30,4,5,9,2,0.3
663,30,45,89,134,2,0.3
664,30,35,54,89,2,0.3
665,30,63,139,202,2,0.3
666,30,28,59,87,2,0.3
667,30,15,60,75,2,0.3
668,30,26,100,126,2,0.3
669,30,34,47,81,2,0.3
670,30,34,38,72,2,0.3
671,30,22,62,84,2,0.3
672,30,19,49,68,2,0.3
673,30,9,22,31,2,0.3
674,30,20,27,47,2,0.3
675,30,0,4,4,2,0.3
676,30,8,27,35,2,0.3
677,30,4,10,14,2,0.3
678,30,2,0,2,2,0.3
679,30,63,76,139,2,0.3
680,30,46,55,101,2,0.3
681,30,73,144,217,2,0.3
682,30,52,96,148,2,0.3
683,30,12,44,56,2,0.3
684,30,17,57,74,2,0.3
685,30,37,68,105,2,0.3
686,30,39,50,89,2,0.3
687,30,6,10,16,2,0.3
688,30,2,0,2,2,0.3
689,30,46,135,181,2,0.3
690,30,22,100,122,2,0.3
691,30,59,128,187,2,0.3
692,30,13,32,45,2,0.3
693,30,34,121,155,2,0.3
694,30,31,67,98,2,0.3
695,30,15,29,44,2,0.3
696,30,15,29,44,2,0.3
697,30,15,23,38,2,0.3
698,30,15,21,36,2,0.3
699,30,35,34,69,2,0.3
700,30,4,19,23,2,0.3
701,30,16,68,84,2,0.3
702,30,47,95,142,2,0.3
703,30,90,214,304,2,0.3
704,30,62,123,185,2,0.3
705,30,35,84,119,2,0.3
706,30,44,60,104,2,0.3
707,30,19,70,89,2,0.3
708,30,22,71,93,2,0.3
709,30,32,56,88,2,0.3
710,30,13,31,44,2,0.3
711,30,62,130,192,2,0.3
712,30,27,81,108,2,0.3
713,30,18,61,79,2,0.3
714,30,28,24,52,2,0.3
715,30,32,83,115,2,0.3
716,30,20,44,64,2,0.3
717,30,8,34,42,2,0.3
718,30,4,13,17,2,0.3
719,30,14,28,42,2,0.3
720,30,86,33,119,2,0.3
721,30,26,66,92,2,0.3
722,30,14,38,52,2,0.3
723,30,16,29,45,2,0.3
724,30,51,150,201,2,0.3
725,30,24,52,76,2,0.3
726,30,21,103,124,2,0.3
727,30,12,28,40,2,0.3
728,30,22,37,59,2,0.3
729,30,9,22,31,2,0.3
730,30,45,115,160,2,0.3
731,30,7,3,10,2,0.3
732,30,4,16,20,2,0.3
733,30,9,12,21,2,0.3
734,30,2,11,13,2,0.3
735,30,0,0,0,2,0.3
736,30,31,77,108,2,0.3
737,30,27,92,119,2,0.3
738,30,12,34,46,2,0.3
739,30,18,40,58,2,0.3
740,30,51,88,139,2,0.3
741,30,56,99,155,2,0.3
742,30,20,41,61,2,0.3
743,30,18,20,38,2,0.3
744,30,3,8,11,2,0.3
745,30,8,19,27,2,0.3
746,30,3,2,5,2,0.3
747,30,14,13,27,2,0.3
748,30,2,6,8,2,0.3
749,30,9,11,20,2,0.3
750,30,49,112,161,2,0.3
751,30,28,55,83,2,0.3
752,30,43,49,92,2,0.3
753,30,15,18,33,2,0.3
754,30,31,75,106,2,0.3
755,30,5,19,24,2,0.3
756,30,4,10,14,2,0.3
757,30,36,59,95,2,0.3
758,30,10,21,31,2,0.3
759,30,13,19,32,2,0.3
760,30,10,31,41,2,0.3
761,30,9,17,26,2,0.3
762,30,10,29,39,2,0.3
763,30,35,40,75,2,0.3
764,30,25,37,62,2,0.3
765,30,4,57,61,2,0.3
766,30,57,76,133,2,0.3
767,30,15,48,63,2,0.3
768,30,9,23,32,2,0.3
769,30,11,21,32,2,0.3
770,30,8,6,14,2,0.3
771,30,12,15,27,2,0.3
772,30,49,83,132,2,0.3
773,30,8,8,16,2,0.3
774,30,16,17,33,2,0.3
775,30,8,6,14,2,0.3
776,30,10,17,27,2,0.3
777,30,16,28,44,2,0.3
778,30,2,12,14,2,0.3
779,30,50,94,144,2,0.3
780,30,31,56,87,2,0.3
781,30,3,10,13,2,0.3
782,30,35,45,80,2,0.3
783,30,18,46,64,2,0.3
784,30,23,31,54,2,0.3
785,30,20,30,50,2,0.3
786,30,10,37,47,2,0.3
787,30,23,27,50,2,0.3
788,30,5,16,21,2,0.3
789,30,16,46,62,2,0.3
790,30,11,51,62,2,0.3
791,30,1,4,5,2,0.3
792,30,48,136,184,2,0.3
793,30,47,104,151,2,0.3
794,30,33,144,177,2,0.3
795,30,40,76,116,2,0.3
796,30,33,87,120,2,0.3
797,30,29,160,189,2,0.3
798,30,34,62,96,2,0.3
799,30,18,31,49,2,0.3
800,30,7,30,37,2,0.3
801,30,10,28,38,2,0.3
802,30,131,205,336,2,0.3
803,30,13,44,57,2,0.3
804,30,50,159,209,2,0.3
805,30,40,77,117,2,0.3
806,30,42,87,129,2,0.3
807,30,12,41,53,2,0.3
808,30,16,11,27,2,0.3
809,30,22,17,39,2,0.3
810,30,1,8,9,2,0.3
811,30,12,36,48,2,0.3
812,30,12,12,24,2,0.3
813,30,0,0,0,2,0.3
814,30,3,13,16,2,0.3
815,30,23,47,70,2,0.3
816,30,30,32,62,2,0.3
817,30,30,47,77,2,0.3
818,30,32,46,78,2,0.3
819,30,35,71,106,2,0.3
820,30,21,45,66,2,0.3
821,30,36,56,92,2,0.3
822,30,39,61,100,2,0.3
823,30,15,22,37,2,0.3
824,30,23,47,70,2,0.3
825,30,3,11,14,2,0.3
826,30,17,27,44,2,0.3
827,30,31,32,63,2,0.3
828,30,6,23,29,2,0.3
829,50,67,94,161,2,0.3
830,50,31,83,114,2,0.3
831,50,39,48,87,2,0.3
832,50,47,91,138,2,0.3
833,50,38,114,152,2,0.3
834,50,41,111,152,2,0.3
835,50,78,119,197,2,0.3
836,50,79,138,217,2,0.3
837,50,25,45,70,2,0.3
838,50,39,81,120,2,0.3
839,50,9,15,24,2,0.3
840,50,26,57,83,2,0.3
841,50,4,14,18,2,0.3
842,50,37,20,57,2,0.3
843,50,16,54,70,2,0.3
844,50,24,36,60,2,0.3
845,50,19,33,52,2,0.3
846,50,15,22,37,2,0.3
847,50,8,12,20,2,0.3
848,50,13,29,42,2,0.3
849,50,29,69,98,2,0.3
850,50,75,211,286,2,0.3
851,50,14,32,46,2,0.3
852,50,13,29,42,2,0.3
853,50,4,5,9,2,0.3
854,50,1,2,3,2,0.3
855,50,1,1,2,2,0.3
856,50,11,37,48,2,0.3
857,50,9,28,37,2,0.3
858,50,34,80,114,2,0.3
859,50,22,69,91,2,0.3
860,50,10,19,29,2,0.3
861,50,48,80,128,2,0.3
862,50,12,11,23,2,0.3
863,50,23,81,104,2,0.3
864,50,17,17,34,2,0.3
865,50,28,42,70,2,0.3
866,50,13,25,38,2,0.3
867,50,9,44,53,2,0.3
868,50,14,38,52,2,0.3
869,50,0,23,23,2,0.3
870,50,0,5,5,2,0.3
871,50,35,64,99,2,0.3
872,50,1,11,12,2,0.3
873,50,27,57,84,2,0.3
874,50,22,33,55,2,0.3
875,50,20,53,73,2,0.3
876,50,40,82,122,2,0.3
877,50,11,24,35,2,0.3
878,50,12,22,34,2,0.3
879,50,13,39,52,2,0.3
880,50,13,21,34,2,0.3
881,50,24,53,77,2,0.3
882,50,26,55,81,2,0.3
883,50,21,32,53,2,0.3
884,50,15,13,28,2,0.3
885,50,13,27,40,2,0.3
886,50,19,32,51,2,0.3
887,50,26,48,74,2,0.3
888,50,8,36,44,2,0.3
889,50,46,53,99,2,0.3
890,50,16,19,35,2,0.3
891,50,16,22,38,2,0.3
892,50,47,83,130,2,0.3
893,50,24,34,58,2,0.3
894,50,11,21,32,2,0.3
895,50,4,9,13,2,0.3
896,50,2,4,6,2,0.3
897,50,0,0,0,2,0.3
898,50,2,1,3,2,0.3
899,50,5,8,13,2,0.3
900,50,58,89,147,2,0.3
901,50,24,40,64,2,0.3
902,50,31,56,87,2,0.3
903,50,20,33,53,2,0.3
904,50,22,44,66,2,0.3
905,50,14,22,36,2,0.3
906,50,16,85,101,2,0.3
907,50,27,24,51,2,0.3
908,50,39,87,126,2,0.3
909,50,37,92,129,2,0.3
910,50,4,6,10,2,0.3
911,50,6,25,31,2,0.3
912,50,2,20,22,2,0.3
913,50,18,45,63,2,0.3
914,50,7,10,17,2,0.3
915,50,8,3,11,2,0.3
916,50,3,4,7,2,0.3
917,50,0,2,2,2,0.3
918,50,35,72,107,2,0.3
919,50,17,41,58,2,0.3
920,50,17,21,38,2,0.3
921,50,21,49,70,2,0.3
922,50,8,13,21,2,0.3
923,50,21,22,43,2,0.3
924,50,17,29,46,2,0.3
925,50,5,14,19,2,0.3
926,50,5,15,20,2,0.3
927,50,17,43,60,2,0.3
928,50,0,0,0,2,0.3
929,50,0,20,20,2,0.3
930,50,0,2,2,2,0.3
931,50,0,0,0,2,0.3
932,50,1,2,3,2,0.3
933,50,0,0,0,2,0.3
934,50,17,42,59,2,0.3
935,50,19,35,54,2,0.3
936,50,43,48,91,2,0.3
937,50,36,39,75,2,0.3
938,50,11,27,38,2,0.3
939,50,24,62,86,2,0.3
940,50,43,28,71,2,0.3
941,50,4,5,9,2,0.3
942,50,16,17,33,2,0.3
943,50,13,25,38,2,0.3
944,50,5,17,22,2,0.3
945,50,4,8,12,2,0.3
946,50,43,47,90,2,0.3
947,50,4,21,25,2,0.3
948,50,2,8,10,2,0.3
949,50,2,13,15,2,0.3
950,50,5,3,8,2,0.3
951,50,1,4,5,2,0.3
952,50,30,44,74,2,0.3
953,50,4,8,12,2,0.3
954,50,18,31,49,2,0.3
955,50,31,59,90,2,0.3
956,50,16,23,39,2,0.3
957,50,37,72,109,2,0.3
958,50,11,11,22,2,0.3
959,50,9,19,28,2,0.3
960,50,10,25,35,2,0.3
961,50,5,24,29,2,0.3
962,50,10,27,37,2,0.3
963,50,10,16,26,2,0.3
964,50,11,21,32,2,0.3
965,50,18,31,49,2,0.3
966,50,4,19,23,2,0.3
967,50,11,7,18,2,0.3
968,50,7,48,55,2,0.3
969,50,12,4,16,2,0.3
970,50,6,42,48,2,0.3
971,50,91,94,185,2,0.3
972,50,31,98,129,2,0.3
973,50,25,40,65,2,0.3
974,50,22,50,72,2,0.3
975,50,34,61,95,2,0.3
976,50,53,80,133,2,0.3
977,50,15,17,32,2,0.3
978,50,6,18,24,2,0.3
979,50,9,17,26,2,0.3
980,50,4,23,27,2,0.3
981,50,0,5,5,2,0.3
982,50,7,14,21,2,0.3
983,50,5,6,11,2,0.3
984,50,13,13,26,2,0.3
985,50,18,33,51,2,0.3
986,50,17,44,61,2,0.3
987,50,37,56,93,2,0.3
988,50,47,88,135,2,0.3
989,50,11,26,37,2,0.3
990,50,29,49,78,2,0.3
991,50,31,53,84,2,0.3
992,50,15,30,45,2,0.3
993,50,16,47,63,2,0.3
994,50,16,32,48,2,0.3
995,50,4,21,25,2,0.3
996,50,5,8,13,2,0.3
997,50,20,35,55,2,0.3
998,50,10,33,43,2,0.3
999,50,11,10,21,2,0.3
1000,50,10,41,51,2,0.3
1001,50,16,15,31,2,0.3
1002,50,22,24,46,2,0.3
1003,50,13,56,69,2,0.3
1004,50,18,21,39,2,0.3
1005,50,13,21,34,2,0.3
1006,50,20,14,34,2,0.3
1007,50,5,11,16,2,0.3
1008,50,9,25,34,2,0.3
1009,50,6,13,19,2,0.3
1010,50,17,28,45,2,0.3
1011,50,16,56,72,2,0.3
1012,50,26,56,82,2,0.3
1013,50,32,40,72,2,0.3
1014,50,43,64,107,2,0.3
1015,50,29,47,76,2,0.3
1016,50,23,25,48,2,0.3
1017,50,15,39,54,2,0.3
1018,50,8,20,28,2,0.3
1019,50,23,22,45,2,0.3
1020,50,10,18,28,2,0.3
1021,50,6,9,15,2,0.3
1022,50,6,26,32,2,0.3
1023,50,20,39,59,2,0.3
1024,50,9,25,34,2,0.3
1025,50,18,41,59,2,0.3
1026,50,28,50,78,2,0.3
1027,50,5,12,17,2,0.3
1028,50,8,1,9,2,0.3
1029,50,21,22,43,2,0.3
1030,50,19,54,73,2,0.3
1031,50,10,23,33,2,0.3
1032,50,10,20,30,2,0.3
1033,50,10,19,29,2,0.3
1034,50,13,13,26,2,0.3
1035,50,38,34,72,2,0.3
1036,50,23,41,64,2,0.3
1037,50,17,49,66,2,0.3
1038,50,20,16,36,2,0.3
1039,50,7,7,14,2,0.3
1040,50,34,35,69,2,0.3
1041,50,27,34,61,2,0.3
1042,50,57,76,133,2,0.3
1043,50,19,34,53,2,0.3
1044,50,10,15,25,2,0.3
1045,50,21,32,53,2,0.3
1046,50,8,14,22,2,0.3
1047,50,3,4,7,2,0.3
1048,50,9,21,30,2,0.3
1049,50,6,8,14,2,0.3
1050,50,7,8,15,2,0.3
1051,50,8,23,31,2,0.3
1052,50,25,23,48,2,0.3
1053,50,48,58,106,2,0.3
1054,50,29,69,98,2,0.3
1055,50,54,72,126,2,0.3
1056,50,20,39,59,2,0.3
1057,50,9,5,14,2,0.3
1058,50,26,59,85,2,0.3
1059,50,7,8,15,2,0.3
1060,50,40,88,128,2,0.3
1061,50,21,56,77,2,0.3
1062,50,11,25,36,2,0.3
1063,50,11,29,40,2,0.3
1064,50,24,61,85,2,0.3
1065,50,7,20,27,2,0.3
1066,50,8,10,18,2,0.3
1067,50,10,18,28,2,0.3
1068,50,18,41,59,2,0.3
1069,50,8,25,33,2,0.3
1070,50,34,86,120,2,0.3
1071,50,17,52,69,2,0.3
1072,50,9,31,40,2,0.3
1073,50,12,40,52,2,0.3
1074,50,16,35,51,2,0.3
1075,50,16,29,45,2,0.3
1076,50,22,17,39,2,0.3
1077,50,14,16,30,2,0.3
1078,50,18,39,57,2,0.3
1079,50,8,22,30,2,0.3
1080,50,46,62,108,2,0.3
1081,50,8,15,23,2,0.3
1082,50,5,15,20,2,0.3
1083,50,12,31,43,2,0.3
1084,50,34,59,93,2,0.3
1085,50,21,57,78,2,0.3
1086,50,14,42,56,2,0.3
1087,50,27,108,135,2,0.3
1088,50,28,58,86,2,0.3
1089,50,41,77,118,2,0.3
1090,50,29,31,60,2,0.3
1091,50,2,10,12,2,0.3
1092,50,11,14,25,2,0.3
1093,50,16,37,53,2,0.3
1094,50,6,5,11,2,0.3
1095,50,9,21,30,2,0.3
1096,50,10,14,24,2,0.3
1097,50,1,22,23,2,0.3
1098,50,12,49,61,2,0.3
1099,50,6,50,56,2,0.3
1100,50,2,16,18,2,0.3
1101,50,30,51,81,2,0.3
1102,50,19,35,54,2,0.3
1103,50,6,6,12,2,0.3
1104,50,3,12,15,2,0.3
1105,50,15,38,53,2,0.3
1106,50,12,26,38,2,0.3
1107,50,9,23,32,2,0.3
1108,50,0,0,0,2,0.3
1109,50,2,8,10,2,0.3
1110,50,41,47,88,2,0.3
1111,50,13,22,35,2,0.3
1112,50,28,53,81,2,0.3
1113,50,17,64,81,2,0.3
1114,50,67,96,163,2,0.3
1115,50,22,42,64,2,0.3
1116,50,15,68,83,2,0.3
1117,50,66,75,141,2,0.3
1118,50,28,45,73,2,0.3
1119,50,15,34,49,2,0.3
1120,50,10,33,43,2,0.3
1121,50,8,20,28,2,0.3
1122,50,10,22,32,2,0.3
1123,50,11,23,34,2,0.3
1124,50,2,9,11,2,0.3
1125,50,53,41,94,2,0.3
1126,50,8,18,26,2,0.3
1127,50,1,2,3,2,0.3
1128,50,58,92,150,2,0.3
1129,50,15,20,35,2,0.3
1130,50,50,76,126,2,0.3
1131,50,7,5,12,2,0.3
1132,50,69,121,190,2,0.3
1133,50,31,47,78,2,0.3
1134,50,38,39,77,2,0.3
1135,50,21,53,74,2,0.3
1136,50,5,27,32,2,0.3
1137,50,21,40,61,2,0.3
1138,50,5,2,7,2,0.3
1139,50,8,4,12,2,0.3
1140,50,18,26,44,2,0.3
1141,50,0,2,2,2,0.3
1142,50,15,27,42,2,0.3
1143,50,29,71,100,2,0.3
1144,50,11,22,33,2,0.3
1145,50,23,32,55,2,0.3
1146,50,14,30,44,2,0.3
1147,50,4,19,23,2,0.3
1148,50,16,32,48,2,0.3
1149,50,31,88,119,2,0.3
1150,50,16,19,35,2,0.3
1151,50,8,18,26,2,0.3
1152,50,16,69,85,2,0.3
1153,50,19,16,35,2,0.3
1154,50,23,42,65,2,0.3
1155,50,12,12,24,2,0.3
1156,50,1,2,3,2,0.3
1157,50,15,11,26,2,0.3
1158,50,13,20,33,2,0.3
1159,50,15,20,35,2,0.3
1160,50,26,59,85,2,0.3
1161,50,26,29,55,2,0.3
1162,50,49,63,112,2,0.3
1163,50,41,53,94,2,0.3
1164,50,4,32,36,2,0.3
1165,50,21,32,53,2,0.3
1166,50,11,23,34,2,0.3
1167,50,32,79,111,2,0.3
1168,50,32,41,73,2,0.3
1169,50,35,71,106,2,0.3
1170,50,22,34,56,2,0.3
1171,50,21,27,48,2,0.3
1172,50,9,28,37,2,0.3
1173,50,9,9,18,2,0.3
1174,50,1,4,5,2,0.3
1175,50,24,43,67,2,0.3
1176,50,1,6,7,2,0.3
1177,50,19,18,37,2,0.3
1178,50,12,36,48,2,0.3
1179,50,19,18,37,2,0.3
1180,50,18,30,48,2,0.3
1181,50,23,26,49,2,0.3
1182,50,40,68,108,2,0.3
1183,50,5,5,10,2,0.3
1184,50,16,32,48,2,0.3
1185,50,45,81,126,2,0.3
1186,50,28,76,104,2,0.3
1187,50,7,13,20,2,0.3
1188,50,17,42,59,2,0.3
1189,50,19,32,51,2,0.3
1190,50,22,29,51,2,0.3
1191,50,4,6,10,2,0.3
1192,50,9,14,23,2,0.3
1193,50,8,8,16,2,0.3
1194,50,0,7,7,2,0.3
1195,50,5,8,13,2,0.3
1196,50,3,3,6,2,0.3
1197,50,3,2,5,2,0.3
1198,50,2,4,6,2,0.3
1199,50,15,32,47,2,0.3
1200,50,40,135,175,2,0.3
1201,50,25,89,114,2,0.3
1202,50,28,70,98,2,0.3
1203,50,22,34,56,2,0.3
1204,50,11,25,36,2,0.3
1205,50,51,68,119,2,0.3
1206,50,26,30,56,2,0.3
1207,50,12,29,41,2,0.3
1208,50,7,16,23,2,0.3
1209,50,9,17,26,2,0.3
1210,50,3,7,10,2,0.3
1211,50,18,27,45,2,0.3
1212,50,25,32,57,2,0.3
1213,50,14,24,38,2,0.3
1214,50,20,57,77,2,0.3
1215,50,19,27,46,2,0.3
1216,50,13,36,49,2,0.3
1217,50,7,10,17,2,0.3
1218,50,7,40,47,2,0.3
1219,50,12,13,25,2,0.3
1220,50,5,5,10,2,0.3
1221,50,3,7,10,2,0.3
1222,50,5,2,7,2,0.3
1223,50,3,7,10,2,0.3
1224,50,2,2,4,2,0.3
1225,50,5,8,13,2,0.3
1226,50,0,0,0,2,0.3
1227,50,22,29,51,2,0.3
1228,50,28,62,90,2,0.3
1229,50,37,69,106,2,0.3
1230,50,71,82,153,2,0.3
1231,50,31,52,83,2,0.3
1232,50,7,10,17,2,0.3
1233,50,18,23,41,2,0.3
1234,50,16,28,44,2,0.3
1235,50,12,28,40,2,0.3
1236,50,42,59,101,2,0.3
1237,50,30,40,70,2,0.3
1238,50,48,104,152,2,0.3
1239,50,5,6,11,2,0.3
1240,50,4,7,11,2,0.3
1241,50,3,21,24,2,0.3
1242,50,16,34,50,2,0.3
1243,50,12,27,39,2,0.3
1244,50,32,37,69,2,0.3
1245,50,13,28,41,2,0.3
1246,50,7,8,15,2,0.3
1247,50,24,62,86,2,0.3
1248,50,27,47,74,2,0.3
1249,50,16,37,53,2,0.3
1250,50,21,33,54,2,0.3
1251,50,4,2,6,2,0.3
1252,50,2,5,7,2,0.3
1253,50,10,24,34,2,0.3
1254,50,3,1,4,2,0.3
1255,50,6,7,13,2,0.3
1256,50,3,2,5,2,0.3
1257,50,7,10,17,2,0.3
1258,50,10,28,38,2,0.3
1259,50,7,12,19,2,0.3
1260,50,19,44,63,2,0.3
1261,50,3,14,17,2,0.3
1262,50,17,39,56,2,0.3
1263,50,18,17,35,2,0.3
1264,50,7,5,12,2,0.3
1265,50,10,13,23,2,0.3
1266,50,9,6,15,2,0.3
1267,50,17,24,41,2,0.3
1268,50,26,59,85,2,0.3
1269,50,5,4,9,2,0.3
1270,50,10,13,23,2,0.3
1271,50,6,16,22,2,0.3
1272,50,4,3,7,2,0.3
1273,50,0,0,0,2,0.3
1274,50,0,0,0,2,0.3
1275,50,12,31,43,2,0.3
1276,50,2,4,6,2,0.3
1277,50,20,28,48,2,0.3
1278,50,21,55,76,2,0.3
1279,50,5,17,22,2,0.3
1280,50,25,47,72,2,0.3
1281,50,4,7,11,2,0.3
1282,50,16,33,49,2,0.3
1283,50,14,19,33,2,0.3
1284,50,17,37,54,2,0.3
1285,50,2,9,11,2,0.3
1286,50,0,2,2,2,0.3
1287,50,5,22,27,2,0.3
1288,50,1,4,5,2,0.3
1289,50,24,52,76,2,0.3
1290,50,0,6,6,2,0.3
1291,50,35,80,115,2,0.3
1292,50,3,6,9,2,0.3
1293,50,11,35,46,2,0.3
1294,50,2,7,9,2,0.3
1295,50,18,23,41,2,0.3
1296,50,37,44,81,2,0.3
1297,50,12,18,30,2,0.3
1298,50,29,28,57,2,0.3
1299,50,29,71,100,2,0.3
1300,50,29,72,101,2,0.3
1301,50,8,41,49,2,0.3
1302,50,6,4,10,2,0.3
1303,50,7,4,11,2,0.3
1304,50,0,2,2,2,0.3
1305,50,15,64,79,2,0.3
1306,50,0,2,2,2,0.3
1307,50,0,13,13,2,0.3
1308,50,52,49,101,2,0.3
1309,50,1,5,6,2,0.3
1310,50,17,29,46,2,0.3
1311,50,18,46,64,2,0.3
1312,50,11,26,37,2,0.3
1313,50,9,20,29,2,0.3
1314,50,20,63,83,2,0.3
1315,50,22,53,75,2,0.3
1316,50,14,56,70,2,0.3
1317,50,4,9,13,2,0.3
1318,50,14,31,45,2,0.3
1319,50,3,11,14,2,0.3
1320,50,7,14,21,2,0.3
1321,50,1,10,11,2,0.3
1322,50,2,9,11,2,0.3
1323,50,8,2,10,2,0.3
1324,50,0,3,3,2,0.3
1325,50,4,4,8,2,0.3
1326,50,6,11,17,2,0.3
1327,50,9,18,27,2,0.3
1328,50,1,3,4,2,0.3
1329,50,10,23,33,2,0.3
1330,50,5,23,28,2,0.3
1331,50,2,5,7,2,0.3
1332,50,7,14,21,2,0.3
1333,50,2,8,10,2,0.3
1334,50,7,16,23,2,0.3
1335,50,10,9,19,2,0.3
1336,50,12,18,30,2,0.3
1337,50,1,7,8,2,0.3
1338,50,4,2,6,2,0.3
1339,50,3,4,7,2,0.3
1340,50,2,5,7,2,0.3
1341,50,0,0,0,2,0.3
1342,50,0,0,0,2,0.3
1343,75,41,105,146,2,0.3
1344,75,18,42,60,2,0.3
1345,75,38,48,86,2,0.3
1346,75,28,39,67,2,0.3
1347,75,22,62,84,2,0.3
1348,75,24,45,69,2,0.3
1349,75,21,58,79,2,0.3
1350,75,12,33,45,2,0.3
1351,75,35,35,70,2,0.3
1352,75,24,36,60,2,0.3
1353,75,17,23,40,2,0.3
1354,75,19,34,53,2,0.3
1355,75,4,20,24,2,0.3
1356,75,21,12,33,2,0.3
1357,75,6,2,8,2,0.3
1358,75,28,80,108,2,0.3
1359,75,10,15,25,2,0.3
1360,75,61,79,140,2,0.3
1361,75,38,98,136,2,0.3
1362,75,25,77,102,2,0.3
1363,75,30,26,56,2,0.3
1364,75,39,39,78,2,0.3
1365,75,14,24,38,2,0.3
1366,75,19,24,43,2,0.3
1367,75,11,23,34,2,0.3
1368,75,36,69,105,2,0.3
1369,75,5,10,15,2,0.3
1370,75,2,20,22,2,0.3
1371,75,34,51,85,2,0.3
1372,75,45,70,115,2,0.3
1373,75,27,62,89,2,0.3
1374,75,6,12,18,2,0.3
1375,75,31,72,103,2,0.3
1376,75,15,38,53,2,0.3
1377,75,91,180,271,2,0.3
1378,75,42,93,135,2,0.3
1379,75,66,63,129,2,0.3
1380,75,41,100,141,2,0.3
1381,75,40,36,76,2,0.3
1382,75,25,54,79,2,0.3
1383,75,7,5,12,2,0.3
1384,75,8,11,19,2,0.3
1385,75,3,8,11,2,0.3
1386,75,7,34,41,2,0.3
1387,75,21,64,85,2,0.3
1388,75,42,30,72,2,0.3
1389,75,60,66,126,2,0.3
1390,75,70,89,159,2,0.3
1391,75,46,142,188,2,0.3
1392,75,28,62,90,2,0.3
1393,75,62,134,196,2,0.3
1394,75,39,38,77,2,0.3
1395,75,45,80,125,2,0.3
1396,75,25,34,59,2,0.3
1397,75,11,8,19,2,0.3
1398,75,20,30,50,2,0.3
1399,75,19,36,55,2,0.3
1400,75,3,6,9,2,0.3
1401,75,3,9,12,2,0.3
1402,75,4,6,10,2,0.3
1403,75,38,47,85,2,0.3
1404,75,33,110,143,2,0.3
1405,75,22,23,45,2,0.3
1406,75,41,40,81,2,0.3
1407,75,55,72,127,2,0.3
1408,75,116,115,231,2,0.3
1409,75,15,18,33,2,0.3
1410,75,123,119,242,2,0.3
1411,75,26,95,121,2,0.3
1412,75,23,32,55,2,0.3
1413,75,22,39,61,2,0.3
1414,75,21,63,84,2,0.3
1415,75,36,27,63,2,0.3
1416,75,10,37,47,2,0.3
1417,75,38,63,101,2,0.3
1418,75,44,62,106,2,0.3
1419,75,22,34,56,2,0.3
1420,75,4,8,12,2,0.3
1421,75,20,30,50,2,0.3
1422,75,4,18,22,2,0.3
1423,75,41,62,103,2,0.3
1424,75,3,13,16,2,0.3
1425,75,58,108,166,2,0.3
1426,75,150,124,274,2,0.3
1427,75,31,88,119,2,0.3
1428,75,37,66,103,2,0.3
1429,75,38,85,123,2,0.3
1430,75,71,97,168,2,0.3
1431,75,33,68,101,2,0.3
1432,75,40,104,144,2,0.3
1433,75,24,67,91,2,0.3
1434,75,17,44,61,2,0.3
1435,75,13,38,51,2,0.3
1436,75,17,46,63,2,0.3
1437,75,8,18,26,2,0.3
1438,75,4,6,10,2,0.3
1439,75,7,1,8,2,0.3
1440,75,24,31,55,2,0.3
1441,75,5,9,14,2,0.3
1442,75,12,17,29,2,0.3
1443,75,16,50,66,2,0.3
1444,75,27,83,110,2,0.3
1445,75,26,59,85,2,0.3
1446,75,32,76,108,2,0.3
1447,75,21,51,72,2,0.3
1448,75,30,40,70,2,0.3
1449,75,30,57,87,2,0.3
1450,75,34,69,103,2,0.3
1451,75,8,12,20,2,0.3
1452,75,4,17,21,2,0.3
1453,75,7,8,15,2,0.3
1454,75,13,8,21,2,0.3
1455,75,24,58,82,2,0.3
1456,75,11,28,39,2,0.3
1457,75,107,236,343,2,0.3
1458,75,36,173,209,2,0.3
1459,75,24,15,39,2,0.3
1460,75,88,40,128,2,0.3
1461,75,40,76,116,2,0.3
1462,75,28,38,66,2,0.3
1463,75,62,97,159,2,0.3
1464,75,20,41,61,2,0.3
1465,75,12,22,34,2,0.3
1466,75,22,23,45,2,0.3
1467,75,20,40,60,2,0.3
1468,75,23,52,75,2,0.3
1469,75,59,71,130,2,0.3
1470,75,10,25,35,2,0.3
1471,75,3,14,17,2,0.3
1472,75,42,145,187,2,0.3
1473,75,51,142,193,2,0.3
1474,75,41,69,110,2,0.3
1475,75,44,105,149,2,0.3
1476,75,48,81,129,2,0.3
1477,75,64,110,174,2,0.3
1478,75,25,32,57,2,0.3
1479,75,55,26,81,2,0.3
1480,75,19,59,78,2,0.3
1481,75,19,17,36,2,0.3
1482,75,25,33,58,2,0.3
1483,75,8,10,18,2,0.3
1484,75,8,21,29,2,0.3
1485,75,12,10,22,2,0.3
1486,75,21,61,82,2,0.3
1487,75,42,65,107,2,0.3
1488,75,15,24,39,2,0.3
1489,75,55,62,117,2,0.3
1490,75,31,63,94,2,0.3
1491,75,12,22,34,2,0.3
1492,75,17,31,48,2,0.3
1493,75,16,26,42,2,0.3
1494,75,18,8,26,2,0.3
1495,75,47,164,211,2,0.3
1496,75,47,26,73,2,0.3
1497,75,35,39,74,2,0.3
1498,75,23,43,66,2,0.3
1499,75,38,58,96,2,0.3
1500,75,30,55,85,2,0.3
1501,75,3,27,30,2,0.3
1502,75,4,5,9,2,0.3
1503,75,4,9,13,2,0.3
1504,75,78,133,211,2,0.3
1505,75,50,122,172,2,0.3
1506,75,70,324,394,2,0.3
1507,75,104,297,401,2,0.3
1508,75,84,152,236,2,0.3
1509,75,47,102,149,2,0.3
1510,75,81,245,326,2,0.3
1511,75,21,76,97,2,0.3
1512,75,25,63,88,2,0.3
1513,75,32,105,137,2,0.3
1514,75,60,147,207,2,0.3
1515,75,17,38,55,2,0.3
1516,75,60,119,179,2,0.3
1517,75,116,203,319,2,0.3
1518,75,67,78,145,2,0.3
1519,75,58,112,170,2,0.3
1520,75,72,157,229,2,0.3
1521,75,44,37,81,2,0.3
1522,75,47,64,111,2,0.3
1523,75,14,24,38,2,0.3
1524,75,24,30,54,2,0.3
1525,75,11,13,24,2,0.3
1526,75,11,24,35,2,0.3
1527,75,2,3,5,2,0.3
1528,75,30,57,87,2,0.3
1529,75,77,89,166,2,0.3
1530,75,25,34,59,2,0.3
1531,75,35,30,65,2,0.3
1532,75,45,40,85,2,0.3
1533,75,30,65,95,2,0.3
1534,75,19,43,62,2,0.3
1535,75,18,12,30,2,0.3
1536,75,10,30,40,2,0.3
1537,75,18,65,83,2,0.3
1538,75,10,29,39,2,0.3
1539,75,10,22,32,2,0.3
1540,75,4,14,18,2,0.3
1541,75,22,27,49,2,0.3
1542,75,17,25,42,2,0.3
1543,75,18,58,76,2,0.3
1544,75,30,88,118,2,0.3
1545,75,26,65,91,2,0.3
1546,75,36,97,133,2,0.3
1547,75,23,53,76,2,0.3
1548,75,31,51,82,2,0.3
1549,75,32,76,108,2,0.3
1550,75,40,71,111,2,0.3
1551,75,18,16,34,2,0.3
1552,75,3,15,18,2,0.3
1553,75,0,12,12,2,0.3
1554,75,32,112,144,2,0.3
1555,75,39,26,65,2,0.3
1556,75,46,52,98,2,0.3
1557,75,63,194,257,2,0.3
1558,75,75,240,315,2,0.3
1559,75,12,45,57,2,0.3
1560,75,29,66,95,2,0.3
1561,75,48,63,111,2,0.3
1562,75,31,49,80,2,0.3
1563,75,19,27,46,2,0.3
1564,75,29,66,95,2,0.3
1565,75,14,18,32,2,0.3
1566,75,1,16,17,2,0.3
1567,75,2,20,22,2,0.3
1568,75,2,11,13,2,0.3
1569,75,32,60,92,2,0.3
1570,75,26,53,79,2,0.3
1571,75,21,64,85,2,0.3
1572,75,13,42,55,2,0.3
1573,75,19,68,87,2,0.3
1574,75,32,39,71,2,0.3
1575,75,15,32,47,2,0.3
1576,75,10,21,31,2,0.3
1577,75,8,21,29,2,0.3
1578,75,2,15,17,2,0.3
1579,75,5,16,21,2,0.3
1580,75,61,103,164,2,0.3
1581,75,38,67,105,2,0.3
1582,75,45,111,156,2,0.3
1583,75,15,42,57,2,0.3
1584,75,70,59,129,2,0.3
1585,75,10,52,62,2,0.3
1586,75,3,9,12,2,0.3
1587,75,8,7,15,2,0.3
1588,75,0,0,0,2,0.3
1589,75,1,6,7,2,0.3
1590,75,0,0,0,2,0.3
1591,75,0,0,0,2,0.3
1592,75,5,10,15,2,0.3
1593,75,2,0,2,2,0.3
1594,75,39,88,127,2,0.3
1595,75,32,70,102,2,0.3
1596,75,62,178,240,2,0.3
1597,75,13,28,41,2,0.3
1598,75,13,22,35,2,0.3
1599,75,19,43,62,2,0.3
1600,75,37,96,133,2,0.3
1601,75,17,31,48,2,0.3
1602,75,20,28,48,2,0.3
1603,75,3,7,10,2,0.3
1604,75,3,14,17,2,0.3
1605,75,5,37,42,2,0.3
1606,75,16,38,54,2,0.3
1607,75,11,14,25,2,0.3
1608,75,23,46,69,2,0.3
1609,75,16,32,48,2,0.3
1610,75,53,80,133,2,0.3
1611,75,20,87,107,2,0.3
1612,75,26,70,96,2,0.3
1613,75,41,39,80,2,0.3
1614,75,23,56,79,2,0.3
1615,75,36,43,79,2,0.3
1616,75,28,41,69,2,0.3
1617,75,3,9,12,2,0.3
1618,75,23,59,82,2,0.3
1619,75,3,9,12,2,0.3
1620,75,55,115,170,2,0.3
1621,75,23,80,103,2,0.3
1622,75,8,21,29,2,0.3
1623,75,16,16,32,2,0.3
1624,75,21,84,105,2,0.3
1625,75,21,25,46,2,0.3
1626,75,57,104,161,2,0.3
1627,75,75,81,156,2,0.3
1628,75,67,156,223,2,0.3
1629,75,51,77,128,2,0.3
1630,75,42,88,130,2,0.3
1631,75,9,15,24,2,0.3
1632,75,2,2,4,2,0.3
1633,75,41,90,131,2,0.3
1634,75,22,108,130,2,0.3
1635,75,81,155,236,2,0.3
1636,75,48,60,108,2,0.3
1637,75,30,52,82,2,0.3
1638,75,38,76,114,2,0.3
1639,75,28,59,87,2,0.3
1640,75,56,75,131,2,0.3
1641,75,21,29,50,2,0.3
1642,75,36,45,81,2,0.3
1643,75,18,61,79,2,0.3
1644,75,24,26,50,2,0.3
1645,75,4,27,31,2,0.3
1646,75,17,9,26,2,0.3
1647,75,18,34,52,2,0.3
1648,75,172,94,266,2,0.3
1649,75,89,195,284,2,0.3
1650,75,32,78,110,2,0.3
1651,75,72,74,146,2,0.3
1652,75,89,79,168,2,0.3
1653,75,98,235,333,2,0.3
1654,75,27,52,79,2,0.3
1655,75,56,128,184,2,0.3
1656,75,48,98,146,2,0.3
1657,75,84,209,293,2,0.3
1658,75,68,106,174,2,0.3
1659,75,60,160,220,2,0.3
1660,75,39,73,112,2,0.3
1661,75,8,22,30,2,0.3
1662,75,49,124,173,2,0.3
1663,75,65,98,163,2,0.3
1664,75,64,91,155,2,0.3
1665,75,55,116,171,2,0.3
1666,75,51,105,156,2,0.3
1667,75,47,90,137,2,0.3
1668,75,59,71,130,2,0.3
1669,75,21,21,42,2,0.3
1670,75,26,97,123,2,0.3
1671,75,26,20,46,2,0.3
1672,75,12,30,42,2,0.3
1673,75,51,72,123,2,0.3
1674,75,13,36,49,2,0.3
1675,75,33,44,77,2,0.3
1676,75,20,25,45,2,0.3
1677,75,46,45,91,2,0.3
1678,75,30,35,65,2,0.3
1679,75,20,41,61,2,0.3
1680,75,37,77,114,2,0.3
1681,75,10,20,30,2,0.3
1682,75,51,32,83,2,0.3
1683,75,27,66,93,2,0.3
1684,75,14,13,27,2,0.3
1685,75,62,93,155,2,0.3
1686,75,44,60,104,2,0.3
1687,75,25,36,61,2,0.3
1688,75,6,8,14,2,0.3
1689,75,18,29,47,2,0.3
1690,75,3,5,8,2,0.3
1691,75,18,21,39,2,0.3
1692,75,6,15,21,2,0.3
1693,75,37,48,85,2,0.3
1694,75,35,65,100,2,0.3
1695,75,28,54,82,2,0.3
1696,75,37,57,94,2,0.3
1697,75,30,54,84,2,0.3
1698,75,41,46,87,2,0.3
1699,75,14,32,46,2,0.3
1700,75,18,22,40,2,0.3
1701,75,20,46,66,2,0.3
1702,75,16,18,34,2,0.3
1703,75,13,34,47,2,0.3
1704,75,28,63,91,2,0.3
1705,75,6,42,48,2,0.3
1706,75,36,46,82,2,0.3
1707,75,14,17,31,2,0.3
1708,75,16,23,39,2,0.3
1709,75,4,7,11,2,0.3
1710,75,20,58,78,2,0.3
1711,75,64,89,153,2,0.3
1712,75,45,51,96,2,0.3
1713,75,31,34,65,2,0.3
1714,75,40,50,90,2,0.3
1715,75,45,164,209,2,0.3
1716,75,31,62,93,2,0.3
1717,75,33,61,94,2,0.3
1718,75,64,107,171,2,0.3
1719,75,9,15,24,2,0.3
1720,75,23,53,76,2,0.3
1721,75,32,18,50,2,0.3
1722,75,30,41,71,2,0.3
1723,75,11,14,25,2,0.3
1724,75,42,74,116,2,0.3
1725,75,12,14,26,2,0.3
1726,75,4,16,20,2,0.3
1727,75,8,10,18,2,0.3
1728,75,28,20,48,2,0.3
1729,75,3,5,8,2,0.3
1730,75,101,130,231,2,0.3
1731,75,51,61,112,2,0.3
1732,75,71,111,182,2,0.3
1733,75,50,76,126,2,0.3
1734,75,23,49,72,2,0.3
1735,75,108,58,166,2,0.3
1736,75,24,42,66,2,0.3
1737,75,5,25,30,2,0.3
1738,75,38,41,79,2,0.3
1739,75,44,34,78,2,0.3
1740,75,24,40,64,2,0.3
1741,75,22,35,57,2,0.3
1742,75,9,16,25,2,0.3
1743,75,56,97,153,2,0.3
1744,75,39,85,124,2,0.3
1745,75,16,45,61,2,0.3
1746,75,12,28,40,2,0.3
1747,75,20,32,52,2,0.3
1748,75,91,102,193,2,0.3
1749,75,20,24,44,2,0.3
1750,75,6,15,21,2,0.3
1751,75,6,14,20,2,0.3
1752,75,12,7,19,2,0.3
1753,75,2,8,10,2,0.3
1754,75,0,5,5,2,0.3
1755,75,40,39,79,2,0.3
1756,75,18,41,59,2,0.3
1757,75,17,37,54,2,0.3
1758,75,60,75,135,2,0.3
1759,75,19,28,47,2,0.3
1760,75,22,52,74,2,0.3
1761,75,32,53,85,2,0.3
1762,75,30,53,83,2,0.3
1763,75,27,34,61,2,0.3
1764,75,21,46,67,2,0.3
1765,75,25,31,56,2,0.3
1766,75,15,45,60,2,0.3
1767,75,10,28,38,2,0.3
1768,75,7,18,25,2,0.3
1769,75,21,63,84,2,0.3
1770,75,43,76,119,2,0.3
1771,75,49,71,120,2,0.3
1772,75,61,135,196,2,0.3
1773,75,12,56,68,2,0.3
1774,75,20,51,71,2,0.3
1775,75,7,26,33,2,0.3
1776,75,33,67,100,2,0.3
1777,75,100,138,238,2,0.3
1778,75,43,47,90,2,0.3
1779,75,17,58,75,2,0.3
1780,75,23,53,76,2,0.3
1781,75,12,37,49,2,0.3
1782,75,15,37,52,2,0.3
1783,90,23,21,44,2,0.3
1784,90,35,81,116,2,0.3
1785,90,61,70,131,2,0.3
1786,90,22,24,46,2,0.3
1787,90,18,25,43,2,0.3
1788,90,27,80,107,2,0.3
1789,90,13,33,46,2,0.3
1790,90,7,20,27,2,0.3
1791,90,27,51,78,2,0.3
1792,90,14,21,35,2,0.3
1793,90,9,12,21,2,0.3
1794,90,4,22,26,2,0.3
1795,90,10,31,41,2,0.3
1796,90,11,14,25,2,0.3
1797,90,15,14,29,2,0.3
1798,90,8,14,22,2,0.3
1799,90,22,35,57,2,0.3
1800,90,41,109,150,2,0.3
1801,90,15,18,33,2,0.3
1802,90,35,40,75,2,0.3
1803,90,52,49,101,2,0.3
1804,90,34,78,112,2,0.3
1805,90,52,89,141,2,0.3
1806,90,18,41,59,2,0.3
1807,90,66,87,153,2,0.3
1808,90,17,26,43,2,0.3
1809,90,39,58,97,2,0.3
1810,90,3,8,11,2,0.3
1811,90,10,22,32,2,0.3
1812,90,5,8,13,2,0.3
1813,90,80,137,217,2,0.3
1814,90,55,201,256,2,0.3
1815,90,46,138,184,2,0.3
1816,90,20,67,87,2,0.3
1817,90,46,150,196,2,0.3
1818,90,31,14,45,2,0.3
1819,90,33,64,97,2,0.3
1820,90,20,28,48,2,0.3
1821,90,43,54,97,2,0.3
1822,90,93,166,259,2,0.3
1823,90,33,36,69,2,0.3
1824,90,12,30,42,2,0.3
1825,90,2,7,9,2,0.3
1826,90,5,5,10,2,0.3
1827,90,79,110,189,2,0.3
1828,90,38,59,97,2,0.3
1829,90,18,15,33,2,0.3
1830,90,25,56,81,2,0.3
1831,90,21,41,62,2,0.3
1832,90,59,69,128,2,0.3
1833,90,18,25,43,2,0.3
1834,90,15,14,29,2,0.3
1835,90,37,23,60,2,0.3
1836,90,35,12,47,2,0.3
1837,90,6,18,24,2,0.3
1838,90,33,34,67,2,0.3
1839,90,8,22,30,2,0.3
1840,90,37,36,73,2,0.3
1841,90,3,4,7,2,0.3
1842,90,19,34,53,2,0.3
1843,90,10,28,38,2,0.3
1844,90,36,66,102,2,0.3
1845,90,72,149,221,2,0.3
1846,90,63,63,126,2,0.3
1847,90,23,49,72,2,0.3
1848,90,36,58,94,2,0.3
1849,90,29,118,147,2,0.3
1850,90,17,37,54,2,0.3
1851,90,4,17,21,2,0.3
1852,90,23,38,61,2,0.3
1853,90,26,56,82,2,0.3
1854,90,13,11,24,2,0.3
1855,90,11,27,38,2,0.3
1856,90,5,6,11,2,0.3
1857,90,4,7,11,2,0.3
1858,90,14,21,35,2,0.3
1859,90,25,130,155,2,0.3
1860,90,43,70,113,2,0.3
1861,90,51,64,115,2,0.3
1862,90,22,75,97,2,0.3
1863,90,46,73,119,2,0.3
1864,90,42,79,121,2,0.3
1865,90,39,61,100,2,0.3
1866,90,71,73,144,2,0.3
1867,90,32,62,94,2,0.3
1868,90,28,62,90,2,0.3
1869,90,34,51,85,2,0.3
1870,90,9,24,33,2,0.3
1871,90,11,21,32,2,0.3
1872,90,18,44,62,2,0.3
1873,90,54,68,122,2,0.3
1874,90,24,73,97,2,0.3
1875,90,18,68,86,2,0.3
1876,90,42,106,148,2,0.3
1877,90,51,73,124,2,0.3
1878,90,55,94,149,2,0.3
1879,90,13,66,79,2,0.3
1880,90,15,14,29,2,0.3
1881,90,52,51,103,2,0.3
1882,90,63,120,183,2,0.3
1883,90,3,19,22,2,0.3
1884,90,2,15,17,2,0.3
1885,90,3,7,10,2,0.3
1886,90,39,87,126,2,0.3
1887,90,52,39,91,2,0.3
1888,90,58,125,183,2,0.3
1889,90,9,26,35,2,0.3
1890,90,64,141,205,2,0.3
1891,90,66,146,212,2,0.3
1892,90,38,96,134,2,0.3
1893,90,26,45,71,2,0.3
1894,90,14,30,44,2,0.3
1895,90,48,107,155,2,0.3
1896,90,14,39,53,2,0.3
1897,90,4,8,12,2,0.3
1898,90,19,24,43,2,0.3
1899,90,10,19,29,2,0.3
1900,90,9,20,29,2,0.3
1901,90,14,11,25,2,0.3
1902,90,3,12,15,2,0.3
1903,90,4,3,7,2,0.3
1904,90,9,5,14,2,0.3
1905,90,23,44,67,2,0.3
1906,90,16,26,42,2,0.3
1907,90,188,133,321,2,0.3
1908,90,25,38,63,2,0.3
1909,90,85,141,226,2,0.3
1910,90,25,45,70,2,0.3
1911,90,31,63,94,2,0.3
1912,90,9,23,32,2,0.3
1913,90,32,40,72,2,0.3
1914,90,4,6,10,2,0.3
1915,90,8,17,25,2,0.3
1916,90,7,26,33,2,0.3
1917,90,3,3,6,2,0.3
1918,90,35,93,128,2,0.3
1919,90,45,107,152,2,0.3
1920,90,5,11,16,2,0.3
1921,90,45,84,129,2,0.3
1922,90,46,229,275,2,0.3
1923,90,15,27,42,2,0.3
1924,90,65,76,141,2,0.3
1925,90,27,72,99,2,0.3
1926,90,14,28,42,2,0.3
1927,90,20,24,44,2,0.3
1928,90,27,32,59,2,0.3
1929,90,13,27,40,2,0.3
1930,90,6,10,16,2,0.3
1931,90,38,33,71,2,0.3
1932,90,8,8,16,2,0.3
1933,90,14,47,61,2,0.3
1934,90,16,60,76,2,0.3
1935,90,51,158,209,2,0.3
1936,90,32,47,79,2,0.3
1937,90,36,34,70,2,0.3
1938,90,16,42,58,2,0.3
1939,90,19,22,41,2,0.3
1940,90,14,22,36,2,0.3
1941,90,11,14,25,2,0.3
1942,90,20,24,44,2,0.3
1943,90,17,22,39,2,0.3
1944,90,20,25,45,2,0.3
1945,90,8,8,16,2,0.3
1946,90,10,18,28,2,0.3
1947,90,29,14,43,2,0.3
1948,90,32,67,99,2,0.3
1949,90,50,89,139,2,0.3
1950,90,54,112,166,2,0.3
1951,90,30,39,69,2,0.3
1952,90,26,87,113,2,0.3
1953,90,27,45,72,2,0.3
1954,90,8,60,68,2,0.3
1955,90,45,81,126,2,0.3
1956,90,10,9,19,2,0.3
1957,90,15,21,36,2,0.3
1958,90,12,19,31,2,0.3
1959,90,7,21,28,2,0.3
1960,90,6,11,17,2,0.3
1961,90,2,7,9,2,0.3
1962,90,0,9,9,2,0.3
1963,90,20,53,73,2,0.3
1964,90,78,113,191,2,0.3
1965,90,58,96,154,2,0.3
1966,90,19,72,91,2,0.3
1967,90,46,52,98,2,0.3
1968,90,23,83,106,2,0.3
1969,90,20,81,101,2,0.3
1970,90,49,87,136,2,0.3
1971,90,16,20,36,2,0.3
1972,90,2,27,29,2,0.3
1973,90,19,19,38,2,0.3
1974,90,24,17,41,2,0.3
1975,90,11,24,35,2,0.3
1976,90,9,17,26,2,0.3
1977,90,15,40,55,2,0.3
1978,90,32,119,151,2,0.3
1979,90,72,61,133,2,0.3
1980,90,24,82,106,2,0.3
1981,90,20,33,53,2,0.3
1982,90,18,55,73,2,0.3
1983,90,54,86,140,2,0.3
1984,90,10,32,42,2,0.3
1985,90,7,12,19,2,0.3
1986,90,5,9,14,2,0.3
1987,90,13,26,39,2,0.3
1988,90,4,16,20,2,0.3
1989,90,23,45,68,2,0.3
1990,90,68,85,153,2,0.3
1991,90,31,55,86,2,0.3
1992,90,9,56,65,2,0.3
1993,90,38,46,84,2,0.3
1994,90,65,48,113,2,0.3
1995,90,20,24,44,2,0.3
1996,90,22,64,86,2,0.3
1997,90,21,51,72,2,0.3
1998,90,11,23,34,2,0.3
1999,90,5,17,22,2,0.3
2000,90,7,10,17,2,0.3
2001,90,17,27,44,2,0.3
2002,90,4,23,27,2,0.3
2003,90,28,68,96,2,0.3
2004,90,21,40,61,2,0.3
2005,90,34,39,73,2,0.3
2006,90,34,33,67,2,0.3
2007,90,34,41,75,2,0.3
2008,90,53,79,132,2,0.3
2009,90,20,41,61,2,0.3
2010,90,24,14,38,2,0.3
2011,90,2,44,46,2,0.3
2012,90,30,31,61,2,0.3
2013,90,23,25,48,2,0.3
2014,90,45,40,85,2,0.3
2015,90,16,20,36,2,0.3
2016,90,9,11,20,2,0.3
2017,90,10,13,23,2,0.3
2018,90,24,61,85,2,0.3
2019,90,17,13,30,2,0.3
2020,90,11,17,28,2,0.3
2021,90,5,10,15,2,0.3
2022,90,3,11,14,2,0.3
2023,90,2,2,4,2,0.3
2024,90,25,42,67,2,0.3
2025,90,59,108,167,2,0.3
2026,90,30,82,112,2,0.3
2027,90,45,142,187,2,0.3
2028,90,35,80,115,2,0.3
2029,90,18,13,31,2,0.3
2030,90,38,66,104,2,0.3
2031,90,95,170,265,2,0.3
2032,90,71,93,164,2,0.3
2033,90,5,16,21,2,0.3
2034,90,32,68,100,2,0.3
2035,90,44,49,93,2,0.3
2036,90,46,80,126,2,0.3
2037,90,33,65,98,2,0.3
2038,90,21,30,51,2,0.3
2039,90,21,24,45,2,0.3
2040,90,35,56,91,2,0.3
2041,90,20,28,48,2,0.3
2042,90,1,4,5,2,0.3
2043,90,26,45,71,2,0.3
2044,90,8,15,23,2,0.3
2045,90,20,21,41,2,0.3
2046,90,9,17,26,2,0.3
2047,90,20,16,36,2,0.3
2048,90,34,44,78,2,0.3
2049,90,26,51,77,2,0.3
2050,90,28,87,115,2,0.3
2051,90,34,56,90,2,0.3
2052,90,29,22,51,2,0.3
2053,90,48,62,110,2,0.3
2054,90,44,129,173,2,0.3
2055,90,32,48,80,2,0.3
2056,90,24,48,72,2,0.3
2057,90,10,22,32,2,0.3
2058,90,21,30,51,2,0.3
2059,90,15,27,42,2,0.3
2060,90,16,23,39,2,0.3
2061,90,35,55,90,2,0.3
2062,90,36,82,118,2,0.3
2063,90,35,66,101,2,0.3
2064,90,57,73,130,2,0.3
2065,90,68,139,207,2,0.3
2066,90,9,12,21,2,0.3
2067,90,114,191,305,2,0.3
2068,90,13,62,75,2,0.3
2069,90,99,132,231,2,0.3
2070,90,42,84,126,2,0.3
2071,90,98,185,283,2,0.3
2072,90,43,86,129,2,0.3
2073,90,28,29,57,2,0.3
2074,90,47,75,122,2,0.3
2075,90,9,33,42,2,0.3
2076,90,37,55,92,2,0.3
2077,90,21,45,66,2,0.3
2078,90,5,7,12,2,0.3
2079,90,26,58,84,2,0.3
2080,90,31,52,83,2,0.3
2081,90,24,25,49,2,0.3
2082,90,14,56,70,2,0.3
2083,90,13,23,36,2,0.3
2084,90,14,48,62,2,0.3
2085,90,30,36,66,2,0.3
2086,90,22,43,65,2,0.3
2087,90,15,52,67,2,0.3
2088,90,14,27,41,2,0.3
2089,90,16,77,93,2,0.3
2090,90,39,41,80,2,0.3
2091,90,28,38,66,2,0.3
2092,90,16,32,48,2,0.3
2093,90,46,94,140,2,0.3
2094,90,44,62,106,2,0.3
2095,90,70,109,179,2,0.3
2096,90,13,27,40,2,0.3
2097,90,34,100,134,2,0.3
2098,90,21,25,46,2,0.3
2099,90,12,41,53,2,0.3
2100,90,3,5,8,2,0.3
2101,90,14,20,34,2,0.3
2102,90,10,18,28,2,0.3
2103,90,24,38,62,2,0.3
2104,90,18,12,30,2,0.3
2105,90,3,2,5,2,0.3
2106,90,15,13,28,2,0.3
2107,90,6,7,13,2,0.3
2108,90,1,7,8,2,0.3
2109,90,12,12,24,2,0.3
2110,90,20,17,37,2,0.3
2111,90,15,18,33,2,0.3
2112,90,17,30,47,2,0.3
2113,90,21,20,41,2,0.3
2114,90,9,26,35,2,0.3
2115,90,14,21,35,2,0.3
2116,90,7,6,13,2,0.3
2117,90,3,2,5,2,0.3
2118,90,9,20,29,2,0.3
2119,90,6,11,17,2,0.3
2120,90,2,8,10,2,0.3
2121,90,1,2,3,2,0.3
2122,90,3,66,69,2,0.3
2123,90,0,12,12,2,0.3
2124,90,49,48,97,2,0.3
2125,90,53,145,198,2,0.3
2126,90,43,60,103,2,0.3
2127,90,33,54,87,2,0.3
2128,90,21,58,79,2,0.3
2129,90,36,44,80,2,0.3
2130,90,21,56,77,2,0.3
2131,90,45,71,116,2,0.3
2132,90,3,10,13,2,0.3
2133,90,13,26,39,2,0.3
2134,90,37,27,64,2,0.3
2135,90,29,23,52,2,0.3
2136,90,2,3,5,2,0.3
2137,90,68,124,192,2,0.3
2138,90,11,11,22,2,0.3
2139,90,32,28,60,2,0.3
2140,90,35,106,141,2,0.3
2141,90,22,48,70,2,0.3
2142,90,38,101,139,2,0.3
2143,90,36,60,96,2,0.3
2144,90,32,49,81,2,0.3
2145,90,38,67,105,2,0.3
2146,90,21,46,67,2,0.3
2147,90,22,20,42,2,0.3
2148,90,86,130,216,2,0.3
2149,90,42,68,110,2,0.3
2150,90,23,25,48,2,0.3
2151,90,1,1,2,2,0.3
2152,90,21,15,36,2,0.3
2153,90,36,69,105,2,0.3
2154,90,32,51,83,2,0.3
2155,90,49,87,136,2,0.3
2156,90,8,8,16,2,0.3
2157,90,28,39,67,2,0.3
2158,90,22,24,46,2,0.3
2159,90,19,30,49,2,0.3
2160,90,20,42,62,2,0.3
2161,90,9,19,28,2,0.3
2162,90,21,22,43,2,0.3
2163,90,17,5,22,2,0.3
2164,90,8,26,34,2,0.3
2165,90,8,5,13,2,0.3
2166,90,23,29,52,2,0.3
2167,90,1,2,3,2,0.3
2168,90,22,42,64,2,0.3
2169,90,24,29,53,2,0.3
2170,90,14,54,68,2,0.3
2171,90,53,64,117,2,0.3
2172,90,20,45,65,2,0.3
2173,90,19,69,88,2,0.3
2174,90,36,51,87,2,0.3
2175,90,58,153,211,2,0.3
2176,90,26,25,51,2,0.3
2177,90,103,138,241,2,0.3
2178,90,14,39,53,2,0.3
2179,90,5,13,18,2,0.3
2180,90,11,21,32,2,0.3
2181,90,9,23,32,2,0.3
2182,90,36,69,105,2,0.3
2183,90,23,67,90,2,0.3
2184,90,38,118,156,2,0.3
2185,90,10,43,53,2,0.3
2186,90,20,52,72,2,0.3
2187,90,7,12,19,2,0.3
2188,90,23,34,57,2,0.3
2189,90,8,17,25,2,0.3
2190,90,10,12,22,2,0.3
2191,90,12,18,30,2,0.3
2192,90,13,34,47,2,0.3
2193,90,12,44,56,2,0.3
2194,90,12,47,59,2,0.3
2195,90,0,2,2,2,0.3
2196,90,37,49,86,2,0.3
2197,90,23,41,64,2,0.3
2198,90,60,100,160,2,0.3
2199,90,31,44,75,2,0.3
2200,90,26,37,63,2,0.3
2201,90,54,85,139,2,0.3
2202,90,13,27,40,2,0.3
2203,90,78,33,111,2,0.3
2204,90,10,30,40,2,0.3
2205,90,20,53,73,2,0.3
2206,90,13,30,43,2,0.3
2207,90,7,9,16,2,0.3
2208,90,8,13,21,2,0.3
2209,90,6,4,10,2,0.3
2210,90,23,44,67,2,0.3
2211,90,27,31,58,2,0.3
2212,90,24,71,95,2,0.3
2213,90,57,64,121,2,0.3
2214,90,22,28,50,2,0.3
2215,90,23,74,97,2,0.3
2216,90,54,80,134,2,0.3
2217,90,49,61,110,2,0.3
2218,90,34,20,54,2,0.3
2219,90,16,29,45,2,0.3
2220,90,10,6,16,2,0.3
2221,90,5,8,13,2,0.3
2222,90,11,26,37,2,0.3
2223,90,32,23,55,2,0.3
2224,90,22,28,50,2,0.3
2225,90,6,5,11,2,0.3
2226,90,22,18,40,2,0.3
2227,90,11,14,25,2,0.3
2228,90,5,4,9,2,0.3
2229,120,18,25,43,2,0.3
2230,120,23,62,85,2,0.3
2231,120,25,81,106,2,0.3
2232,120,27,37,64,2,0.3
2233,120,25,33,58,2,0.3
2234,120,23,21,44,2,0.3
2235,120,33,40,73,2,0.3
2236,120,23,28,51,2,0.3
2237,120,11,44,55,2,0.3
2238,120,6,16,22,2,0.3
2239,120,8,13,21,2,0.3
2240,120,83,150,233,2,0.3
2241,120,71,125,196,2,0.3
2242,120,66,161,227,2,0.3
2243,120,128,244,372,2,0.3
2244,120,85,270,355,2,0.3
2245,120,71,165,236,2,0.3
2246,120,16,27,43,2,0.3
2247,120,9,12,21,2,0.3
2248,120,24,40,64,2,0.3
2249,120,64,87,151,2,0.3
2250,120,18,39,57,2,0.3
2251,120,3,15,18,2,0.3
2252,120,29,57,86,2,0.3
2253,120,19,64,83,2,0.3
2254,120,19,61,80,2,0.3
2255,120,59,51,110,2,0.3
2256,120,52,59,111,2,0.3
2257,120,11,43,54,2,0.3
2258,120,27,37,64,2,0.3
2259,120,26,20,46,2,0.3
2260,120,8,18,26,2,0.3
2261,120,33,69,102,2,0.3
2262,120,26,30,56,2,0.3
2263,120,20,23,43,2,0.3
2264,120,7,14,21,2,0.3
2265,120,7,19,26,2,0.3
2266,120,9,17,26,2,0.3
2267,120,6,11,17,2,0.3
2268,120,1,2,3,2,0.3
2269,120,39,117,156,2,0.3
2270,120,34,79,113,2,0.3
2271,120,34,78,112,2,0.3
2272,120,38,100,138,2,0.3
2273,120,45,93,138,2,0.3
2274,120,22,51,73,2,0.3
2275,120,63,113,176,2,0.3
2276,120,28,51,79,2,0.3
2277,120,30,37,67,2,0.3
2278,120,14,38,52,2,0.3
2279,120,26,46,72,2,0.3
2280,120,11,11,22,2,0.3
2281,120,25,42,67,2,0.3
2282,120,24,44,68,2,0.3
2283,120,18,64,82,2,0.3
2284,120,13,29,42,2,0.3
2285,120,23,52,75,2,0.3
2286,120,31,61,92,2,0.3
2287,120,16,62,78,2,0.3
2288,120,16,30,46,2,0.3
2289,120,23,33,56,2,0.3
2290,120,6,10,16,2,0.3
2291,120,26,57,83,2,0.3
2292,120,4,13,17,2,0.3
2293,120,27,40,67,2,0.3
2294,120,26,63,89,2,0.3
2295,120,23,17,40,2,0.3
2296,120,29,75,104,2,0.3
2297,120,32,54,86,2,0.3
2298,120,40,106,146,2,0.3
2299,120,22,24,46,2,0.3
2300,120,10,28,38,2,0.3
2301,120,25,27,52,2,0.3
2302,120,92,77,169,2,0.3
2303,120,16,39,55,2,0.3
2304,120,21,31,52,2,0.3
2305,120,20,30,50,2,0.3
2306,120,14,12,26,2,0.3
2307,120,98,182,280,2,0.3
2308,120,73,162,235,2,0.3
2309,120,36,54,90,2,0.3
2310,120,28,30,58,2,0.3
2311,120,46,108,154,2,0.3
2312,120,21,38,59,2,0.3
2313,120,25,59,84,2,0.3
2314,120,41,97,138,2,0.3
2315,120,48,65,113,2,0.3
2316,120,12,18,30,2,0.3
2317,120,19,40,59,2,0.3
2318,120,14,21,35,2,0.3
2319,120,4,9,13,2,0.3
2320,120,43,141,184,2,0.3
2321,120,20,16,36,2,0.3
2322,120,29,51,80,2,0.3
2323,120,22,19,41,2,0.3
2324,120,35,65,100,2,0.3
2325,120,10,43,53,2,0.3
2326,120,18,82,100,2,0.3
2327,120,13,26,39,2,0.3
2328,120,116,207,323,2,0.3
2329,120,41,61,102,2,0.3
2330,120,12,10,22,2,0.3
2331,120,10,32,42,2,0.3
2332,120,19,20,39,2,0.3
2333,120,5,16,21,2,0.3
2334,120,2,4,6,2,0.3
2335,120,64,125,189,2,0.3
2336,120,21,50,71,2,0.3
2337,120,46,61,107,2,0.3
2338,120,31,70,101,2,0.3
2339,120,40,98,138,2,0.3
2340,120,16,17,33,2,0.3
2341,120,21,27,48,2,0.3
2342,120,27,28,55,2,0.3
2343,120,10,15,25,2,0.3
2344,120,12,18,30,2,0.3
2345,120,6,12,18,2,0.3
2346,120,13,6,19,2,0.3
2347,120,46,62,108,2,0.3
2348,120,10,36,46,2,0.3
2349,120,24,65,89,2,0.3
2350,120,12,17,29,2,0.3
2351,120,20,65,85,2,0.3
2352,120,65,77,142,2,0.3
2353,120,22,34,56,2,0.3
2354,120,69,64,133,2,0.3
2355,120,11,29,40,2,0.3
2356,120,21,44,65,2,0.3
2357,120,31,42,73,2,0.3
2358,120,28,28,56,2,0.3
2359,120,7,6,13,2,0.3
2360,120,10,18,28,2,0.3
2361,120,3,10,13,2,0.3
2362,120,89,118,207,2,0.3
2363,120,60,92,152,2,0.3
2364,120,19,32,51,2,0.3
2365,120,36,48,84,2,0.3
2366,120,43,57,100,2,0.3
2367,120,30,103,133,2,0.3
2368,120,20,36,56,2,0.3
2369,120,60,79,139,2,0.3
2370,120,25,40,65,2,0.3
2371,120,26,40,66,2,0.3
2372,120,21,57,78,2,0.3
2373,120,30,57,87,2,0.3
2374,120,30,52,82,2,0.3
2375,120,6,25,31,2,0.3
2376,120,42,56,98,2,0.3
2377,120,26,133,159,2,0.3
2378,120,22,23,45,2,0.3
2379,120,53,89,142,2,0.3
2380,120,47,81,128,2,0.3
2381,120,42,175,217,2,0.3
2382,120,32,21,53,2,0.3
2383,120,34,116,150,2,0.3
2384,120,81,117,198,2,0.3
2385,120,27,77,104,2,0.3
2386,120,43,29,72,2,0.3
2387,120,31,48,79,2,0.3
2388,120,28,53,81,2,0.3
2389,120,10,14,24,2,0.3
2390,120,5,17,22,2,0.3
2391,120,4,17,21,2,0.3
2392,120,29,50,79,2,0.3
2393,120,31,107,138,2,0.3
2394,120,38,51,89,2,0.3
2395,120,16,54,70,2,0.3
2396,120,36,55,91,2,0.3
2397,120,34,104,138,2,0.3
2398,120,27,46,73,2,0.3
2399,120,53,73,126,2,0.3
2400,120,22,87,109,2,0.3
2401,120,16,92,108,2,0.3
2402,120,42,79,121,2,0.3
2403,120,24,17,41,2,0.3
2404,120,14,27,41,2,0.3
2405,120,8,14,22,2,0.3
2406,120,12,24,36,2,0.3
2407,120,44,49,93,2,0.3
2408,120,29,75,104,2,0.3
2409,120,26,55,81,2,0.3
2410,120,41,44,85,2,0.3
2411,120,13,20,33,2,0.3
2412,120,24,26,50,2,0.3
2413,120,22,60,82,2,0.3
2414,120,34,48,82,2,0.3
2415,120,30,34,64,2,0.3
2416,120,4,9,13,2,0.3
2417,120,6,0,6,2,0.3
2418,120,54,99,153,2,0.3
2419,120,30,10,40,2,0.3
2420,120,57,117,174,2,0.3
2421,120,37,113,150,2,0.3
2422,120,33,100,133,2,0.3
2423,120,35,68,103,2,0.3
2424,120,8,38,46,2,0.3
2425,120,10,10,20,2,0.3
2426,120,75,70,145,2,0.3
2427,120,72,81,153,2,0.3
2428,120,10,29,39,2,0.3
2429,120,15,17,32,2,0.3
2430,120,34,68,102,2,0.3
2431,120,38,92,130,2,0.3
2432,120,33,107,140,2,0.3
2433,120,33,95,128,2,0.3
2434,120,27,36,63,2,0.3
2435,120,18,70,88,2,0.3
2436,120,59,91,150,2,0.3
2437,120,4,4,8,2,0.3
2438,120,17,28,45,2,0.3
2439,120,10,11,21,2,0.3
2440,120,10,17,27,2,0.3
2441,120,14,15,29,2,0.3
2442,120,20,8,28,2,0.3
2443,120,8,11,19,2,0.3
2444,120,9,11,20,2,0.3
2445,120,1,9,10,2,0.3
2446,120,31,94,125,2,0.3
2447,120,56,144,200,2,0.3
2448,120,13,37,50,2,0.3
2449,120,60,73,133,2,0.3
2450,120,32,29,61,2,0.3
2451,120,70,119,189,2,0.3
2452,120,27,31,58,2,0.3
2453,120,34,62,96,2,0.3
2454,120,47,64,111,2,0.3
2455,120,16,16,32,2,0.3
2456,120,7,16,23,2,0.3
2457,120,4,6,10,2,0.3
2458,120,7,11,18,2,0.3
2459,120,10,21,31,2,0.3
2460,120,24,91,115,2,0.3
2461,120,21,81,102,2,0.3
2462,120,49,176,225,2,0.3
2463,120,55,102,157,2,0.3
2464,120,14,40,54,2,0.3
2465,120,55,50,105,2,0.3
2466,120,26,51,77,2,0.3
2467,120,22,36,58,2,0.3
2468,120,21,29,50,2,0.3
2469,120,6,18,24,2,0.3
2470,120,12,27,39,2,0.3
2471,120,4,15,19,2,0.3
2472,120,31,69,100,2,0.3
2473,120,31,106,137,2,0.3
2474,120,83,105,188,2,0.3
2475,120,12,38,50,2,0.3
2476,120,30,56,86,2,0.3
2477,120,19,88,107,2,0.3
2478,120,48,85,133,2,0.3
2479,120,25,29,54,2,0.3
2480,120,16,40,56,2,0.3
2481,120,7,8,15,2,0.3
2482,120,5,10,15,2,0.3
2483,120,2,9,11,2,0.3
2484,120,22,56,78,2,0.3
2485,120,6,10,16,2,0.3
2486,120,8,17,25,2,0.3
2487,120,19,37,56,2,0.3
2488,120,14,32,46,2,0.3
2489,120,10,11,21,2,0.3
2490,120,0,3,3,2,0.3
2491,120,86,135,221,2,0.3
2492,120,44,61,105,2,0.3
2493,120,44,48,92,2,0.3
2494,120,41,141,182,2,0.3
2495,120,35,91,126,2,0.3
2496,120,27,40,67,2,0.3
2497,120,7,20,27,2,0.3
2498,120,12,19,31,2,0.3
2499,120,5,7,12,2,0.3
2500,120,23,13,36,2,0.3
2501,120,12,21,33,2,0.3
2502,120,52,123,175,2,0.3
2503,120,85,182,267,2,0.3
2504,120,24,39,63,2,0.3
2505,120,44,98,142,2,0.3
2506,120,18,60,78,2,0.3
2507,120,20,57,77,2,0.3
2508,120,27,85,112,2,0.3
2509,120,9,13,22,2,0.3
2510,120,6,9,15,2,0.3
2511,120,15,17,32,2,0.3
2512,120,32,68,100,2,0.3
2513,120,14,46,60,2,0.3
2514,120,38,71,109,2,0.3
2515,120,50,77,127,2,0.3
2516,120,15,56,71,2,0.3
2517,120,18,40,58,2,0.3
2518,120,82,151,233,2,0.3
2519,120,10,10,20,2,0.3
2520,120,50,101,151,2,0.3
2521,120,16,21,37,2,0.3
2522,120,23,53,76,2,0.3
2523,120,7,16,23,2,0.3
2524,120,28,34,62,2,0.3
2525,120,9,32,41,2,0.3
2526,120,28,88,116,2,0.3
2527,120,53,266,319,2,0.3
2528,120,50,158,208,2,0.3
2529,120,55,146,201,2,0.3
2530,120,24,50,74,2,0.3
2531,120,19,74,93,2,0.3
2532,120,19,37,56,2,0.3
2533,120,37,136,173,2,0.3
2534,120,5,28,33,2,0.3
2535,120,3,12,15,2,0.3
2536,120,24,53,77,2,0.3
2537,120,6,26,32,2,0.3
2538,120,7,5,12,2,0.3
2539,120,6,21,27,2,0.3
2540,120,3,8,11,2,0.3
2541,120,43,145,188,2,0.3
2542,120,70,148,218,2,0.3
2543,120,25,49,74,2,0.3
2544,120,40,115,155,2,0.3
2545,120,16,36,52,2,0.3
2546,120,33,92,125,2,0.3
2547,120,25,61,86,2,0.3
2548,120,7,13,20,2,0.3
2549,120,11,15,26,2,0.3
2550,120,12,7,19,2,0.3
2551,120,0,11,11,2,0.3
2552,120,48,115,163,2,0.3
2553,120,51,166,217,2,0.3
2554,120,25,57,82,2,0.3
2555,120,33,141,174,2,0.3
2556,120,26,103,129,2,0.3
2557,120,25,74,99,2,0.3
2558,120,31,83,114,2,0.3
2559,120,41,89,130,2,0.3
2560,120,17,51,68,2,0.3
2561,120,4,21,25,2,0.3
2562,120,10,17,27,2,0.3
2563,120,7,26,33,2,0.3
2564,120,24,32,56,2,0.3
2565,120,9,7,16,2,0.3
2566,120,117,278,395,2,0.3
2567,120,88,127,215,2,0.3
2568,120,58,133,191,2,0.3
2569,120,11,31,42,2,0.3
2570,120,59,169,228,2,0.3
2571,120,12,57,69,2,0.3
2572,120,38,69,107,2,0.3
2573,120,31,15,46,2,0.3
2574,120,54,61,115,2,0.3
2575,120,34,74,108,2,0.3
2576,120,32,66,98,2,0.3
2577,120,19,39,58,2,0.3
2578,120,24,36,60,2,0.3
2579,120,8,17,25,2,0.3
2580,120,40,48,88,2,0.3
2581,120,12,40,52,2,0.3
2582,120,25,75,100,2,0.3
2583,120,26,50,76,2,0.3
2584,120,61,156,217,2,0.3
2585,120,29,64,93,2,0.3
2586,120,24,26,50,2,0.3
2587,120,22,30,52,2,0.3
2588,120,34,52,86,2,0.3
2589,120,13,21,34,2,0.3
2590,120,15,31,46,2,0.3
2591,120,9,25,34,2,0.3
2592,120,0,3,3,2,0.3
2593,120,23,38,61,2,0.3
2594,120,19,81,100,2,0.3
2595,120,68,95,163,2,0.3
2596,120,42,87,129,2,0.3
2597,120,9,16,25,2,0.3
2598,120,19,21,40,2,0.3
2599,120,22,36,58,2,0.3
2600,120,21,51,72,2,0.3
2601,120,13,39,52,2,0.3
2602,120,20,37,57,2,0.3
2603,120,5,6,11,2,0.3
2604,120,6,6,12,2,0.3
2605,120,1,6,7,2,0.3
2606,120,64,148,212,2,0.3
2607,120,29,62,91,2,0.3
2608,120,194,168,362,2,0.3
2609,120,3,48,51,2,0.3
2610,120,46,84,130,2,0.3
2611,120,36,86,122,2,0.3
2612,120,13,17,30,2,0.3
2613,120,16,36,52,2,0.3
2614,120,21,53,74,2,0.3
2615,120,19,28,47,2,0.3
2616,120,17,51,68,2,0.3
2617,120,5,3,8,2,0.3
2618,120,12,12,24,2,0.3
2619,120,0,2,2,2,0.3
2620,120,0,0,0,2,0.3
2621,120,3,2,5,2,0.3
2622,180,57,87,144,2,0.3
2623,180,13,24,37,2,0.3
2624,180,11,33,44,2,0.3
2625,180,41,89,130,2,0.3
2626,180,18,8,26,2,0.3
2627,180,18,31,49,2,0.3
2628,180,11,25,36,2,0.3
2629,180,18,18,36,2,0.3
2630,180,15,35,50,2,0.3
2631,180,6,13,19,2,0.3
2632,180,14,22,36,2,0.3
2633,180,11,31,42,2,0.3
2634,180,9,1,10,2,0.3
2635,180,1,4,5,2,0.3
2636,180,27,162,189,2,0.3
2637,180,21,107,128,2,0.3
2638,180,2,3,5,2,0.3
2639,180,45,42,87,2,0.3
2640,180,27,62,89,2,0.3
2641,180,31,85,116,2,0.3
2642,180,38,56,94,2,0.3
2643,180,51,96,147,2,0.3
2644,180,30,46,76,2,0.3
2645,180,13,57,70,2,0.3
2646,180,36,64,100,2,0.3
2647,180,24,26,50,2,0.3
2648,180,25,26,51,2,0.3
2649,180,12,24,36,2,0.3
2650,180,25,60,85,2,0.3
2651,180,65,140,205,2,0.3
2652,180,36,90,126,2,0.3
2653,180,12,52,64,2,0.3
2654,180,76,108,184,2,0.3
2655,180,72,109,181,2,0.3
2656,180,8,23,31,2,0.3
2657,180,19,40,59,2,0.3
2658,180,42,39,81,2,0.3
2659,180,33,58,91,2,0.3
2660,180,4,22,26,2,0.3
2661,180,10,8,18,2,0.3
2662,180,37,110,147,2,0.3
2663,180,89,122,211,2,0.3
2664,180,30,171,201,2,0.3
2665,180,15,41,56,2,0.3
2666,180,32,49,81,2,0.3
2667,180,22,35,57,2,0.3
2668,180,29,77,106,2,0.3
2669,180,13,6,19,2,0.3
2670,180,14,30,44,2,0.3
2671,180,21,21,42,2,0.3
2672,180,30,89,119,2,0.3
2673,180,67,97,164,2,0.3
2674,180,38,50,88,2,0.3
2675,180,52,127,179,2,0.3
2676,180,28,52,80,2,0.3
2677,180,76,125,201,2,0.3
2678,180,29,35,64,2,0.3
2679,180,52,78,130,2,0.3
2680,180,14,47,61,2,0.3
2681,180,8,11,19,2,0.3
2682,180,47,173,220,2,0.3
2683,180,46,30,76,2,0.3
2684,180,26,50,76,2,0.3
2685,180,26,50,76,2,0.3
2686,180,36,99,135,2,0.3
2687,180,33,94,127,2,0.3
2688,180,28,38,66,2,0.3
2689,180,15,68,83,2,0.3
2690,180,25,42,67,2,0.3
2691,180,19,42,61,2,0.3
2692,180,9,37,46,2,0.3
2693,180,18,23,41,2,0.3
2694,180,1,7,8,2,0.3
2695,180,15,20,35,2,0.3
2696,180,80,135,215,2,0.3
2697,180,56,179,235,2,0.3
2698,180,46,157,203,2,0.3
2699,180,19,47,66,2,0.3
2700,180,30,97,127,2,0.3
2701,180,10,24,34,2,0.3
2702,180,45,55,100,2,0.3
2703,180,42,71,113,2,0.3
2704,180,16,32,48,2,0.3
2705,180,37,49,86,2,0.3
2706,180,40,99,139,2,0.3
2707,180,12,20,32,2,0.3
2708,180,23,11,34,2,0.3
2709,180,30,75,105,2,0.3
2710,180,29,39,68,2,0.3
2711,180,48,128,176,2,0.3
2712,180,37,43,80,2,0.3
2713,180,23,72,95,2,0.3
2714,180,11,27,38,2,0.3
2715,180,8,14,22,2,0.3
2716,180,7,9,16,2,0.3
2717,180,8,36,44,2,0.3
2718,180,22,31,53,2,0.3
2719,180,3,3,6,2,0.3
2720,180,8,22,30,2,0.3
2721,180,2,12,14,2,0.3
2722,180,1,2,3,2,0.3
2723,180,25,100,125,2,0.3
2724,180,22,57,79,2,0.3
2725,180,21,80,101,2,0.3
2726,180,30,62,92,2,0.3
2727,180,51,70,121,2,0.3
2728,180,11,22,33,2,0.3
2729,180,27,14,41,2,0.3
2730,180,9,46,55,2,0.3
2731,180,30,26,56,2,0.3
2732,180,9,11,20,2,0.3
2733,180,13,27,40,2,0.3
2734,180,17,30,47,2,0.3
2735,180,31,139,170,2,0.3
2736,180,53,144,197,2,0.3
2737,180,52,141,193,2,0.3
2738,180,15,28,43,2,0.3
2739,180,42,79,121,2,0.3
2740,180,45,124,169,2,0.3
2741,180,27,79,106,2,0.3
2742,180,27,115,142,2,0.3
2743,180,59,149,208,2,0.3
2744,180,25,79,104,2,0.3
2745,180,8,31,39,2,0.3
2746,180,31,60,91,2,0.3
2747,180,11,27,38,2,0.3
2748,180,37,55,92,2,0.3
2749,180,13,48,61,2,0.3
2750,180,51,62,113,2,0.3
2751,180,37,55,92,2,0.3
2752,180,21,20,41,2,0.3
2753,180,13,58,71,2,0.3
2754,180,12,7,19,2,0.3
2755,180,1,3,4,2,0.3
2756,180,12,22,34,2,0.3
2757,180,5,22,27,2,0.3
2758,180,17,11,28,2,0.3
2759,180,4,2,6,2,0.3
2760,180,8,9,17,2,0.3
2761,180,14,9,23,2,0.3
2762,180,40,28,68,2,0.3
2763,180,25,99,124,2,0.3
2764,180,27,74,101,2,0.3
2765,180,24,45,69,2,0.3
2766,180,24,65,89,2,0.3
2767,180,33,67,100,2,0.3
2768,180,31,60,91,2,0.3
2769,180,27,52,79,2,0.3
2770,180,8,55,63,2,0.3
2771,180,7,8,15,2,0.3
2772,180,17,39,56,2,0.3
2773,180,5,21,26,2,0.3
2774,180,4,10,14,2,0.3
2775,180,18,29,47,2,0.3
2776,180,1,2,3,2,0.3
2777,180,2,5,7,2,0.3
2778,180,37,56,93,2,0.3
2779,180,68,109,177,2,0.3
2780,180,31,60,91,2,0.3
2781,180,19,75,94,2,0.3
2782,180,17,27,44,2,0.3
2783,180,30,53,83,2,0.3
2784,180,29,48,77,2,0.3
2785,180,7,13,20,2,0.3
2786,180,15,17,32,2,0.3
2787,180,13,24,37,2,0.3
2788,180,5,9,14,2,0.3
2789,180,48,51,99,2,0.3
2790,180,49,110,159,2,0.3
2791,180,14,19,33,2,0.3
2792,180,36,56,92,2,0.3
2793,180,30,45,75,2,0.3
2794,180,26,34,60,2,0.3
2795,180,9,14,23,2,0.3
2796,180,10,35,45,2,0.3
2797,180,5,14,19,2,0.3
2798,180,5,21,26,2,0.3
2799,180,3,4,7,2,0.3
2800,180,3,9,12,2,0.3
2801,180,0,0,0,2,0.3
2802,180,1,12,13,2,0.3
2803,180,4,23,27,2,0.3
2804,180,9,10,19,2,0.3
2805,180,72,82,154,2,0.3
2806,180,13,52,65,2,0.3
2807,180,36,150,186,2,0.3
2808,180,28,35,63,2,0.3
2809,180,9,34,43,2,0.3
2810,180,23,77,100,2,0.3
2811,180,37,66,103,2,0.3
2812,180,7,7,14,2,0.3
2813,180,21,62,83,2,0.3
2814,180,27,25,52,2,0.3
2815,180,8,20,28,2,0.3
2816,180,4,13,17,2,0.3
2817,180,3,1,4,2,0.3
2818,180,51,81,132,2,0.3
2819,180,38,82,120,2,0.3
2820,180,21,28,49,2,0.3
2821,180,27,81,108,2,0.3
2822,180,33,100,133,2,0.3
2823,180,47,110,157,2,0.3
2824,180,31,87,118,2,0.3
2825,180,40,51,91,2,0.3
2826,180,23,71,94,2,0.3
2827,180,13,25,38,2,0.3
2828,180,11,24,35,2,0.3
2829,180,10,46,56,2,0.3
2830,180,4,14,18,2,0.3
2831,180,1,1,2,2,0.3
2832,180,19,4,23,2,0.3
2833,180,48,128,176,2,0.3
2834,180,14,25,39,2,0.3
2835,180,28,81,109,2,0.3
2836,180,68,229,297,2,0.3
2837,180,39,65,104,2,0.3
2838,180,43,108,151,2,0.3
2839,180,16,38,54,2,0.3
2840,180,10,18,28,2,0.3
2841,180,25,43,68,2,0.3
2842,180,7,20,27,2,0.3
2843,180,3,10,13,2,0.3
2844,180,5,9,14,2,0.3
2845,180,26,47,73,2,0.3
2846,180,33,119,152,2,0.3
2847,180,27,42,69,2,0.3
2848,180,7,9,16,2,0.3
2849,180,9,41,50,2,0.3
2850,180,8,23,31,2,0.3
2851,180,11,31,42,2,0.3
2852,180,21,5,26,2,0.3
2853,180,6,34,40,2,0.3
2854,180,4,7,11,2,0.3
2855,180,5,12,17,2,0.3
2856,180,6,14,20,2,0.3
2857,180,9,45,54,2,0.3
2858,180,14,27,41,2,0.3
2859,180,13,57,70,2,0.3
2860,180,20,56,76,2,0.3
2861,180,11,32,43,2,0.3
2862,180,16,41,57,2,0.3
2863,180,3,27,30,2,0.3
2864,180,33,43,76,2,0.3
2865,180,14,21,35,2,0.3
2866,180,6,25,31,2,0.3
2867,180,6,10,16,2,0.3
2868,180,10,31,41,2,0.3
2869,180,0,0,0,2,0.3
2870,180,12,43,55,2,0.3
2871,180,49,107,156,2,0.3
2872,180,25,101,126,2,0.3
2873,180,44,127,171,2,0.3
2874,180,18,57,75,2,0.3
2875,180,22,89,111,2,0.3
2876,180,12,40,52,2,0.3
2877,180,40,134,174,2,0.3
2878,180,25,79,104,2,0.3
2879,180,4,24,28,2,0.3
2880,180,34,68,102,2,0.3
2881,180,29,57,86,2,0.3
2882,180,2,8,10,2,0.3
2883,180,7,8,15,2,0.3
2884,180,5,12,17,2,0.3
2885,180,18,18,36,2,0.3
2886,180,22,68,90,2,0.3
2887,180,14,12,26,2,0.3
2888,180,12,44,56,2,0.3
2889,180,20,79,99,2,0.3
2890,180,23,26,49,2,0.3
2891,180,22,83,105,2,0.3
2892,180,41,60,101,2,0.3
2893,180,22,50,72,2,0.3
2894,180,17,66,83,2,0.3
2895,180,12,13,25,2,0.3
2896,180,27,37,64,2,0.3
2897,180,20,44,64,2,0.3
2898,180,7,16,23,2,0.3
2899,180,40,31,71,2,0.3
2900,180,5,14,19,2,0.3
2901,180,1,7,8,2,0.3
2902,180,8,17,25,2,0.3
2903,180,0,6,6,2,0.3
2904,180,13,17,30,2,0.3
2905,180,16,26,42,2,0.3
2906,180,31,61,92,2,0.3
2907,180,15,24,39,2,0.3
2908,180,19,46,65,2,0.3
2909,180,58,108,166,2,0.3
2910,180,10,28,38,2,0.3
2911,180,10,16,26,2,0.3
2912,180,14,50,64,2,0.3
2913,180,5,15,20,2,0.3
2914,180,7,31,38,2,0.3
2915,180,20,49,69,2,0.3
2916,180,9,20,29,2,0.3
2917,180,2,5,7,2,0.3
2918,180,11,27,38,2,0.3
2919,180,44,101,145,2,0.3
2920,180,47,173,220,2,0.3
2921,180,8,76,84,2,0.3
2922,180,56,146,202,2,0.3
2923,180,34,102,136,2,0.3
2924,180,11,12,23,2,0.3
2925,180,23,39,62,2,0.3
2926,180,12,6,18,2,0.3
2927,180,41,98,139,2,0.3
2928,180,3,4,7,2,0.3
2929,180,16,34,50,2,0.3
2930,180,5,1,6,2,0.3
2931,180,1,4,5,2,0.3
2932,180,1,2,3,2,0.3
2933,180,47,77,124,2,0.3
2934,180,53,80,133,2,0.3
2935,180,83,95,178,2,0.3
2936,180,63,169,232,2,0.3
2937,180,46,82,128,2,0.3
2938,180,69,40,109,2,0.3
2939,180,24,83,107,2,0.3
2940,180,31,152,183,2,0.3
2941,180,29,100,129,2,0.3
2942,180,29,41,70,2,0.3
2943,180,21,66,87,2,0.3
2944,180,16,43,59,2,0.3
2945,180,7,24,31,2,0.3
2946,180,2,12,14,2,0.3
2947,180,5,3,8,2,0.3
2948,180,23,78,101,2,0.3
2949,180,6,5,11,2,0.3
2950,180,17,103,120,2,0.3
2951,180,42,98,140,2,0.3
2952,180,29,50,79,2,0.3
2953,180,22,45,67,2,0.3
2954,180,28,65,93,2,0.3
2955,180,13,30,43,2,0.3
2956,180,13,20,33,2,0.3
2957,180,4,12,16,2,0.3
2958,180,1,2,3,2,0.3
2959,180,0,0,0,2,0.3
2960,180,1,1,2,2,0.3
2961,180,0,0,0,2,0.3
2962,180,7,54,61,2,0.3
2963,180,45,36,81,2,0.3
2964,180,28,72,100,2,0.3
2965,180,13,33,46,2,0.3
2966,180,45,88,133,2,0.3
2967,180,20,69,89,2,0.3
2968,180,14,17,31,2,0.3
2969,180,58,157,215,2,0.3
2970,180,26,83,109,2,0.3
2971,180,8,29,37,2,0.3
2972,180,6,9,15,2,0.3
2973,180,13,21,34,2,0.3
2974,180,7,12,19,2,0.3
2975,180,3,8,11,2,0.3
2976,180,6,7,13,2,0.3
2977,180,59,165,224,2,0.3
2978,180,55,185,240,2,0.3
2979,180,55,224,279,2,0.3
2980,180,70,97,167,2,0.3
2981,180,26,121,147,2,0.3
2982,180,16,77,93,2,0.3
2983,180,31,52,83,2,0.3
2984,180,19,14,33,2,0.3
2985,180,23,46,69,2,0.3
2986,180,12,25,37,2,0.3
2987,180,18,27,45,2,0.3
2988,180,16,8,24,2,0.3
2989,180,3,13,16,2,0.3
2990,180,0,4,4,2,0.3
2991,180,35,73,108,2,0.3
2992,180,16,39,55,2,0.3
2993,180,26,74,100,2,0.3
2994,180,40,73,113,2,0.3
2995,180,12,44,56,2,0.3
2996,180,30,44,74,2,0.3
2997,180,6,12,18,2,0.3
2998,180,26,14,40,2,0.3
2999,180,6,5,11,2,0.3
3000,180,1,2,3,2,0.3
3001,180,0,4,4,2,0.3
3002,180,5,1,6,2,0.3
3003,180,1,1,2,2,0.3
3004,180,25,73,98,2,0.3
3005,180,55,166,221,2,0.3
3006,180,38,118,156,2,0.3
3007,180,81,106,187,2,0.3
3008,180,56,114,170,2,0.3
3009,180,60,186,246,2,0.3
3010,180,19,46,65,2,0.3
3011,180,36,132,168,2,0.3
3012,180,9,18,27,2,0.3
3013,180,15,56,71,2,0.3
3014,180,14,40,54,2,0.3
3015,180,15,37,52,2,0.3
3016,180,6,9,15,2,0.3
3017,180,6,19,25,2,0.3
3018,180,18,90,108,2,0.3
3019,180,10,21,31,2,0.3
3020,180,0,0,0,2,0.3
3021,180,16,27,43,2,0.3
3022,180,9,23,32,2,0.3
3023,180,18,25,43,2,0.3
3024,180,27,41,68,2,0.3
3025,180,18,28,46,2,0.3
3026,180,13,25,38,2,0.3
3027,180,10,22,32,2,0.3
3028,180,28,50,78,2,0.3
3029,180,1,28,29,2,0.3
3030,180,0,2,2,2,0.3
3031,180,2,4,6,2,0.3
3032,30,41,71,112,2,1.0
3033,30,23,51,74,2,1.0
3034,30,13,30,43,2,1.0
3035,30,11,43,54,2,1.0
3036,30,40,73,113,2,1.0
3037,30,61,74,135,2,1.0
3038,30,14,38,52,2,1.0
3039,30,8,7,15,2,1.0
3040,30,10,38,48,2,1.0
3041,30,2,0,2,2,1.0
3042,30,2,5,7,2,1.0
3043,30,4,4,8,2,1.0
3044,30,25,53,78,2,1.0
3045,30,15,20,35,2,1.0
3046,30,6,37,43,2,1.0
3047,30,46,115,161,2,1.0
3048,30,48,69,117,2,1.0
3049,30,9,30,39,2,1.0
3050,30,24,60,84,2,1.0
3051,30,56,89,145,2,1.0
3052,30,11,56,67,2,1.0
3053,30,8,19,27,2,1.0
3054,30,2,6,8,2,1.0
3055,30,13,11,24,2,1.0
3056,30,53,62,115,2,1.0
3057,30,62,151,213,2,1.0
3058,30,55,162,217,2,1.0
3059,30,45,188,233,2,1.0
3060,30,67,152,219,2,1.0
3061,30,35,69,104,2,1.0
3062,30,35,61,96,2,1.0
3063,30,49,82,131,2,1.0
3064,30,4,28,32,2,1.0
3065,30,20,24,44,2,1.0
3066,30,20,34,54,2,1.0
3067,30,4,17,21,2,1.0
3068,30,15,19,34,2,1.0
3069,30,3,3,6,2,1.0
3070,30,44,78,122,2,1.0
3071,30,59,61,120,2,1.0
3072,30,29,31,60,2,1.0
3073,30,24,65,89,2,1.0
3074,30,23,30,53,2,1.0
3075,30,50,90,140,2,1.0
3076,30,18,24,42,2,1.0
3077,30,44,60,104,2,1.0
3078,30,27,36,63,2,1.0
3079,30,22,26,48,2,1.0
3080,30,9,17,26,2,1.0
3081,30,29,58,87,2,1.0
3082,30,13,24,37,2,1.0
3083,30,4,8,12,2,1.0
3084,30,17,33,50,2,1.0
3085,30,14,8,22,2,1.0
3086,30,2,9,11,2,1.0
3087,30,2,3,5,2,1.0
3088,30,3,4,7,2,1.0
3089,30,36,58,94,2,1.0
3090,30,20,22,42,2,1.0
3091,30,39,54,93,2,1.0
3092,30,25,23,48,2,1.0
3093,30,12,35,47,2,1.0
3094,30,10,13,23,2,1.0
3095,30,6,10,16,2,1.0
3096,30,29,50,79,2,1.0
3097,30,14,18,32,2,1.0
3098,30,45,54,99,2,1.0
3099,30,7,8,15,2,1.0
3100,30,4,7,11,2,1.0
3101,30,4,15,19,2,1.0
3102,30,3,6,9,2,1.0
3103,30,20,28,48,2,1.0
3104,30,2,6,8,2,1.0
3105,30,49,44,93,2,1.0
3106,30,42,55,97,2,1.0
3107,30,13,54,67,2,1.0
3108,30,32,32,64,2,1.0
3109,30,21,66,87,2,1.0
3110,30,57,98,155,2,1.0
3111,30,19,34,53,2,1.0
3112,30,24,28,52,2,1.0
3113,30,11,28,39,2,1.0
3114,30,19,22,41,2,1.0
3115,30,4,4,8,2,1.0
3116,30,11,12,23,2,1.0
3117,30,5,6,11,2,1.0
3118,30,12,31,43,2,1.0
3119,30,4,8,12,2,1.0
3120,30,43,39,82,2,1.0
3121,30,23,45,68,2,1.0
3122,30,61,106,167,2,1.0
3123,30,5,10,15,2,1.0
3124,30,40,44,84,2,1.0
3125,30,35,61,96,2,1.0
3126,30,8,17,25,2,1.0
3127,30,18,25,43,2,1.0
3128,30,29,68,97,2,1.0
3129,30,15,30,45,2,1.0
3130,30,6,21,27,2,1.0
3131,30,11,15,26,2,1.0
3132,30,19,10,29,2,1.0
3133,30,5,9,14,2,1.0
3134,30,11,8,19,2,1.0
3135,30,8,6,14,2,1.0
3136,30,9,9,18,2,1.0
3137,30,43,44,87,2,1.0
3138,30,36,39,75,2,1.0
3139,30,36,49,85,2,1.0
3140,30,17,79,96,2,1.0
3141,30,35,44,79,2,1.0
3142,30,33,46,79,2,1.0
3143,30,17,73,90,2,1.0
3144,30,7,42,49,2,1.0
3145,30,15,40,55,2,1.0
3146,30,21,36,57,2,1.0
3147,30,12,18,30,2,1.0
3148,30,7,7,14,2,1.0
3149,30,11,38,49,2,1.0
3150,30,19,37,56,2,1.0
3151,30,23,34,57,2,1.0
3152,30,42,114,156,2,1.0
3153,30,38,27,65,2,1.0
3154,30,38,107,145,2,1.0
3155,30,42,99,141,2,1.0
3156,30,39,82,121,2,1.0
3157,30,11,29,40,2,1.0
3158,30,29,24,53,2,1.0
3159,30,24,51,75,2,1.0
3160,30,15,23,38,2,1.0
3161,30,25,14,39,2,1.0
3162,30,27,69,96,2,1.0
3163,30,30,76,106,2,1.0
3164,30,27,80,107,2,1.0
3165,30,28,88,116,2,1.0
3166,30,53,65,118,2,1.0
3167,30,11,15,26,2,1.0
3168,30,61,60,121,2,1.0
3169,30,1,5,6,2,1.0
3170,30,2,15,17,2,1.0
3171,30,4,15,19,2,1.0
3172,30,15,84,99,2,1.0
3173,30,23,138,161,2,1.0
3174,30,47,71,118,2,1.0
3175,30,9,32,41,2,1.0
3176,30,47,128,175,2,1.0
3177,30,40,81,121,2,1.0
3178,30,23,18,41,2,1.0
3179,30,11,46,57,2,1.0
3180,30,46,46,92,2,1.0
3181,30,27,54,81,2,1.0
3182,30,24,35,59,2,1.0
3183,30,47,125,172,2,1.0
3184,30,17,15,32,2,1.0
3185,30,30,52,82,2,1.0
3186,30,4,3,7,2,1.0
3187,30,12,17,29,2,1.0
3188,30,10,6,16,2,1.0
3189,30,11,14,25,2,1.0
3190,30,5,6,11,2,1.0
3191,30,9,14,23,2,1.0
3192,30,1,7,8,2,1.0
3193,30,27,88,115,2,1.0
3194,30,40,155,195,2,1.0
3195,30,9,25,34,2,1.0
3196,30,4,4,8,2,1.0
3197,30,50,92,142,2,1.0
3198,30,11,20,31,2,1.0
3199,30,33,56,89,2,1.0
3200,30,21,31,52,2,1.0
3201,30,16,24,40,2,1.0
3202,30,16,28,44,2,1.0
3203,30,2,7,9,2,1.0
3204,30,4,4,8,2,1.0
3205,30,54,88,142,2,1.0
3206,30,13,9,22,2,1.0
3207,30,20,99,119,2,1.0
3208,30,6,13,19,2,1.0
3209,30,26,39,65,2,1.0
3210,30,32,59,91,2,1.0
3211,30,12,7,19,2,1.0
3212,30,31,29,60,2,1.0
3213,30,8,22,30,2,1.0
3214,30,6,12,18,2,1.0
3215,30,11,31,42,2,1.0
3216,30,39,53,92,2,1.0
3217,30,3,2,5,2,1.0
3218,30,40,61,101,2,1.0
3219,30,7,20,27,2,1.0
3220,30,50,121,171,2,1.0
3221,30,35,38,73,2,1.0
3222,30,70,66,136,2,1.0
3223,30,25,49,74,2,1.0
3224,30,14,39,53,2,1.0
3225,30,12,54,66,2,1.0
3226,30,5,19,24,2,1.0
3227,30,8,45,53,2,1.0
3228,30,4,27,31,2,1.0
3229,30,19,19,38,2,1.0
3230,30,19,53,72,2,1.0
3231,30,9,20,29,2,1.0
3232,30,11,45,56,2,1.0
3233,30,4,11,15,2,1.0
3234,30,3,18,21,2,1.0
3235,30,41,179,220,2,1.0
3236,30,18,83,101,2,1.0
3237,30,41,67,108,2,1.0
3238,30,58,197,255,2,1.0
3239,30,26,46,72,2,1.0
3240,30,36,139,175,2,1.0
3241,30,11,60,71,2,1.0
3242,30,9,18,27,2,1.0
3243,30,8,12,20,2,1.0
3244,30,17,20,37,2,1.0
3245,30,51,72,123,2,1.0
3246,30,40,100,140,2,1.0
3247,30,33,64,97,2,1.0
3248,30,27,45,72,2,1.0
3249,30,60,116,176,2,1.0
3250,30,14,28,42,2,1.0
3251,30,21,22,43,2,1.0
3252,30,20,34,54,2,1.0
3253,30,16,20,36,2,1.0
3254,30,35,43,78,2,1.0
3255,30,9,12,21,2,1.0
3256,30,24,26,50,2,1.0
3257,30,5,13,18,2,1.0
3258,30,5,5,10,2,1.0
3259,30,5,15,20,2,1.0
3260,30,3,4,7,2,1.0
3261,30,43,120,163,2,1.0
3262,30,43,78,121,2,1.0
3263,30,25,38,63,2,1.0
3264,30,25,58,83,2,1.0
3265,30,18,38,56,2,1.0
3266,30,32,58,90,2,1.0
3267,30,23,40,63,2,1.0
3268,30,10,18,28,2,1.0
3269,30,10,14,24,2,1.0
3270,30,6,14,20,2,1.0
3271,30,6,25,31,2,1.0
3272,30,15,46,61,2,1.0
3273,30,18,40,58,2,1.0
3274,30,13,23,36,2,1.0
3275,30,24,47,71,2,1.0
3276,30,11,54,65,2,1.0
3277,30,21,40,61,2,1.0
3278,30,37,91,128,2,1.0
3279,30,47,84,131,2,1.0
3280,30,22,25,47,2,1.0
3281,30,200,383,583,2,1.0
3282,30,8,7,15,2,1.0
3283,30,21,30,51,2,1.0
3284,30,1,4,5,2,1.0
3285,30,10,20,30,2,1.0
3286,30,20,24,44,2,1.0
3287,30,45,101,146,2,1.0
3288,30,43,44,87,2,1.0
3289,30,20,27,47,2,1.0
3290,30,14,14,28,2,1.0
3291,30,53,107,160,2,1.0
3292,30,62,77,139,2,1.0
3293,30,68,83,151,2,1.0
3294,30,20,25,45,2,1.0
3295,30,25,35,60,2,1.0
3296,30,36,76,112,2,1.0
3297,30,23,22,45,2,1.0
3298,30,25,19,44,2,1.0
3299,30,24,44,68,2,1.0
3300,30,15,16,31,2,1.0
3301,30,41,63,104,2,1.0
3302,30,82,197,279,2,1.0
3303,30,56,115,171,2,1.0
3304,30,37,90,127,2,1.0
3305,30,44,89,133,2,1.0
3306,30,6,9,15,2,1.0
3307,30,16,43,59,2,1.0
3308,30,21,20,41,2,1.0
3309,30,9,15,24,2,1.0
3310,30,10,10,20,2,1.0
3311,30,5,30,35,2,1.0
3312,30,13,14,27,2,1.0
3313,30,7,21,28,2,1.0
3314,30,4,6,10,2,1.0
3315,30,2,9,11,2,1.0
3316,30,43,58,101,2,1.0
3317,30,24,31,55,2,1.0
3318,30,23,24,47,2,1.0
3319,30,50,88,138,2,1.0
3320,30,38,55,93,2,1.0
3321,30,59,112,171,2,1.0
3322,30,65,78,143,2,1.0
3323,30,30,23,53,2,1.0
3324,30,9,26,35,2,1.0
3325,30,13,20,33,2,1.0
3326,30,23,8,31,2,1.0
3327,30,40,52,92,2,1.0
3328,30,2,6,8,2,1.0
3329,30,22,28,50,2,1.0
3330,30,0,5,5,2,1.0
3331,30,10,19,29,2,1.0
3332,30,23,64,87,2,1.0
3333,30,23,21,44,2,1.0
3334,30,19,32,51,2,1.0
3335,30,35,56,91,2,1.0
3336,30,52,99,151,2,1.0
3337,30,26,8,34,2,1.0
3338,30,53,12,65,2,1.0
3339,30,23,40,63,2,1.0
3340,30,22,19,41,2,1.0
3341,30,11,17,28,2,1.0
3342,30,27,120,147,2,1.0
3343,30,25,41,66,2,1.0
3344,30,5,15,20,2,1.0
3345,30,53,30,83,2,1.0
3346,30,20,30,50,2,1.0
3347,30,5,11,16,2,1.0
3348,30,8,19,27,2,1.0
3349,30,21,72,93,2,1.0
3350,30,32,36,68,2,1.0
3351,30,17,37,54,2,1.0
3352,30,26,73,99,2,1.0
3353,30,28,59,87,2,1.0
3354,30,21,34,55,2,1.0
3355,30,9,25,34,2,1.0
3356,30,41,76,117,2,1.0
3357,30,20,38,58,2,1.0
3358,30,8,12,20,2,1.0
3359,30,1,9,10,2,1.0
3360,30,4,9,13,2,1.0
3361,30,8,5,13,2,1.0
3362,30,4,5,9,2,1.0
3363,30,0,0,0,2,1.0
3364,30,75,45,120,2,1.0
3365,30,65,88,153,2,1.0
3366,30,59,80,139,2,1.0
3367,30,24,58,82,2,1.0
3368,30,9,19,28,2,1.0
3369,30,49,104,153,2,1.0
3370,30,28,50,78,2,1.0
3371,30,32,61,93,2,1.0
3372,30,19,39,58,2,1.0
3373,30,25,35,60,2,1.0
3374,30,35,45,80,2,1.0
3375,30,8,12,20,2,1.0
3376,30,28,26,54,2,1.0
3377,30,39,94,133,2,1.0
3378,30,11,7,18,2,1.0
3379,30,28,31,59,2,1.0
3380,30,11,16,27,2,1.0
3381,30,6,15,21,2,1.0
3382,30,17,24,41,2,1.0
3383,30,14,9,23,2,1.0
3384,30,53,93,146,2,1.0
3385,30,27,42,69,2,1.0
3386,30,14,7,21,2,1.0
3387,30,17,37,54,2,1.0
3388,30,78,117,195,2,1.0
3389,30,38,74,112,2,1.0
3390,30,20,35,55,2,1.0
3391,30,14,7,21,2,1.0
3392,30,33,32,65,2,1.0
3393,30,10,15,25,2,1.0
3394,30,2,4,6,2,1.0
3395,30,25,33,58,2,1.0
3396,30,28,28,56,2,1.0
3397,30,29,51,80,2,1.0
3398,30,32,42,74,2,1.0
3399,30,17,7,24,2,1.0
3400,30,30,44,74,2,1.0
3401,30,7,13,20,2,1.0
3402,30,23,26,49,2,1.0
3403,30,25,32,57,2,1.0
3404,30,7,23,30,2,1.0
3405,30,1,2,3,2,1.0
3406,30,22,29,51,2,1.0
3407,30,1,8,9,2,1.0
3408,30,32,66,98,2,1.0
3409,30,23,42,65,2,1.0
3410,30,59,109,168,2,1.0
3411,30,31,56,87,2,1.0
3412,30,46,46,92,2,1.0
3413,30,34,44,78,2,1.0
3414,30,51,59,110,2,1.0
3415,30,20,27,47,2,1.0
3416,30,22,79,101,2,1.0
3417,30,21,12,33,2,1.0
3418,30,18,20,38,2,1.0
3419,30,49,74,123,2,1.0
3420,30,32,44,76,2,1.0
3421,30,6,8,14,2,1.0
3422,30,14,17,31,2,1.0
3423,30,38,136,174,2,1.0
3424,30,16,50,66,2,1.0
3425,30,36,39,75,2,1.0
3426,30,56,65,121,2,1.0
3427,30,17,39,56,2,1.0
3428,30,32,35,67,2,1.0
3429,30,7,31,38,2,1.0
3430,30,4,41,45,2,1.0
3431,30,4,14,18,2,1.0
3432,30,17,40,57,2,1.0
3433,30,11,27,38,2,1.0
3434,30,6,20,26,2,1.0
3435,30,4,15,19,2,1.0
3436,30,46,64,110,2,1.0
3437,30,17,25,42,2,1.0
3438,30,13,54,67,2,1.0
3439,30,33,76,109,2,1.0
3440,30,12,13,25,2,1.0
3441,30,17,24,41,2,1.0
3442,30,29,34,63,2,1.0
3443,30,19,38,57,2,1.0
3444,30,28,44,72,2,1.0
3445,30,27,33,60,2,1.0
3446,30,20,35,55,2,1.0
3447,30,12,14,26,2,1.0
3448,30,10,52,62,2,1.0
3449,30,6,20,26,2,1.0
3450,30,1,2,3,2,1.0
3451,30,29,21,50,2,1.0
3452,30,42,71,113,2,1.0
3453,30,26,53,79,2,1.0
3454,30,25,49,74,2,1.0
3455,30,33,85,118,2,1.0
3456,30,43,90,133,2,1.0
3457,30,25,49,74,2,1.0
3458,30,8,9,17,2,1.0
3459,30,37,66,103,2,1.0
3460,30,39,41,80,2,1.0
3461,30,61,56,117,2,1.0
3462,30,18,22,40,2,1.0
3463,30,8,18,26,2,1.0
3464,30,3,22,25,2,1.0
3465,50,25,56,81,2,1.0
3466,50,29,48,77,2,1.0
3467,50,52,63,115,2,1.0
3468,50,65,91,156,2,1.0
3469,50,23,42,65,2,1.0
3470,50,23,50,73,2,1.0
3471,50,27,47,74,2,1.0
3472,50,17,27,44,2,1.0
3473,50,7,10,17,2,1.0
3474,50,30,32,62,2,1.0
3475,50,18,13,31,2,1.0
3476,50,20,14,34,2,1.0
3477,50,9,13,22,2,1.0
3478,50,20,13,33,2,1.0
3479,50,21,19,40,2,1.0
3480,50,35,61,96,2,1.0
3481,50,22,31,53,2,1.0
3482,50,14,43,57,2,1.0
3483,50,24,51,75,2,1.0
3484,50,54,77,131,2,1.0
3485,50,39,63,102,2,1.0
3486,50,92,75,167,2,1.0
3487,50,29,54,83,2,1.0
3488,50,44,59,103,2,1.0
3489,50,41,48,89,2,1.0
3490,50,43,71,114,2,1.0
3491,50,33,67,100,2,1.0
3492,50,28,28,56,2,1.0
3493,50,38,41,79,2,1.0
3494,50,18,53,71,2,1.0
3495,50,42,106,148,2,1.0
3496,50,33,61,94,2,1.0
3497,50,45,57,102,2,1.0
3498,50,68,103,171,2,1.0
3499,50,60,90,150,2,1.0
3500,50,46,76,122,2,1.0
3501,50,57,49,106,2,1.0
3502,50,27,69,96,2,1.0
3503,50,61,130,191,2,1.0
3504,50,27,41,68,2,1.0
3505,50,8,4,12,2,1.0
3506,50,37,37,74,2,1.0
3507,50,26,43,69,2,1.0
3508,50,6,31,37,2,1.0
3509,50,21,28,49,2,1.0
3510,50,69,88,157,2,1.0
3511,50,96,166,262,2,1.0
3512,50,24,30,54,2,1.0
3513,50,40,83,123,2,1.0
3514,50,16,24,40,2,1.0
3515,50,76,118,194,2,1.0
3516,50,16,35,51,2,1.0
3517,50,17,9,26,2,1.0
3518,50,21,47,68,2,1.0
3519,50,12,21,33,2,1.0
3520,50,12,21,33,2,1.0
3521,50,10,34,44,2,1.0
3522,50,77,124,201,2,1.0
3523,50,19,50,69,2,1.0
3524,50,43,54,97,2,1.0
3525,50,32,72,104,2,1.0
3526,50,26,29,55,2,1.0
3527,50,7,20,27,2,1.0
3528,50,21,70,91,2,1.0
3529,50,7,20,27,2,1.0
3530,50,15,17,32,2,1.0
3531,50,19,27,46,2,1.0
3532,50,32,34,66,2,1.0
3533,50,7,15,22,2,1.0
3534,50,20,21,41,2,1.0
3535,50,6,25,31,2,1.0
3536,50,44,97,141,2,1.0
3537,50,52,111,163,2,1.0
3538,50,14,28,42,2,1.0
3539,50,19,13,32,2,1.0
3540,50,25,60,85,2,1.0
3541,50,44,70,114,2,1.0
3542,50,159,107,266,2,1.0
3543,50,18,40,58,2,1.0
3544,50,44,60,104,2,1.0
3545,50,23,39,62,2,1.0
3546,50,20,40,60,2,1.0
3547,50,10,28,38,2,1.0
3548,50,27,20,47,2,1.0
3549,50,9,24,33,2,1.0
3550,50,6,4,10,2,1.0
3551,50,83,93,176,2,1.0
3552,50,21,34,55,2,1.0
3553,50,21,42,63,2,1.0
3554,50,6,6,12,2,1.0
3555,50,9,29,38,2,1.0
3556,50,6,18,24,2,1.0
3557,50,18,40,58,2,1.0
3558,50,8,16,24,2,1.0
3559,50,33,48,81,2,1.0
3560,50,10,13,23,2,1.0
3561,50,27,13,40,2,1.0
3562,50,7,14,21,2,1.0
3563,50,3,6,9,2,1.0
3564,50,4,6,10,2,1.0
3565,50,35,25,60,2,1.0
3566,50,39,69,108,2,1.0
3567,50,43,56,99,2,1.0
3568,50,53,36,89,2,1.0
3569,50,67,127,194,2,1.0
3570,50,24,79,103,2,1.0
3571,50,46,65,111,2,1.0
3572,50,56,85,141,2,1.0
3573,50,57,83,140,2,1.0
3574,50,47,75,122,2,1.0
3575,50,9,17,26,2,1.0
3576,50,18,32,50,2,1.0
3577,50,7,15,22,2,1.0
3578,50,12,26,38,2,1.0
3579,50,0,0,0,2,1.0
3580,50,42,53,95,2,1.0
3581,50,6,16,22,2,1.0
3582,50,70,82,152,2,1.0
3583,50,37,47,84,2,1.0
3584,50,30,47,77,2,1.0
3585,50,46,49,95,2,1.0
3586,50,25,19,44,2,1.0
3587,50,34,61,95,2,1.0
3588,50,76,74,150,2,1.0
3589,50,20,17,37,2,1.0
3590,50,18,23,41,2,1.0
3591,50,8,18,26,2,1.0
3592,50,14,25,39,2,1.0
3593,50,14,25,39,2,1.0
3594,50,10,14,24,2,1.0
3595,50,18,19,37,2,1.0
3596,50,34,48,82,2,1.0
3597,50,13,31,44,2,1.0
3598,50,7,20,27,2,1.0
3599,50,44,43,87,2,1.0
3600,50,26,44,70,2,1.0
3601,50,97,109,206,2,1.0
3602,50,27,45,72,2,1.0
3603,50,23,41,64,2,1.0
3604,50,17,34,51,2,1.0
3605,50,28,29,57,2,1.0
3606,50,18,18,36,2,1.0
3607,50,6,15,21,2,1.0
3608,50,7,9,16,2,1.0
3609,50,37,62,99,2,1.0
3610,50,24,42,66,2,1.0
3611,50,40,54,94,2,1.0
3612,50,39,75,114,2,1.0
3613,50,26,58,84,2,1.0
3614,50,34,62,96,2,1.0
3615,50,26,20,46,2,1.0
3616,50,19,25,44,2,1.0
3617,50,10,24,34,2,1.0
3618,50,1,7,8,2,1.0
3619,50,14,12,26,2,1.0
3620,50,10,21,31,2,1.0
3621,50,2,5,7,2,1.0
3622,50,12,24,36,2,1.0
3623,50,14,34,48,2,1.0
3624,50,34,59,93,2,1.0
3625,50,9,26,35,2,1.0
3626,50,55,76,131,2,1.0
3627,50,46,89,135,2,1.0
3628,50,15,25,40,2,1.0
3629,50,20,29,49,2,1.0
3630,50,21,32,53,2,1.0
3631,50,6,26,32,2,1.0
3632,50,25,57,82,2,1.0
3633,50,2,12,14,2,1.0
3634,50,20,25,45,2,1.0
3635,50,46,59,105,2,1.0
3636,50,16,20,36,2,1.0
3637,50,28,51,79,2,1.0
3638,50,29,23,52,2,1.0
3639,50,17,38,55,2,1.0
3640,50,17,21,38,2,1.0
3641,50,7,16,23,2,1.0
3642,50,28,43,71,2,1.0
3643,50,21,36,57,2,1.0
3644,50,11,14,25,2,1.0
3645,50,2,5,7,2,1.0
3646,50,7,7,14,2,1.0
3647,50,16,21,37,2,1.0
3648,50,14,32,46,2,1.0
3649,50,20,24,44,2,1.0
3650,50,12,8,20,2,1.0
3651,50,52,92,144,2,1.0
3652,50,95,133,228,2,1.0
3653,50,55,83,138,2,1.0
3654,50,20,30,50,2,1.0
3655,50,31,30,61,2,1.0
3656,50,22,23,45,2,1.0
3657,50,36,81,117,2,1.0
3658,50,12,17,29,2,1.0
3659,50,6,11,17,2,1.0
3660,50,9,9,18,2,1.0
3661,50,5,14,19,2,1.0
3662,50,11,22,33,2,1.0
3663,50,3,4,7,2,1.0
3664,50,6,27,33,2,1.0
3665,50,13,16,29,2,1.0
3666,50,43,104,147,2,1.0
3667,50,11,16,27,2,1.0
3668,50,40,89,129,2,1.0
3669,50,7,15,22,2,1.0
3670,50,8,10,18,2,1.0
3671,50,18,28,46,2,1.0
3672,50,10,14,24,2,1.0
3673,50,29,25,54,2,1.0
3674,50,15,19,34,2,1.0
3675,50,14,21,35,2,1.0
3676,50,58,64,122,2,1.0
3677,50,10,8,18,2,1.0
3678,50,5,19,24,2,1.0
3679,50,4,13,17,2,1.0
3680,50,9,21,30,2,1.0
3681,50,3,3,6,2,1.0
3682,50,19,17,36,2,1.0
3683,50,20,23,43,2,1.0
3684,50,34,68,102,2,1.0
3685,50,13,38,51,2,1.0
3686,50,19,51,70,2,1.0
3687,50,42,33,75,2,1.0
3688,50,23,28,51,2,1.0
3689,50,20,36,56,2,1.0
3690,50,10,21,31,2,1.0
3691,50,26,31,57,2,1.0
3692,50,13,16,29,2,1.0
3693,50,11,23,34,2,1.0
3694,50,1,4,5,2,1.0
3695,50,10,9,19,2,1.0
3696,50,6,12,18,2,1.0
3697,50,7,13,20,2,1.0
3698,50,13,25,38,2,1.0
3699,50,18,49,67,2,1.0
3700,50,11,36,47,2,1.0
3701,50,20,19,39,2,1.0
3702,50,52,49,101,2,1.0
3703,50,22,49,71,2,1.0
3704,50,24,84,108,2,1.0
3705,50,10,3,13,2,1.0
3706,50,24,44,68,2,1.0
3707,50,49,41,90,2,1.0
3708,50,3,7,10,2,1.0
3709,50,10,22,32,2,1.0
3710,50,15,25,40,2,1.0
3711,50,4,8,12,2,1.0
3712,50,34,26,60,2,1.0
3713,50,9,6,15,2,1.0
3714,50,20,23,43,2,1.0
3715,50,26,43,69,2,1.0
3716,50,52,59,111,2,1.0
3717,50,96,130,226,2,1.0
3718,50,51,97,148,2,1.0
3719,50,13,42,55,2,1.0
3720,50,13,14,27,2,1.0
3721,50,55,41,96,2,1.0
3722,50,50,48,98,2,1.0
3723,50,11,26,37,2,1.0
3724,50,13,14,27,2,1.0
3725,50,17,24,41,2,1.0
3726,50,14,26,40,2,1.0
3727,50,3,8,11,2,1.0
3728,50,9,12,21,2,1.0
3729,50,1,2,3,2,1.0
3730,50,14,23,37,2,1.0
3731,50,4,4,8,2,1.0
3732,50,14,16,30,2,1.0
3733,50,13,11,24,2,1.0
3734,50,24,20,44,2,1.0
3735,50,33,33,66,2,1.0
3736,50,9,13,22,2,1.0
3737,50,10,8,18,2,1.0
3738,50,24,9,33,2,1.0
3739,50,51,52,103,2,1.0
3740,50,10,27,37,2,1.0
3741,50,43,37,80,2,1.0
3742,50,59,80,139,2,1.0
3743,50,29,39,68,2,1.0
3744,50,10,22,32,2,1.0
3745,50,28,34,62,2,1.0
3746,50,14,24,38,2,1.0
3747,50,42,48,90,2,1.0
3748,50,41,27,68,2,1.0
3749,50,17,16,33,2,1.0
3750,50,50,110,160,2,1.0
3751,50,19,20,39,2,1.0
3752,50,3,3,6,2,1.0
3753,50,22,35,57,2,1.0
3754,50,12,22,34,2,1.0
3755,50,15,30,45,2,1.0
3756,50,6,22,28,2,1.0
3757,50,16,19,35,2,1.0
3758,50,24,46,70,2,1.0
3759,50,113,174,287,2,1.0
3760,50,32,71,103,2,1.0
3761,50,55,87,142,2,1.0
3762,50,41,152,193,2,1.0
3763,50,22,47,69,2,1.0
3764,50,52,68,120,2,1.0
3765,50,10,15,25,2,1.0
3766,50,82,126,208,2,1.0
3767,50,44,51,95,2,1.0
3768,50,26,46,72,2,1.0
3769,50,22,29,51,2,1.0
3770,50,43,52,95,2,1.0
3771,50,46,65,111,2,1.0
3772,50,22,49,71,2,1.0
3773,50,28,37,65,2,1.0
3774,50,58,104,162,2,1.0
3775,50,36,25,61,2,1.0
3776,50,36,28,64,2,1.0
3777,50,41,23,64,2,1.0
3778,50,18,24,42,2,1.0
3779,50,27,34,61,2,1.0
3780,50,33,29,62,2,1.0
3781,50,37,45,82,2,1.0
3782,50,53,53,106,2,1.0
3783,50,16,33,49,2,1.0
3784,50,6,14,20,2,1.0
3785,50,8,18,26,2,1.0
3786,50,6,4,10,2,1.0
3787,50,8,11,19,2,1.0
3788,50,0,0,0,2,1.0
3789,50,61,86,147,2,1.0
3790,50,24,41,65,2,1.0
3791,50,23,42,65,2,1.0
3792,50,2,13,15,2,1.0
3793,50,54,34,88,2,1.0
3794,50,54,97,151,2,1.0
3795,50,30,22,52,2,1.0
3796,50,44,37,81,2,1.0
3797,50,35,41,76,2,1.0
3798,50,51,84,135,2,1.0
3799,50,26,36,62,2,1.0
3800,50,48,37,85,2,1.0
3801,50,23,28,51,2,1.0
3802,50,30,42,72,2,1.0
3803,50,46,48,94,2,1.0
3804,50,25,84,109,2,1.0
3805,50,32,18,50,2,1.0
3806,50,23,27,50,2,1.0
3807,50,22,33,55,2,1.0
3808,50,106,140,246,2,1.0
3809,50,128,208,336,2,1.0
3810,50,26,66,92,2,1.0
3811,50,38,73,111,2,1.0
3812,50,37,57,94,2,1.0
3813,50,78,217,295,2,1.0
3814,50,26,43,69,2,1.0
3815,50,58,173,231,2,1.0
3816,50,72,63,135,2,1.0
3817,50,19,20,39,2,1.0
3818,50,16,83,99,2,1.0
3819,50,29,39,68,2,1.0
3820,50,39,78,117,2,1.0
3821,50,17,25,42,2,1.0
3822,50,3,4,7,2,1.0
3823,50,11,27,38,2,1.0
3824,50,32,36,68,2,1.0
3825,50,41,89,130,2,1.0
3826,50,51,42,93,2,1.0
3827,50,9,25,34,2,1.0
3828,50,55,74,129,2,1.0
3829,50,32,56,88,2,1.0
3830,50,17,27,44,2,1.0
3831,50,6,11,17,2,1.0
3832,50,9,17,26,2,1.0
3833,50,3,3,6,2,1.0
3834,50,3,6,9,2,1.0
3835,50,4,15,19,2,1.0
3836,50,47,88,135,2,1.0
3837,50,32,39,71,2,1.0
3838,50,24,55,79,2,1.0
3839,50,53,125,178,2,1.0
3840,50,43,51,94,2,1.0
3841,50,15,26,41,2,1.0
3842,50,64,87,151,2,1.0
3843,50,27,41,68,2,1.0
3844,50,60,39,99,2,1.0
3845,50,62,49,111,2,1.0
3846,50,16,23,39,2,1.0
3847,50,8,22,30,2,1.0
3848,50,35,91,126,2,1.0
3849,50,18,30,48,2,1.0
3850,50,13,9,22,2,1.0
3851,50,62,100,162,2,1.0
3852,50,20,34,54,2,1.0
3853,50,32,34,66,2,1.0
3854,50,10,12,22,2,1.0
3855,50,30,84,114,2,1.0
3856,50,39,44,83,2,1.0
3857,50,5,8,13,2,1.0
3858,50,20,24,44,2,1.0
3859,50,24,12,36,2,1.0
3860,50,22,16,38,2,1.0
3861,50,3,11,14,2,1.0
3862,50,30,29,59,2,1.0
3863,50,5,1,6,2,1.0
3864,50,1,17,18,2,1.0
3865,50,31,36,67,2,1.0
3866,50,2,0,2,2,1.0
3867,50,26,36,62,2,1.0
3868,50,27,17,44,2,1.0
3869,50,33,39,72,2,1.0
3870,50,16,26,42,2,1.0
3871,50,13,8,21,2,1.0
3872,50,24,19,43,2,1.0
3873,50,21,25,46,2,1.0
3874,50,40,38,78,2,1.0
3875,50,2,6,8,2,1.0
3876,50,20,49,69,2,1.0
3877,50,27,21,48,2,1.0
3878,50,32,58,90,2,1.0
3879,50,18,21,39,2,1.0
3880,50,81,108,189,2,1.0
3881,50,16,18,34,2,1.0
3882,50,9,26,35,2,1.0
3883,50,19,31,50,2,1.0
3884,50,36,35,71,2,1.0
3885,50,26,33,59,2,1.0
3886,50,27,3,30,2,1.0
3887,50,15,14,29,2,1.0
3888,50,28,49,77,2,1.0
3889,50,26,65,91,2,1.0
3890,50,46,75,121,2,1.0
3891,50,57,48,105,2,1.0
3892,50,14,22,36,2,1.0
3893,50,92,196,288,2,1.0
3894,50,39,75,114,2,1.0
3895,50,8,37,45,2,1.0
3896,50,13,13,26,2,1.0
3897,50,18,25,43,2,1.0
3898,50,6,22,28,2,1.0
3899,50,12,18,30,2,1.0
3900,50,15,46,61,2,1.0
3901,50,12,17,29,2,1.0
3902,50,14,44,58,2,1.0
3903,50,37,26,63,2,1.0
3904,50,180,116,296,2,1.0
3905,50,43,53,96,2,1.0
3906,50,23,43,66,2,1.0
3907,50,13,35,48,2,1.0
3908,50,53,54,107,2,1.0
3909,50,28,21,49,2,1.0
3910,50,27,18,45,2,1.0
3911,50,28,45,73,2,1.0
3912,50,3,10,13,2,1.0
3913,50,19,37,56,2,1.0
3914,75,21,20,41,2,1.0
3915,75,19,22,41,2,1.0
3916,75,29,22,51,2,1.0
3917,75,41,84,125,2,1.0
3918,75,42,75,117,2,1.0
3919,75,18,29,47,2,1.0
3920,75,39,99,138,2,1.0
3921,75,17,6,23,2,1.0
3922,75,24,59,83,2,1.0
3923,75,14,39,53,2,1.0
3924,75,50,82,132,2,1.0
3925,75,15,15,30,2,1.0
3926,75,26,31,57,2,1.0
3927,75,6,16,22,2,1.0
3928,75,24,52,76,2,1.0
3929,75,4,6,10,2,1.0
3930,75,40,59,99,2,1.0
3931,75,38,49,87,2,1.0
3932,75,51,119,170,2,1.0
3933,75,28,31,59,2,1.0
3934,75,16,34,50,2,1.0
3935,75,38,42,80,2,1.0
3936,75,22,12,34,2,1.0
3937,75,55,43,98,2,1.0
3938,75,19,46,65,2,1.0
3939,75,7,14,21,2,1.0
3940,75,11,30,41,2,1.0
3941,75,13,31,44,2,1.0
3942,75,6,16,22,2,1.0
3943,75,29,61,90,2,1.0
3944,75,32,56,88,2,1.0
3945,75,14,33,47,2,1.0
3946,75,25,17,42,2,1.0
3947,75,28,43,71,2,1.0
3948,75,8,21,29,2,1.0
3949,75,23,32,55,2,1.0
3950,75,7,11,18,2,1.0
3951,75,9,15,24,2,1.0
3952,75,158,178,336,2,1.0
3953,75,6,4,10,2,1.0
3954,75,1,6,7,2,1.0
3955,75,2,1,3,2,1.0
3956,75,28,52,80,2,1.0
3957,75,3,2,5,2,1.0
3958,75,20,10,30,2,1.0
3959,75,16,31,47,2,1.0
3960,75,72,116,188,2,1.0
3961,75,49,62,111,2,1.0
3962,75,32,46,78,2,1.0
3963,75,22,20,42,2,1.0
3964,75,35,24,59,2,1.0
3965,75,71,68,139,2,1.0
3966,75,28,28,56,2,1.0
3967,75,11,8,19,2,1.0
3968,75,12,16,28,2,1.0
3969,75,4,10,14,2,1.0
3970,75,10,16,26,2,1.0
3971,75,33,47,80,2,1.0
3972,75,9,25,34,2,1.0
3973,75,4,25,29,2,1.0
3974,75,38,86,124,2,1.0
3975,75,8,28,36,2,1.0
3976,75,42,97,139,2,1.0
3977,75,30,84,114,2,1.0
3978,75,69,86,155,2,1.0
3979,75,51,103,154,2,1.0
3980,75,29,31,60,2,1.0
3981,75,11,29,40,2,1.0
3982,75,61,51,112,2,1.0
3983,75,55,75,130,2,1.0
3984,75,20,47,67,2,1.0
3985,75,1,3,4,2,1.0
3986,75,17,23,40,2,1.0
3987,75,151,84,235,2,1.0
3988,75,9,12,21,2,1.0
3989,75,41,31,72,2,1.0
3990,75,10,9,19,2,1.0
3991,75,38,60,98,2,1.0
3992,75,63,48,111,2,1.0
3993,75,11,19,30,2,1.0
3994,75,77,79,156,2,1.0
3995,75,11,8,19,2,1.0
3996,75,62,123,185,2,1.0
3997,75,25,42,67,2,1.0
3998,75,31,38,69,2,1.0
3999,75,7,26,33,2,1.0
4000,75,26,53,79,2,1.0
4001,75,3,10,13,2,1.0
4002,75,104,184,288,2,1.0
4003,75,45,125,170,2,1.0
4004,75,52,53,105,2,1.0
4005,75,41,89,130,2,1.0
4006,75,21,33,54,2,1.0
4007,75,47,81,128,2,1.0
4008,75,35,87,122,2,1.0
4009,75,48,83,131,2,1.0
4010,75,24,45,69,2,1.0
4011,75,25,16,41,2,1.0
4012,75,1,13,14,2,1.0
4013,75,131,153,284,2,1.0
4014,75,78,103,181,2,1.0
4015,75,72,177,249,2,1.0
4016,75,55,69,124,2,1.0
4017,75,69,75,144,2,1.0
4018,75,79,136,215,2,1.0
4019,75,28,36,64,2,1.0
4020,75,62,156,218,2,1.0
4021,75,20,61,81,2,1.0
4022,75,24,33,57,2,1.0
4023,75,82,71,153,2,1.0
4024,75,10,31,41,2,1.0
4025,75,11,51,62,2,1.0
4026,75,47,82,129,2,1.0
4027,75,30,76,106,2,1.0
4028,75,24,38,62,2,1.0
4029,75,27,56,83,2,1.0
4030,75,22,50,72,2,1.0
4031,75,26,66,92,2,1.0
4032,75,50,100,150,2,1.0
4033,75,26,56,82,2,1.0
4034,75,48,47,95,2,1.0
4035,75,10,37,47,2,1.0
4036,75,18,57,75,2,1.0
4037,75,5,11,16,2,1.0
4038,75,11,21,32,2,1.0
4039,75,18,13,31,2,1.0
4040,75,53,170,223,2,1.0
4041,75,46,72,118,2,1.0
4042,75,81,176,257,2,1.0
4043,75,35,48,83,2,1.0
4044,75,67,74,141,2,1.0
4045,75,21,33,54,2,1.0
4046,75,81,84,165,2,1.0
4047,75,36,54,90,2,1.0
4048,75,20,61,81,2,1.0
4049,75,23,58,81,2,1.0
4050,75,18,21,39,2,1.0
4051,75,9,11,20,2,1.0
4052,75,8,21,29,2,1.0
4053,75,5,13,18,2,1.0
4054,75,37,67,104,2,1.0
4055,75,30,65,95,2,1.0
4056,75,20,53,73,2,1.0
4057,75,58,171,229,2,1.0
4058,75,66,86,152,2,1.0
4059,75,46,106,152,2,1.0
4060,75,52,59,111,2,1.0
4061,75,19,30,49,2,1.0
4062,75,19,19,38,2,1.0
4063,75,20,30,50,2,1.0
4064,75,34,60,94,2,1.0
4065,75,15,21,36,2,1.0
4066,75,32,49,81,2,1.0
4067,75,20,37,57,2,1.0
4068,75,22,45,67,2,1.0
4069,75,19,21,40,2,1.0
4070,75,41,65,106,2,1.0
4071,75,5,12,17,2,1.0
4072,75,16,19,35,2,1.0
4073,75,8,22,30,2,1.0
4074,75,11,10,21,2,1.0
4075,75,16,47,63,2,1.0
4076,75,7,16,23,2,1.0
4077,75,11,13,24,2,1.0
4078,75,30,40,70,2,1.0
4079,75,6,23,29,2,1.0
4080,75,40,74,114,2,1.0
4081,75,43,81,124,2,1.0
4082,75,19,54,73,2,1.0
4083,75,32,66,98,2,1.0
4084,75,34,47,81,2,1.0
4085,75,16,28,44,2,1.0
4086,75,29,90,119,2,1.0
4087,75,10,11,21,2,1.0
4088,75,109,116,225,2,1.0
4089,75,15,40,55,2,1.0
4090,75,0,13,13,2,1.0
4091,75,1,19,20,2,1.0
4092,75,19,18,37,2,1.0
4093,75,45,36,81,2,1.0
4094,75,26,10,36,2,1.0
4095,75,17,56,73,2,1.0
4096,75,22,19,41,2,1.0
4097,75,49,101,150,2,1.0
4098,75,30,70,100,2,1.0
4099,75,31,49,80,2,1.0
4100,75,30,69,99,2,1.0
4101,75,28,74,102,2,1.0
4102,75,42,72,114,2,1.0
4103,75,26,68,94,2,1.0
4104,75,33,52,85,2,1.0
4105,75,49,39,88,2,1.0
4106,75,19,57,76,2,1.0
4107,75,27,63,90,2,1.0
4108,75,18,29,47,2,1.0
4109,75,16,86,102,2,1.0
4110,75,41,56,97,2,1.0
4111,75,16,15,31,2,1.0
4112,75,64,140,204,2,1.0
4113,75,31,75,106,2,1.0
4114,75,16,33,49,2,1.0
4115,75,13,37,50,2,1.0
4116,75,11,26,37,2,1.0
4117,75,1,3,4,2,1.0
4118,75,62,99,161,2,1.0
4119,75,5,7,12,2,1.0
4120,75,5,7,12,2,1.0
4121,75,34,38,72,2,1.0
4122,75,24,33,57,2,1.0
4123,75,30,46,76,2,1.0
4124,75,66,114,180,2,1.0
4125,75,19,35,54,2,1.0
4126,75,7,16,23,2,1.0
4127,75,22,47,69,2,1.0
4128,75,11,38,49,2,1.0
4129,75,25,21,46,2,1.0
4130,75,15,22,37,2,1.0
4131,75,3,26,29,2,1.0
4132,75,18,51,69,2,1.0
4133,75,88,123,211,2,1.0
4134,75,62,108,170,2,1.0
4135,75,46,67,113,2,1.0
4136,75,25,66,91,2,1.0
4137,75,47,81,128,2,1.0
4138,75,1,6,7,2,1.0
4139,75,9,32,41,2,1.0
4140,75,17,31,48,2,1.0
4141,75,55,83,138,2,1.0
4142,75,16,19,35,2,1.0
4143,75,4,0,4,2,1.0
4144,75,0,3,3,2,1.0
4145,75,23,36,59,2,1.0
4146,75,17,39,56,2,1.0
4147,75,17,16,33,2,1.0
4148,75,24,77,101,2,1.0
4149,75,27,29,56,2,1.0
4150,75,6,15,21,2,1.0
4151,75,45,31,76,2,1.0
4152,75,11,19,30,2,1.0
4153,75,24,43,67,2,1.0
4154,75,52,63,115,2,1.0
4155,75,8,8,16,2,1.0
4156,75,13,21,34,2,1.0
4157,75,29,66,95,2,1.0
4158,75,14,14,28,2,1.0
4159,75,0,4,4,2,1.0
4160,75,64,127,191,2,1.0
4161,75,40,70,110,2,1.0
4162,75,43,112,155,2,1.0
4163,75,32,73,105,2,1.0
4164,75,15,32,47,2,1.0
4165,75,13,37,50,2,1.0
4166,75,23,33,56,2,1.0
4167,75,20,35,55,2,1.0
4168,75,25,48,73,2,1.0
4169,75,30,44,74,2,1.0
4170,75,25,52,77,2,1.0
4171,75,95,163,258,2,1.0
4172,75,114,246,360,2,1.0
4173,75,25,24,49,2,1.0
4174,75,52,177,229,2,1.0
4175,75,76,163,239,2,1.0
4176,75,111,199,310,2,1.0
4177,75,50,90,140,2,1.0
4178,75,111,203,314,2,1.0
4179,75,42,77,119,2,1.0
4180,75,73,122,195,2,1.0
4181,75,20,66,86,2,1.0
4182,75,28,57,85,2,1.0
4183,75,20,71,91,2,1.0
4184,75,2,12,14,2,1.0
4185,75,16,15,31,2,1.0
4186,75,36,65,101,2,1.0
4187,75,42,116,158,2,1.0
4188,75,105,135,240,2,1.0
4189,75,75,104,179,2,1.0
4190,75,30,71,101,2,1.0
4191,75,16,12,28,2,1.0
4192,75,20,48,68,2,1.0
4193,75,41,65,106,2,1.0
4194,75,11,9,20,2,1.0
4195,75,7,14,21,2,1.0
4196,75,42,65,107,2,1.0
4197,75,9,15,24,2,1.0
4198,75,57,116,173,2,1.0
4199,75,36,85,121,2,1.0
4200,75,8,36,44,2,1.0
4201,75,88,148,236,2,1.0
4202,75,88,135,223,2,1.0
4203,75,20,35,55,2,1.0
4204,75,75,153,228,2,1.0
4205,75,38,89,127,2,1.0
4206,75,37,61,98,2,1.0
4207,75,28,70,98,2,1.0
4208,75,42,94,136,2,1.0
4209,75,22,17,39,2,1.0
4210,75,4,9,13,2,1.0
4211,75,78,143,221,2,1.0
4212,75,48,62,110,2,1.0
4213,75,28,52,80,2,1.0
4214,75,67,80,147,2,1.0
4215,75,18,28,46,2,1.0
4216,75,44,159,203,2,1.0
4217,75,53,81,134,2,1.0
4218,75,50,85,135,2,1.0
4219,75,28,26,54,2,1.0
4220,75,23,31,54,2,1.0
4221,75,12,28,40,2,1.0
4222,75,12,18,30,2,1.0
4223,75,6,24,30,2,1.0
4224,75,30,86,116,2,1.0
4225,75,53,35,88,2,1.0
4226,75,19,37,56,2,1.0
4227,75,67,95,162,2,1.0
4228,75,21,73,94,2,1.0
4229,75,24,103,127,2,1.0
4230,75,18,23,41,2,1.0
4231,75,17,34,51,2,1.0
4232,75,23,42,65,2,1.0
4233,75,16,35,51,2,1.0
4234,75,12,28,40,2,1.0
4235,75,3,20,23,2,1.0
4236,75,8,13,21,2,1.0
4237,75,8,19,27,2,1.0
4238,75,18,33,51,2,1.0
4239,75,63,95,158,2,1.0
4240,75,52,69,121,2,1.0
4241,75,42,90,132,2,1.0
4242,75,82,208,290,2,1.0
4243,75,49,65,114,2,1.0
4244,75,14,20,34,2,1.0
4245,75,26,70,96,2,1.0
4246,75,8,22,30,2,1.0
4247,75,22,34,56,2,1.0
4248,75,7,7,14,2,1.0
4249,75,43,76,119,2,1.0
4250,75,11,13,24,2,1.0
4251,75,5,8,13,2,1.0
4252,75,15,12,27,2,1.0
4253,75,1,8,9,2,1.0
4254,75,3,8,11,2,1.0
4255,75,14,33,47,2,1.0
4256,75,41,101,142,2,1.0
4257,75,34,94,128,2,1.0
4258,75,33,128,161,2,1.0
4259,75,81,78,159,2,1.0
4260,75,58,94,152,2,1.0
4261,75,105,219,324,2,1.0
4262,75,84,100,184,2,1.0
4263,75,18,23,41,2,1.0
4264,75,34,55,89,2,1.0
4265,75,53,153,206,2,1.0
4266,75,25,38,63,2,1.0
4267,75,89,95,184,2,1.0
4268,75,19,29,48,2,1.0
4269,75,3,20,23,2,1.0
4270,75,8,13,21,2,1.0
4271,75,46,107,153,2,1.0
4272,75,153,131,284,2,1.0
4273,75,61,109,170,2,1.0
4274,75,31,92,123,2,1.0
4275,75,26,63,89,2,1.0
4276,75,21,33,54,2,1.0
4277,75,75,65,140,2,1.0
4278,75,10,31,41,2,1.0
4279,75,34,43,77,2,1.0
4280,75,20,34,54,2,1.0
4281,75,3,10,13,2,1.0
4282,75,8,7,15,2,1.0
4283,75,31,36,67,2,1.0
4284,75,4,8,12,2,1.0
4285,75,56,105,161,2,1.0
4286,75,34,60,94,2,1.0
4287,75,47,79,126,2,1.0
4288,75,19,48,67,2,1.0
4289,75,21,35,56,2,1.0
4290,75,34,105,139,2,1.0
4291,75,48,39,87,2,1.0
4292,75,12,27,39,2,1.0
4293,75,6,17,23,2,1.0
4294,75,6,17,23,2,1.0
4295,75,15,41,56,2,1.0
4296,75,18,38,56,2,1.0
4297,75,2,9,11,2,1.0
4298,75,29,52,81,2,1.0
4299,75,51,73,124,2,1.0
4300,75,22,40,62,2,1.0
4301,75,34,36,70,2,1.0
4302,75,43,65,108,2,1.0
4303,75,21,57,78,2,1.0
4304,75,27,62,89,2,1.0
4305,75,6,27,33,2,1.0
4306,75,19,94,113,2,1.0
4307,75,12,15,27,2,1.0
4308,75,13,21,34,2,1.0
4309,75,1,6,7,2,1.0
4310,75,3,5,8,2,1.0
4311,75,32,46,78,2,1.0
4312,75,43,107,150,2,1.0
4313,75,34,70,104,2,1.0
4314,75,50,106,156,2,1.0
4315,75,38,134,172,2,1.0
4316,75,21,48,69,2,1.0
4317,75,32,133,165,2,1.0
4318,75,19,26,45,2,1.0
4319,75,17,14,31,2,1.0
4320,75,31,74,105,2,1.0
4321,75,8,23,31,2,1.0
4322,75,28,41,69,2,1.0
4323,75,5,4,9,2,1.0
4324,90,14,26,40,2,1.0
4325,90,44,48,92,2,1.0
4326,90,33,98,131,2,1.0
4327,90,58,126,184,2,1.0
4328,90,19,18,37,2,1.0
4329,90,71,110,181,2,1.0
4330,90,71,156,227,2,1.0
4331,90,14,30,44,2,1.0
4332,90,17,45,62,2,1.0
4333,90,39,42,81,2,1.0
4334,90,18,29,47,2,1.0
4335,90,33,37,70,2,1.0
4336,90,19,54,73,2,1.0
4337,90,3,11,14,2,1.0
4338,90,1,1,2,2,1.0
4339,90,24,66,90,2,1.0
4340,90,14,68,82,2,1.0
4341,90,14,43,57,2,1.0
4342,90,69,77,146,2,1.0
4343,90,14,26,40,2,1.0
4344,90,63,179,242,2,1.0
4345,90,41,103,144,2,1.0
4346,90,11,37,48,2,1.0
4347,90,35,90,125,2,1.0
4348,90,34,76,110,2,1.0
4349,90,42,79,121,2,1.0
4350,90,12,17,29,2,1.0
4351,90,13,20,33,2,1.0
4352,90,18,32,50,2,1.0
4353,90,6,8,14,2,1.0
4354,90,6,20,26,2,1.0
4355,90,11,7,18,2,1.0
4356,90,12,16,28,2,1.0
4357,90,0,2,2,2,1.0
4358,90,26,50,76,2,1.0
4359,90,65,82,147,2,1.0
4360,90,68,123,191,2,1.0
4361,90,36,79,115,2,1.0
4362,90,94,279,373,2,1.0
4363,90,33,89,122,2,1.0
4364,90,25,39,64,2,1.0
4365,90,27,53,80,2,1.0
4366,90,29,35,64,2,1.0
4367,90,16,27,43,2,1.0
4368,90,13,42,55,2,1.0
4369,90,35,9,44,2,1.0
4370,90,25,46,71,2,1.0
4371,90,11,8,19,2,1.0
4372,90,12,14,26,2,1.0
4373,90,25,61,86,2,1.0
4374,90,1,6,7,2,1.0
4375,90,36,73,109,2,1.0
4376,90,17,37,54,2,1.0
4377,90,16,22,38,2,1.0
4378,90,26,55,81,2,1.0
4379,90,23,81,104,2,1.0
4380,90,65,68,133,2,1.0
4381,90,26,75,101,2,1.0
4382,90,7,44,51,2,1.0
4383,90,34,91,125,2,1.0
4384,90,11,23,34,2,1.0
4385,90,12,29,41,2,1.0
4386,90,10,19,29,2,1.0
4387,90,6,12,18,2,1.0
4388,90,4,5,9,2,1.0
4389,90,8,7,15,2,1.0
4390,90,12,26,38,2,1.0
4391,90,9,32,41,2,1.0
4392,90,2,7,9,2,1.0
4393,90,18,19,37,2,1.0
4394,90,27,56,83,2,1.0
4395,90,67,96,163,2,1.0
4396,90,42,113,155,2,1.0
4397,90,64,97,161,2,1.0
4398,90,35,34,69,2,1.0
4399,90,58,129,187,2,1.0
4400,90,49,95,144,2,1.0
4401,90,13,54,67,2,1.0
4402,90,39,58,97,2,1.0
4403,90,26,42,68,2,1.0
4404,90,10,13,23,2,1.0
4405,90,50,104,154,2,1.0
4406,90,15,65,80,2,1.0
4407,90,15,33,48,2,1.0
4408,90,32,79,111,2,1.0
4409,90,40,81,121,2,1.0
4410,90,18,90,108,2,1.0
4411,90,72,147,219,2,1.0
4412,90,6,13,19,2,1.0
4413,90,22,59,81,2,1.0
4414,90,26,41,67,2,1.0
4415,90,12,20,32,2,1.0
4416,90,5,15,20,2,1.0
4417,90,19,61,80,2,1.0
4418,90,8,18,26,2,1.0
4419,90,2,3,5,2,1.0
4420,90,14,20,34,2,1.0
4421,90,22,89,111,2,1.0
4422,90,118,166,284,2,1.0
4423,90,58,79,137,2,1.0
4424,90,55,79,134,2,1.0
4425,90,55,228,283,2,1.0
4426,90,35,37,72,2,1.0
4427,90,74,188,262,2,1.0
4428,90,67,79,146,2,1.0
4429,90,13,47,60,2,1.0
4430,90,8,55,63,2,1.0
4431,90,36,103,139,2,1.0
4432,90,27,98,125,2,1.0
4433,90,21,46,67,2,1.0
4434,90,27,32,59,2,1.0
4435,90,16,26,42,2,1.0
4436,90,37,76,113,2,1.0
4437,90,6,17,23,2,1.0
4438,90,36,102,138,2,1.0
4439,90,17,59,76,2,1.0
4440,90,31,115,146,2,1.0
4441,90,86,108,194,2,1.0
4442,90,82,75,157,2,1.0
4443,90,44,101,145,2,1.0
4444,90,1,9,10,2,1.0
4445,90,43,72,115,2,1.0
4446,90,20,50,70,2,1.0
4447,90,4,11,15,2,1.0
4448,90,15,31,46,2,1.0
4449,90,7,6,13,2,1.0
4450,90,5,2,7,2,1.0
4451,90,2,1,3,2,1.0
4452,90,14,7,21,2,1.0
4453,90,17,11,28,2,1.0
4454,90,2,0,2,2,1.0
4455,90,0,2,2,2,1.0
4456,90,26,32,58,2,1.0
4457,90,6,3,9,2,1.0
4458,90,51,127,178,2,1.0
4459,90,36,65,101,2,1.0
4460,90,36,46,82,2,1.0
4461,90,43,80,123,2,1.0
4462,90,46,91,137,2,1.0
4463,90,169,176,345,2,1.0
4464,90,17,48,65,2,1.0
4465,90,29,94,123,2,1.0
4466,90,20,47,67,2,1.0
4467,90,23,32,55,2,1.0
4468,90,9,17,26,2,1.0
4469,90,12,19,31,2,1.0
4470,90,6,15,21,2,1.0
4471,90,4,7,11,2,1.0
4472,90,20,12,32,2,1.0
4473,90,34,41,75,2,1.0
4474,90,41,51,92,2,1.0
4475,90,53,93,146,2,1.0
4476,90,69,126,195,2,1.0
4477,90,43,60,103,2,1.0
4478,90,38,61,99,2,1.0
4479,90,27,41,68,2,1.0
4480,90,15,71,86,2,1.0
4481,90,37,31,68,2,1.0
4482,90,39,138,177,2,1.0
4483,90,11,13,24,2,1.0
4484,90,8,11,19,2,1.0
4485,90,39,24,63,2,1.0
4486,90,42,70,112,2,1.0
4487,90,49,55,104,2,1.0
4488,90,103,75,178,2,1.0
4489,90,41,64,105,2,1.0
4490,90,43,83,126,2,1.0
4491,90,8,9,17,2,1.0
4492,90,73,73,146,2,1.0
4493,90,32,44,76,2,1.0
4494,90,5,11,16,2,1.0
4495,90,39,47,86,2,1.0
4496,90,5,8,13,2,1.0
4497,90,3,8,11,2,1.0
4498,90,58,93,151,2,1.0
4499,90,55,67,122,2,1.0
4500,90,40,69,109,2,1.0
4501,90,29,39,68,2,1.0
4502,90,70,110,180,2,1.0
4503,90,61,29,90,2,1.0
4504,90,52,54,106,2,1.0
4505,90,29,68,97,2,1.0
4506,90,16,21,37,2,1.0
4507,90,36,74,110,2,1.0
4508,90,3,1,4,2,1.0
4509,90,3,6,9,2,1.0
4510,90,15,32,47,2,1.0
4511,90,32,104,136,2,1.0
4512,90,6,2,8,2,1.0
4513,90,12,24,36,2,1.0
4514,90,13,38,51,2,1.0
4515,90,61,111,172,2,1.0
4516,90,23,38,61,2,1.0
4517,90,40,57,97,2,1.0
4518,90,34,76,110,2,1.0
4519,90,22,48,70,2,1.0
4520,90,25,36,61,2,1.0
4521,90,14,30,44,2,1.0
4522,90,13,28,41,2,1.0
4523,90,25,16,41,2,1.0
4524,90,43,29,72,2,1.0
4525,90,59,74,133,2,1.0
4526,90,42,84,126,2,1.0
4527,90,22,66,88,2,1.0
4528,90,35,58,93,2,1.0
4529,90,14,40,54,2,1.0
4530,90,12,30,42,2,1.0
4531,90,25,46,71,2,1.0
4532,90,27,31,58,2,1.0
4533,90,55,47,102,2,1.0
4534,90,52,99,151,2,1.0
4535,90,22,34,56,2,1.0
4536,90,64,72,136,2,1.0
4537,90,51,69,120,2,1.0
4538,90,14,19,33,2,1.0
4539,90,20,17,37,2,1.0
4540,90,31,53,84,2,1.0
4541,90,54,73,127,2,1.0
4542,90,12,11,23,2,1.0
4543,90,14,23,37,2,1.0
4544,90,55,75,130,2,1.0
4545,90,8,13,21,2,1.0
4546,90,17,21,38,2,1.0
4547,90,18,33,51,2,1.0
4548,90,6,12,18,2,1.0
4549,90,31,37,68,2,1.0
4550,90,3,2,5,2,1.0
4551,90,27,18,45,2,1.0
4552,90,23,59,82,2,1.0
4553,90,22,74,96,2,1.0
4554,90,26,47,73,2,1.0
4555,90,24,79,103,2,1.0
4556,90,19,17,36,2,1.0
4557,90,35,75,110,2,1.0
4558,90,36,66,102,2,1.0
4559,90,41,80,121,2,1.0
4560,90,9,26,35,2,1.0
4561,90,11,23,34,2,1.0
4562,90,14,34,48,2,1.0
4563,90,2,6,8,2,1.0
4564,90,7,21,28,2,1.0
4565,90,26,67,93,2,1.0
4566,90,14,31,45,2,1.0
4567,90,6,22,28,2,1.0
4568,90,99,94,193,2,1.0
4569,90,39,79,118,2,1.0
4570,90,37,63,100,2,1.0
4571,90,42,68,110,2,1.0
4572,90,52,100,152,2,1.0
4573,90,28,39,67,2,1.0
4574,90,66,79,145,2,1.0
4575,90,11,44,55,2,1.0
4576,90,62,122,184,2,1.0
4577,90,47,129,176,2,1.0
4578,90,25,27,52,2,1.0
4579,90,17,23,40,2,1.0
4580,90,27,51,78,2,1.0
4581,90,36,53,89,2,1.0
4582,90,35,48,83,2,1.0
4583,90,15,39,54,2,1.0
4584,90,82,135,217,2,1.0
4585,90,14,43,57,2,1.0
4586,90,28,38,66,2,1.0
4587,90,30,27,57,2,1.0
4588,90,66,81,147,2,1.0
4589,90,25,36,61,2,1.0
4590,90,15,128,143,2,1.0
4591,90,11,18,29,2,1.0
4592,90,41,78,119,2,1.0
4593,90,61,75,136,2,1.0
4594,90,46,73,119,2,1.0
4595,90,31,31,62,2,1.0
4596,90,63,83,146,2,1.0
4597,90,24,39,63,2,1.0
4598,90,41,41,82,2,1.0
4599,90,23,45,68,2,1.0
4600,90,7,7,14,2,1.0
4601,90,68,67,135,2,1.0
4602,90,65,75,140,2,1.0
4603,90,58,91,149,2,1.0
4604,90,27,12,39,2,1.0
4605,90,33,55,88,2,1.0
4606,90,44,32,76,2,1.0
4607,90,9,16,25,2,1.0
4608,90,14,25,39,2,1.0
4609,90,16,35,51,2,1.0
4610,90,16,30,46,2,1.0
4611,90,31,33,64,2,1.0
4612,90,11,10,21,2,1.0
4613,90,30,32,62,2,1.0
4614,90,8,2,10,2,1.0
4615,90,29,32,61,2,1.0
4616,90,12,12,24,2,1.0
4617,90,19,43,62,2,1.0
4618,90,30,65,95,2,1.0
4619,90,53,63,116,2,1.0
4620,90,15,27,42,2,1.0
4621,90,37,66,103,2,1.0
4622,90,34,43,77,2,1.0
4623,90,28,18,46,2,1.0
4624,90,48,70,118,2,1.0
4625,90,44,85,129,2,1.0
4626,90,37,39,76,2,1.0
4627,90,42,84,126,2,1.0
4628,90,37,35,72,2,1.0
4629,90,19,16,35,2,1.0
4630,90,17,46,63,2,1.0
4631,90,23,69,92,2,1.0
4632,90,5,6,11,2,1.0
4633,90,17,26,43,2,1.0
4634,90,11,27,38,2,1.0
4635,90,8,23,31,2,1.0
4636,90,37,37,74,2,1.0
4637,90,51,56,107,2,1.0
4638,90,65,49,114,2,1.0
4639,90,42,42,84,2,1.0
4640,90,22,20,42,2,1.0
4641,90,32,36,68,2,1.0
4642,90,50,73,123,2,1.0
4643,90,26,40,66,2,1.0
4644,90,52,69,121,2,1.0
4645,90,43,78,121,2,1.0
4646,90,15,20,35,2,1.0
4647,90,20,22,42,2,1.0
4648,90,17,23,40,2,1.0
4649,90,19,16,35,2,1.0
4650,90,17,21,38,2,1.0
4651,90,17,20,37,2,1.0
4652,90,116,80,196,2,1.0
4653,90,97,96,193,2,1.0
4654,90,21,23,44,2,1.0
4655,90,47,56,103,2,1.0
4656,90,13,22,35,2,1.0
4657,90,155,182,337,2,1.0
4658,90,12,18,30,2,1.0
4659,90,20,32,52,2,1.0
4660,90,77,79,156,2,1.0
4661,90,44,84,128,2,1.0
4662,90,20,39,59,2,1.0
4663,90,39,73,112,2,1.0
4664,90,60,54,114,2,1.0
4665,90,48,39,87,2,1.0
4666,90,5,14,19,2,1.0
4667,90,11,6,17,2,1.0
4668,90,13,44,57,2,1.0
4669,90,5,5,10,2,1.0
4670,90,25,33,58,2,1.0
4671,90,2,6,8,2,1.0
4672,90,4,14,18,2,1.0
4673,90,53,67,120,2,1.0
4674,90,38,60,98,2,1.0
4675,90,44,55,99,2,1.0
4676,90,40,36,76,2,1.0
4677,90,61,70,131,2,1.0
4678,90,67,78,145,2,1.0
4679,90,53,64,117,2,1.0
4680,90,17,27,44,2,1.0
4681,90,9,19,28,2,1.0
4682,90,41,26,67,2,1.0
4683,90,15,30,45,2,1.0
4684,90,22,39,61,2,1.0
4685,90,8,14,22,2,1.0
4686,90,87,85,172,2,1.0
4687,90,81,43,124,2,1.0
4688,90,13,28,41,2,1.0
4689,90,54,74,128,2,1.0
4690,90,19,41,60,2,1.0
4691,90,30,38,68,2,1.0
4692,90,41,56,97,2,1.0
4693,90,13,30,43,2,1.0
4694,90,19,28,47,2,1.0
4695,90,43,70,113,2,1.0
4696,90,25,15,40,2,1.0
4697,90,76,85,161,2,1.0
4698,90,21,32,53,2,1.0
4699,90,34,50,84,2,1.0
4700,90,14,26,40,2,1.0
4701,90,14,16,30,2,1.0
4702,90,10,9,19,2,1.0
4703,120,44,73,117,2,1.0
4704,120,13,41,54,2,1.0
4705,120,64,77,141,2,1.0
4706,120,19,18,37,2,1.0
4707,120,37,120,157,2,1.0
4708,120,17,18,35,2,1.0
4709,120,83,128,211,2,1.0
4710,120,24,70,94,2,1.0
4711,120,105,137,242,2,1.0
4712,120,25,84,109,2,1.0
4713,120,78,197,275,2,1.0
4714,120,12,61,73,2,1.0
4715,120,25,68,93,2,1.0
4716,120,67,93,160,2,1.0
4717,120,11,35,46,2,1.0
4718,120,12,24,36,2,1.0
4719,120,14,12,26,2,1.0
4720,120,31,47,78,2,1.0
4721,120,4,8,12,2,1.0
4722,120,13,25,38,2,1.0
4723,120,73,125,198,2,1.0
4724,120,29,115,144,2,1.0
4725,120,45,75,120,2,1.0
4726,120,26,119,145,2,1.0
4727,120,20,67,87,2,1.0
4728,120,61,111,172,2,1.0
4729,120,53,101,154,2,1.0
4730,120,13,23,36,2,1.0
4731,120,12,59,71,2,1.0
4732,120,11,11,22,2,1.0
4733,120,54,94,148,2,1.0
4734,120,5,15,20,2,1.0
4735,120,27,85,112,2,1.0
4736,120,38,94,132,2,1.0
4737,120,32,67,99,2,1.0
4738,120,36,103,139,2,1.0
4739,120,26,30,56,2,1.0
4740,120,39,42,81,2,1.0
4741,120,50,108,158,2,1.0
4742,120,42,90,132,2,1.0
4743,120,65,45,110,2,1.0
4744,120,10,27,37,2,1.0
4745,120,40,59,99,2,1.0
4746,120,18,44,62,2,1.0
4747,120,14,43,57,2,1.0
4748,120,140,221,361,2,1.0
4749,120,60,110,170,2,1.0
4750,120,97,192,289,2,1.0
4751,120,84,135,219,2,1.0
4752,120,17,54,71,2,1.0
4753,120,35,112,147,2,1.0
4754,120,50,16,66,2,1.0
4755,120,4,12,16,2,1.0
4756,120,38,52,90,2,1.0
4757,120,21,74,95,2,1.0
4758,120,11,12,23,2,1.0
4759,120,19,37,56,2,1.0
4760,120,2,9,11,2,1.0
4761,120,74,91,165,2,1.0
4762,120,83,128,211,2,1.0
4763,120,82,124,206,2,1.0
4764,120,26,52,78,2,1.0
4765,120,45,77,122,2,1.0
4766,120,35,69,104,2,1.0
4767,120,47,91,138,2,1.0
4768,120,27,40,67,2,1.0
4769,120,9,33,42,2,1.0
4770,120,24,87,111,2,1.0
4771,120,22,49,71,2,1.0
4772,120,24,30,54,2,1.0
4773,120,13,29,42,2,1.0
4774,120,15,39,54,2,1.0
4775,120,5,10,15,2,1.0
4776,120,9,28,37,2,1.0
4777,120,7,9,16,2,1.0
4778,120,16,18,34,2,1.0
4779,120,22,66,88,2,1.0
4780,120,30,93,123,2,1.0
4781,120,77,111,188,2,1.0
4782,120,25,124,149,2,1.0
4783,120,23,122,145,2,1.0
4784,120,53,78,131,2,1.0
4785,120,36,95,131,2,1.0
4786,120,30,34,64,2,1.0
4787,120,22,42,64,2,1.0
4788,120,21,34,55,2,1.0
4789,120,46,56,102,2,1.0
4790,120,11,9,20,2,1.0
4791,120,7,1,8,2,1.0
4792,120,11,16,27,2,1.0
4793,120,5,15,20,2,1.0
4794,120,9,17,26,2,1.0
4795,120,49,86,135,2,1.0
4796,120,49,49,98,2,1.0
4797,120,23,20,43,2,1.0
4798,120,33,71,104,2,1.0
4799,120,83,90,173,2,1.0
4800,120,25,46,71,2,1.0
4801,120,28,51,79,2,1.0
4802,120,29,43,72,2,1.0
4803,120,69,116,185,2,1.0
4804,120,73,114,187,2,1.0
4805,120,22,30,52,2,1.0
4806,120,34,42,76,2,1.0
4807,120,20,21,41,2,1.0
4808,120,17,16,33,2,1.0
4809,120,18,11,29,2,1.0
4810,120,2,8,10,2,1.0
4811,120,18,32,50,2,1.0
4812,120,9,17,26,2,1.0
4813,120,30,27,57,2,1.0
4814,120,16,39,55,2,1.0
4815,120,2,9,11,2,1.0
4816,120,46,49,95,2,1.0
4817,120,30,51,81,2,1.0
4818,120,59,68,127,2,1.0
4819,120,37,56,93,2,1.0
4820,120,31,77,108,2,1.0
4821,120,43,94,137,2,1.0
4822,120,13,26,39,2,1.0
4823,120,4,20,24,2,1.0
4824,120,11,15,26,2,1.0
4825,120,23,30,53,2,1.0
4826,120,37,86,123,2,1.0
4827,120,15,14,29,2,1.0
4828,120,1,7,8,2,1.0
4829,120,32,72,104,2,1.0
4830,120,24,35,59,2,1.0
4831,120,6,16,22,2,1.0
4832,120,17,21,38,2,1.0
4833,120,42,63,105,2,1.0
4834,120,66,164,230,2,1.0
4835,120,38,107,145,2,1.0
4836,120,21,42,63,2,1.0
4837,120,45,217,262,2,1.0
4838,120,59,193,252,2,1.0
4839,120,30,70,100,2,1.0
4840,120,66,202,268,2,1.0
4841,120,54,142,196,2,1.0
4842,120,25,34,59,2,1.0
4843,120,105,202,307,2,1.0
4844,120,55,116,171,2,1.0
4845,120,23,74,97,2,1.0
4846,120,14,41,55,2,1.0
4847,120,3,12,15,2,1.0
4848,120,34,125,159,2,1.0
4849,120,33,46,79,2,1.0
4850,120,69,76,145,2,1.0
4851,120,41,142,183,2,1.0
4852,120,74,117,191,2,1.0
4853,120,27,128,155,2,1.0
4854,120,37,102,139,2,1.0
4855,120,55,58,113,2,1.0
4856,120,40,73,113,2,1.0
4857,120,53,62,115,2,1.0
4858,120,15,14,29,2,1.0
4859,120,66,213,279,2,1.0
4860,120,61,146,207,2,1.0
4861,120,39,200,239,2,1.0
4862,120,88,222,310,2,1.0
4863,120,42,173,215,2,1.0
4864,120,28,109,137,2,1.0
4865,120,50,91,141,2,1.0
4866,120,74,118,192,2,1.0
4867,120,25,52,77,2,1.0
4868,120,3,12,15,2,1.0
4869,120,11,15,26,2,1.0
4870,120,5,27,32,2,1.0
4871,120,29,71,100,2,1.0
4872,120,18,28,46,2,1.0
4873,120,18,30,48,2,1.0
4874,120,76,82,158,2,1.0
4875,120,16,52,68,2,1.0
4876,120,45,68,113,2,1.0
4877,120,186,243,429,2,1.0
4878,120,24,56,80,2,1.0
4879,120,25,18,43,2,1.0
4880,120,28,23,51,2,1.0
4881,120,5,8,13,2,1.0
4882,120,19,32,51,2,1.0
4883,120,26,23,49,2,1.0
4884,120,7,11,18,2,1.0
4885,120,13,8,21,2,1.0
4886,120,61,87,148,2,1.0
4887,120,58,132,190,2,1.0
4888,120,117,164,281,2,1.0
4889,120,101,264,365,2,1.0
4890,120,110,243,353,2,1.0
4891,120,2,39,41,2,1.0
4892,120,106,232,338,2,1.0
4893,120,29,74,103,2,1.0
4894,120,15,28,43,2,1.0
4895,120,49,90,139,2,1.0
4896,120,16,11,27,2,1.0
4897,120,20,28,48,2,1.0
4898,120,22,48,70,2,1.0
4899,120,9,19,28,2,1.0
4900,120,18,68,86,2,1.0
4901,120,94,202,296,2,1.0
4902,120,68,154,222,2,1.0
4903,120,43,105,148,2,1.0
4904,120,13,26,39,2,1.0
4905,120,57,82,139,2,1.0
4906,120,18,14,32,2,1.0
4907,120,26,69,95,2,1.0
4908,120,57,98,155,2,1.0
4909,120,12,25,37,2,1.0
4910,120,8,4,12,2,1.0
4911,120,10,37,47,2,1.0
4912,120,50,106,156,2,1.0
4913,120,0,0,0,2,1.0
4914,120,12,15,27,2,1.0
4915,120,4,1,5,2,1.0
4916,120,155,268,423,2,1.0
4917,120,45,138,183,2,1.0
4918,120,15,53,68,2,1.0
4919,120,80,89,169,2,1.0
4920,120,71,137,208,2,1.0
4921,120,24,55,79,2,1.0
4922,120,22,90,112,2,1.0
4923,120,33,97,130,2,1.0
4924,120,35,44,79,2,1.0
4925,120,13,20,33,2,1.0
4926,120,32,44,76,2,1.0
4927,120,14,10,24,2,1.0
4928,120,44,48,92,2,1.0
4929,120,100,100,200,2,1.0
4930,120,37,37,74,2,1.0
4931,120,179,129,308,2,1.0
4932,120,48,56,104,2,1.0
4933,120,17,23,40,2,1.0
4934,120,70,28,98,2,1.0
4935,120,21,25,46,2,1.0
4936,120,21,64,85,2,1.0
4937,120,18,48,66,2,1.0
4938,120,14,40,54,2,1.0
4939,120,19,18,37,2,1.0
4940,120,15,22,37,2,1.0
4941,120,33,70,103,2,1.0
4942,120,26,25,51,2,1.0
4943,120,11,12,23,2,1.0
4944,120,14,17,31,2,1.0
4945,120,23,47,70,2,1.0
4946,120,76,128,204,2,1.0
4947,120,20,69,89,2,1.0
4948,120,32,39,71,2,1.0
4949,120,38,52,90,2,1.0
4950,120,34,34,68,2,1.0
4951,120,38,26,64,2,1.0
4952,120,61,43,104,2,1.0
4953,120,39,58,97,2,1.0
4954,120,7,18,25,2,1.0
4955,120,15,38,53,2,1.0
4956,120,24,55,79,2,1.0
4957,120,38,48,86,2,1.0
4958,120,4,11,15,2,1.0
4959,120,28,57,85,2,1.0
4960,120,76,113,189,2,1.0
4961,120,23,19,42,2,1.0
4962,120,20,39,59,2,1.0
4963,120,18,38,56,2,1.0
4964,120,62,75,137,2,1.0
4965,120,63,104,167,2,1.0
4966,120,59,66,125,2,1.0
4967,120,52,134,186,2,1.0
4968,120,21,54,75,2,1.0
4969,120,15,18,33,2,1.0
4970,120,54,122,176,2,1.0
4971,120,75,144,219,2,1.0
4972,120,14,14,28,2,1.0
4973,120,56,45,101,2,1.0
4974,120,26,27,53,2,1.0
4975,120,55,124,179,2,1.0
4976,120,9,31,40,2,1.0
4977,120,44,61,105,2,1.0
4978,120,39,46,85,2,1.0
4979,120,41,32,73,2,1.0
4980,120,21,52,73,2,1.0
4981,120,61,108,169,2,1.0
4982,120,12,29,41,2,1.0
4983,120,37,105,142,2,1.0
4984,120,79,171,250,2,1.0
4985,120,10,19,29,2,1.0
4986,120,72,43,115,2,1.0
4987,120,23,86,109,2,1.0
4988,120,22,20,42,2,1.0
4989,120,46,60,106,2,1.0
4990,120,27,28,55,2,1.0
4991,120,26,52,78,2,1.0
4992,120,15,18,33,2,1.0
4993,120,62,105,167,2,1.0
4994,120,100,110,210,2,1.0
4995,120,48,97,145,2,1.0
4996,120,19,46,65,2,1.0
4997,120,45,105,150,2,1.0
4998,120,37,68,105,2,1.0
4999,120,27,33,60,2,1.0
5000,120,25,45,70,2,1.0
5001,120,26,61,87,2,1.0
5002,120,22,34,56,2,1.0
5003,120,21,22,43,2,1.0
5004,120,15,55,70,2,1.0
5005,120,16,27,43,2,1.0
5006,120,8,25,33,2,1.0
5007,120,10,36,46,2,1.0
5008,120,7,3,10,2,1.0
5009,120,0,0,0,2,1.0
5010,120,30,38,68,2,1.0
5011,120,26,32,58,2,1.0
5012,120,44,101,145,2,1.0
5013,120,13,27,40,2,1.0
5014,120,24,33,57,2,1.0
5015,120,56,118,174,2,1.0
5016,120,6,13,19,2,1.0
5017,120,32,118,150,2,1.0
5018,120,29,59,88,2,1.0
5019,120,71,57,128,2,1.0
5020,120,65,113,178,2,1.0
5021,120,25,55,80,2,1.0
5022,120,38,81,119,2,1.0
5023,120,21,42,63,2,1.0
5024,120,47,42,89,2,1.0
5025,120,22,28,50,2,1.0
5026,120,18,22,40,2,1.0
5027,120,77,95,172,2,1.0
5028,120,35,37,72,2,1.0
5029,120,68,140,208,2,1.0
5030,120,11,15,26,2,1.0
5031,120,60,72,132,2,1.0
5032,120,32,50,82,2,1.0
5033,120,59,88,147,2,1.0
5034,120,69,51,120,2,1.0
5035,120,17,38,55,2,1.0
5036,120,34,54,88,2,1.0
5037,120,4,13,17,2,1.0
5038,120,28,44,72,2,1.0
5039,120,16,32,48,2,1.0
5040,120,3,7,10,2,1.0
5041,120,49,110,159,2,1.0
5042,120,24,33,57,2,1.0
5043,120,58,100,158,2,1.0
5044,120,26,75,101,2,1.0
5045,120,43,169,212,2,1.0
5046,120,51,82,133,2,1.0
5047,120,49,37,86,2,1.0
5048,120,27,52,79,2,1.0
5049,120,10,29,39,2,1.0
5050,120,31,69,100,2,1.0
5051,120,19,44,63,2,1.0
5052,120,8,15,23,2,1.0
5053,120,32,62,94,2,1.0
5054,120,24,40,64,2,1.0
5055,120,9,24,33,2,1.0
5056,120,5,15,20,2,1.0
5057,120,29,38,67,2,1.0
5058,120,28,55,83,2,1.0
5059,120,42,47,89,2,1.0
5060,120,40,117,157,2,1.0
5061,120,42,75,117,2,1.0
5062,120,62,56,118,2,1.0
5063,120,56,93,149,2,1.0
5064,120,32,56,88,2,1.0
5065,120,35,78,113,2,1.0
5066,120,52,86,138,2,1.0
5067,120,40,61,101,2,1.0
5068,120,23,36,59,2,1.0
5069,120,57,74,131,2,1.0
5070,120,16,24,40,2,1.0
5071,120,3,2,5,2,1.0
5072,120,39,42,81,2,1.0
5073,120,59,79,138,2,1.0
5074,120,92,113,205,2,1.0
5075,120,7,11,18,2,1.0
5076,120,61,58,119,2,1.0
5077,120,60,71,131,2,1.0
5078,120,38,43,81,2,1.0
5079,120,44,44,88,2,1.0
5080,120,68,111,179,2,1.0
5081,120,16,13,29,2,1.0
5082,120,36,47,83,2,1.0
5083,120,18,28,46,2,1.0
5084,120,17,30,47,2,1.0
5085,120,30,54,84,2,1.0
5086,120,19,75,94,2,1.0
5087,120,34,30,64,2,1.0
5088,120,49,114,163,2,1.0
5089,120,49,110,159,2,1.0
5090,120,54,59,113,2,1.0
5091,120,67,81,148,2,1.0
5092,120,89,173,262,2,1.0
5093,120,66,161,227,2,1.0
5094,120,56,82,138,2,1.0
5095,120,11,3,14,2,1.0
5096,120,25,55,80,2,1.0
5097,120,31,28,59,2,1.0
5098,120,49,61,110,2,1.0
5099,120,25,30,55,2,1.0
5100,120,8,15,23,2,1.0
5101,120,26,20,46,2,1.0
5102,120,10,9,19,2,1.0
5103,120,14,31,45,2,1.0
5104,120,23,46,69,2,1.0
5105,120,46,89,135,2,1.0
5106,120,26,50,76,2,1.0
5107,120,41,91,132,2,1.0
5108,120,29,64,93,2,1.0
5109,120,25,44,69,2,1.0
5110,120,26,57,83,2,1.0
5111,120,17,51,68,2,1.0
5112,120,43,45,88,2,1.0
5113,120,44,47,91,2,1.0
5114,120,12,11,23,2,1.0
5115,120,8,19,27,2,1.0
5116,120,10,6,16,2,1.0
5117,120,7,6,13,2,1.0
5118,120,31,36,67,2,1.0
5119,120,70,157,227,2,1.0
5120,120,32,36,68,2,1.0
5121,120,17,43,60,2,1.0
5122,120,79,159,238,2,1.0
5123,120,27,52,79,2,1.0
5124,120,27,31,58,2,1.0
5125,120,17,40,57,2,1.0
5126,120,18,23,41,2,1.0
5127,120,17,37,54,2,1.0
5128,120,12,31,43,2,1.0
5129,120,17,41,58,2,1.0
5130,120,12,25,37,2,1.0
5131,120,3,6,9,2,1.0
5132,120,4,11,15,2,1.0
5133,120,15,22,37,2,1.0
5134,120,34,118,152,2,1.0
5135,120,54,76,130,2,1.0
5136,120,54,103,157,2,1.0
5137,120,36,74,110,2,1.0
5138,120,44,121,165,2,1.0
5139,120,61,98,159,2,1.0
5140,120,34,38,72,2,1.0
5141,120,64,102,166,2,1.0
5142,120,12,11,23,2,1.0
5143,120,18,43,61,2,1.0
5144,120,15,19,34,2,1.0
5145,120,29,37,66,2,1.0
5146,120,15,24,39,2,1.0
5147,120,6,13,19,2,1.0
5148,120,14,91,105,2,1.0
5149,120,30,27,57,2,1.0
5150,120,3,10,13,2,1.0
5151,120,89,81,170,2,1.0
5152,120,65,87,152,2,1.0
5153,120,75,36,111,2,1.0
5154,120,98,155,253,2,1.0
5155,120,54,108,162,2,1.0
5156,120,38,48,86,2,1.0
5157,120,22,48,70,2,1.0
5158,120,30,37,67,2,1.0
5159,120,14,22,36,2,1.0
5160,120,35,68,103,2,1.0
5161,120,47,69,116,2,1.0
5162,120,23,55,78,2,1.0
5163,120,20,24,44,2,1.0
5164,120,9,21,30,2,1.0
5165,120,9,22,31,2,1.0
5166,120,41,47,88,2,1.0
5167,120,6,6,12,2,1.0
5168,120,22,17,39,2,1.0
5169,180,11,75,86,2,1.0
5170,180,37,72,109,2,1.0
5171,180,37,63,100,2,1.0
5172,180,59,146,205,2,1.0
5173,180,14,46,60,2,1.0
5174,180,13,41,54,2,1.0
5175,180,23,42,65,2,1.0
5176,180,12,16,28,2,1.0
5177,180,11,15,26,2,1.0
5178,180,16,21,37,2,1.0
5179,180,4,10,14,2,1.0
5180,180,4,6,10,2,1.0
5181,180,11,15,26,2,1.0
5182,180,36,74,110,2,1.0
5183,180,32,63,95,2,1.0
5184,180,18,16,34,2,1.0
5185,180,23,31,54,2,1.0
5186,180,14,10,24,2,1.0
5187,180,35,72,107,2,1.0
5188,180,1,12,13,2,1.0
5189,180,48,112,160,2,1.0
5190,180,22,39,61,2,1.0
5191,180,22,25,47,2,1.0
5192,180,20,33,53,2,1.0
5193,180,9,30,39,2,1.0
5194,180,20,30,50,2,1.0
5195,180,1,14,15,2,1.0
5196,180,1,4,5,2,1.0
5197,180,3,14,17,2,1.0
5198,180,37,47,84,2,1.0
5199,180,30,75,105,2,1.0
5200,180,17,62,79,2,1.0
5201,180,55,84,139,2,1.0
5202,180,54,131,185,2,1.0
5203,180,22,66,88,2,1.0
5204,180,53,90,143,2,1.0
5205,180,52,82,134,2,1.0
5206,180,39,49,88,2,1.0
5207,180,23,82,105,2,1.0
5208,180,8,26,34,2,1.0
5209,180,35,42,77,2,1.0
5210,180,34,75,109,2,1.0
5211,180,10,16,26,2,1.0
5212,180,37,91,128,2,1.0
5213,180,66,67,133,2,1.0
5214,180,15,27,42,2,1.0
5215,180,22,50,72,2,1.0
5216,180,20,53,73,2,1.0
5217,180,32,34,66,2,1.0
5218,180,28,33,61,2,1.0
5219,180,32,62,94,2,1.0
5220,180,7,22,29,2,1.0
5221,180,54,53,107,2,1.0
5222,180,43,51,94,2,1.0
5223,180,72,113,185,2,1.0
5224,180,38,66,104,2,1.0
5225,180,38,57,95,2,1.0
5226,180,29,68,97,2,1.0
5227,180,18,39,57,2,1.0
5228,180,27,74,101,2,1.0
5229,180,32,52,84,2,1.0
5230,180,2,14,16,2,1.0
5231,180,7,35,42,2,1.0
5232,180,13,28,41,2,1.0
5233,180,3,13,16,2,1.0
5234,180,31,106,137,2,1.0
5235,180,35,80,115,2,1.0
5236,180,25,36,61,2,1.0
5237,180,20,38,58,2,1.0
5238,180,35,76,111,2,1.0
5239,180,35,61,96,2,1.0
5240,180,26,40,66,2,1.0
5241,180,32,45,77,2,1.0
5242,180,39,50,89,2,1.0
5243,180,39,44,83,2,1.0
5244,180,17,26,43,2,1.0
5245,180,14,15,29,2,1.0
5246,180,38,44,82,2,1.0
5247,180,25,33,58,2,1.0
5248,180,11,20,31,2,1.0
5249,180,0,2,2,2,1.0
5250,180,10,20,30,2,1.0
5251,180,76,69,145,2,1.0
5252,180,39,77,116,2,1.0
5253,180,31,43,74,2,1.0
5254,180,13,32,45,2,1.0
5255,180,26,109,135,2,1.0
5256,180,36,84,120,2,1.0
5257,180,46,72,118,2,1.0
5258,180,14,17,31,2,1.0
5259,180,71,102,173,2,1.0
5260,180,12,17,29,2,1.0
5261,180,35,58,93,2,1.0
5262,180,5,38,43,2,1.0
5263,180,10,30,40,2,1.0
5264,180,14,14,28,2,1.0
5265,180,1,6,7,2,1.0
5266,180,14,47,61,2,1.0
5267,180,60,89,149,2,1.0
5268,180,19,33,52,2,1.0
5269,180,51,107,158,2,1.0
5270,180,60,130,190,2,1.0
5271,180,55,72,127,2,1.0
5272,180,17,56,73,2,1.0
5273,180,42,82,124,2,1.0
5274,180,18,34,52,2,1.0
5275,180,7,15,22,2,1.0
5276,180,79,138,217,2,1.0
5277,180,28,54,82,2,1.0
5278,180,71,66,137,2,1.0
5279,180,11,43,54,2,1.0
5280,180,16,18,34,2,1.0
5281,180,6,29,35,2,1.0
5282,180,68,71,139,2,1.0
5283,180,21,39,60,2,1.0
5284,180,50,75,125,2,1.0
5285,180,31,57,88,2,1.0
5286,180,51,70,121,2,1.0
5287,180,63,137,200,2,1.0
5288,180,90,126,216,2,1.0
5289,180,26,59,85,2,1.0
5290,180,57,78,135,2,1.0
5291,180,112,95,207,2,1.0
5292,180,40,105,145,2,1.0
5293,180,29,83,112,2,1.0
5294,180,12,40,52,2,1.0
5295,180,27,45,72,2,1.0
5296,180,28,30,58,2,1.0
5297,180,46,130,176,2,1.0
5298,180,14,36,50,2,1.0
5299,180,5,16,21,2,1.0
5300,180,32,80,112,2,1.0
5301,180,61,93,154,2,1.0
5302,180,24,50,74,2,1.0
5303,180,30,60,90,2,1.0
5304,180,11,30,41,2,1.0
5305,180,21,40,61,2,1.0
5306,180,30,60,90,2,1.0
5307,180,18,19,37,2,1.0
5308,180,20,30,50,2,1.0
5309,180,82,102,184,2,1.0
5310,180,22,92,114,2,1.0
5311,180,4,16,20,2,1.0
5312,180,69,81,150,2,1.0
5313,180,54,28,82,2,1.0
5314,180,37,115,152,2,1.0
5315,180,45,130,175,2,1.0
5316,180,26,36,62,2,1.0
5317,180,0,23,23,2,1.0
5318,180,1,7,8,2,1.0
5319,180,25,29,54,2,1.0
5320,180,2,0,2,2,1.0
5321,180,32,31,63,2,1.0
5322,180,28,65,93,2,1.0
5323,180,32,35,67,2,1.0
5324,180,39,123,162,2,1.0
5325,180,42,95,137,2,1.0
5326,180,104,130,234,2,1.0
5327,180,74,72,146,2,1.0
5328,180,13,15,28,2,1.0
5329,180,10,11,21,2,1.0
5330,180,43,101,144,2,1.0
5331,180,20,41,61,2,1.0
5332,180,18,32,50,2,1.0
5333,180,64,132,196,2,1.0
5334,180,16,15,31,2,1.0
5335,180,12,16,28,2,1.0
5336,180,38,62,100,2,1.0
5337,180,6,8,14,2,1.0
5338,180,20,15,35,2,1.0
5339,180,23,50,73,2,1.0
5340,180,32,64,96,2,1.0
5341,180,37,67,104,2,1.0
5342,180,36,105,141,2,1.0
5343,180,29,28,57,2,1.0
5344,180,19,16,35,2,1.0
5345,180,31,54,85,2,1.0
5346,180,26,54,80,2,1.0
5347,180,27,53,80,2,1.0
5348,180,28,36,64,2,1.0
5349,180,11,21,32,2,1.0
5350,180,5,23,28,2,1.0
5351,180,3,15,18,2,1.0
5352,180,4,10,14,2,1.0
5353,180,63,120,183,2,1.0
5354,180,68,126,194,2,1.0
5355,180,31,83,114,2,1.0
5356,180,57,110,167,2,1.0
5357,180,38,94,132,2,1.0
5358,180,38,70,108,2,1.0
5359,180,28,51,79,2,1.0
5360,180,20,37,57,2,1.0
5361,180,55,87,142,2,1.0
5362,180,14,24,38,2,1.0
5363,180,37,53,90,2,1.0
5364,180,19,27,46,2,1.0
5365,180,11,22,33,2,1.0
5366,180,5,4,9,2,1.0
5367,180,60,76,136,2,1.0
5368,180,29,68,97,2,1.0
5369,180,56,128,184,2,1.0
5370,180,30,43,73,2,1.0
5371,180,83,143,226,2,1.0
5372,180,60,97,157,2,1.0
5373,180,14,43,57,2,1.0
5374,180,24,49,73,2,1.0
5375,180,26,47,73,2,1.0
5376,180,22,47,69,2,1.0
5377,180,37,31,68,2,1.0
5378,180,30,49,79,2,1.0
5379,180,7,10,17,2,1.0
5380,180,29,43,72,2,1.0
5381,180,25,38,63,2,1.0
5382,180,13,50,63,2,1.0
5383,180,28,40,68,2,1.0
5384,180,36,56,92,2,1.0
5385,180,36,68,104,2,1.0
5386,180,69,74,143,2,1.0
5387,180,44,40,84,2,1.0
5388,180,16,38,54,2,1.0
5389,180,33,34,67,2,1.0
5390,180,19,24,43,2,1.0
5391,180,17,51,68,2,1.0
5392,180,44,108,152,2,1.0
5393,180,8,11,19,2,1.0
5394,180,22,59,81,2,1.0
5395,180,50,102,152,2,1.0
5396,180,32,20,52,2,1.0
5397,180,35,60,95,2,1.0
5398,180,47,166,213,2,1.0
5399,180,30,39,69,2,1.0
5400,180,14,39,53,2,1.0
5401,180,14,41,55,2,1.0
5402,180,36,50,86,2,1.0
5403,180,6,18,24,2,1.0
5404,180,21,40,61,2,1.0
5405,180,25,49,74,2,1.0
5406,180,13,18,31,2,1.0
5407,180,60,89,149,2,1.0
5408,180,42,77,119,2,1.0
5409,180,49,113,162,2,1.0
5410,180,34,39,73,2,1.0
5411,180,61,100,161,2,1.0
5412,180,24,49,73,2,1.0
5413,180,65,60,125,2,1.0
5414,180,22,26,48,2,1.0
5415,180,24,48,72,2,1.0
5416,180,24,41,65,2,1.0
5417,180,26,69,95,2,1.0
5418,180,40,11,51,2,1.0
5419,180,23,46,69,2,1.0
5420,180,8,24,32,2,1.0
5421,180,33,41,74,2,1.0
5422,180,12,14,26,2,1.0
5423,180,29,72,101,2,1.0
5424,180,19,49,68,2,1.0
5425,180,33,71,104,2,1.0
5426,180,8,7,15,2,1.0
5427,180,11,29,40,2,1.0
5428,180,62,61,123,2,1.0
5429,180,32,43,75,2,1.0
5430,180,37,58,95,2,1.0
5431,180,33,42,75,2,1.0
5432,180,33,49,82,2,1.0
5433,180,11,12,23,2,1.0
5434,180,19,23,42,2,1.0
5435,180,20,2,22,2,1.0
5436,180,5,21,26,2,1.0
5437,180,2,4,6,2,1.0
5438,180,26,85,111,2,1.0
5439,180,30,40,70,2,1.0
5440,180,23,50,73,2,1.0
5441,180,22,32,54,2,1.0
5442,180,33,58,91,2,1.0
5443,180,17,16,33,2,1.0
5444,180,29,56,85,2,1.0
5445,180,94,113,207,2,1.0
5446,180,20,23,43,2,1.0
5447,180,19,57,76,2,1.0
5448,180,30,21,51,2,1.0
5449,180,7,17,24,2,1.0
5450,180,5,12,17,2,1.0
5451,180,44,63,107,2,1.0
5452,180,48,113,161,2,1.0
5453,180,21,26,47,2,1.0
5454,180,69,129,198,2,1.0
5455,180,30,35,65,2,1.0
5456,180,17,21,38,2,1.0
5457,180,17,30,47,2,1.0
5458,180,23,55,78,2,1.0
5459,180,23,43,66,2,1.0
5460,180,22,31,53,2,1.0
5461,180,16,15,31,2,1.0
5462,180,4,9,13,2,1.0
5463,180,7,9,16,2,1.0
5464,180,1,5,6,2,1.0
5465,180,9,14,23,2,1.0
5466,180,15,13,28,2,1.0
5467,180,20,61,81,2,1.0
5468,180,48,43,91,2,1.0
5469,180,23,56,79,2,1.0
5470,180,38,69,107,2,1.0
5471,180,25,65,90,2,1.0
5472,180,9,55,64,2,1.0
5473,180,21,19,40,2,1.0
5474,180,25,49,74,2,1.0
5475,180,15,29,44,2,1.0
5476,180,4,17,21,2,1.0
5477,180,19,68,87,2,1.0
5478,180,26,23,49,2,1.0
5479,180,23,39,62,2,1.0
5480,180,5,6,11,2,1.0
5481,180,0,7,7,2,1.0
5482,180,3,19,22,2,1.0
5483,180,22,49,71,2,1.0
5484,180,15,39,54,2,1.0
5485,180,97,160,257,2,1.0
5486,180,115,154,269,2,1.0
5487,180,43,44,87,2,1.0
5488,180,9,20,29,2,1.0
5489,180,6,20,26,2,1.0
5490,180,49,197,246,2,1.0
5491,180,10,31,41,2,1.0
5492,180,5,7,12,2,1.0
5493,180,8,22,30,2,1.0
5494,180,20,12,32,2,1.0
5495,180,2,3,5,2,1.0
5496,180,7,21,28,2,1.0
5497,180,6,21,27,2,1.0
5498,180,25,43,68,2,1.0
5499,180,14,23,37,2,1.0
5500,180,38,45,83,2,1.0
5501,180,20,27,47,2,1.0
5502,180,33,60,93,2,1.0
5503,180,19,27,46,2,1.0
5504,180,47,59,106,2,1.0
5505,180,4,18,22,2,1.0
5506,180,13,29,42,2,1.0
5507,180,3,8,11,2,1.0
5508,180,10,15,25,2,1.0
5509,180,42,112,154,2,1.0
5510,180,25,46,71,2,1.0
5511,180,9,13,22,2,1.0
5512,180,30,13,43,2,1.0
5513,180,34,39,73,2,1.0
5514,180,39,100,139,2,1.0
5515,180,18,51,69,2,1.0
5516,180,13,15,28,2,1.0
5517,180,27,41,68,2,1.0
5518,180,9,19,28,2,1.0
5519,180,32,48,80,2,1.0
5520,180,6,14,20,2,1.0
5521,180,6,13,19,2,1.0
5522,180,8,21,29,2,1.0
5523,180,3,5,8,2,1.0
5524,180,15,41,56,2,1.0
5525,180,4,5,9,2,1.0
5526,180,2,13,15,2,1.0
5527,180,4,4,8,2,1.0
5528,180,3,4,7,2,1.0
5529,180,0,4,4,2,1.0
5530,180,20,36,56,2,1.0
5531,180,28,63,91,2,1.0
5532,180,17,32,49,2,1.0
5533,180,13,41,54,2,1.0
5534,180,15,46,61,2,1.0
5535,180,27,31,58,2,1.0
5536,180,4,12,16,2,1.0
5537,180,4,4,8,2,1.0
5538,180,10,26,36,2,1.0
5539,180,24,38,62,2,1.0
5540,180,17,21,38,2,1.0
5541,180,18,29,47,2,1.0
5542,180,7,4,11,2,1.0
5543,180,2,4,6,2,1.0
5544,180,7,17,24,2,1.0
5545,180,3,20,23,2,1.0
5546,180,13,24,37,2,1.0
5547,180,10,2,12,2,1.0
5548,180,35,41,76,2,1.0
5549,180,17,56,73,2,1.0
5550,180,12,21,33,2,1.0
5551,180,31,75,106,2,1.0
5552,180,36,100,136,2,1.0
5553,180,20,47,67,2,1.0
5554,180,14,25,39,2,1.0
5555,180,23,51,74,2,1.0
5556,180,41,91,132,2,1.0
5557,180,6,9,15,2,1.0
5558,180,1,11,12,2,1.0
5559,180,1,11,12,2,1.0
5560,180,8,15,23,2,1.0
5561,180,13,12,25,2,1.0
5562,180,15,15,30,2,1.0
5563,180,9,28,37,2,1.0
5564,180,104,140,244,2,1.0
5565,180,42,55,97,2,1.0
5566,180,30,42,72,2,1.0
5567,180,25,44,69,2,1.0
5568,180,38,43,81,2,1.0
5569,180,25,34,59,2,1.0
5570,180,41,72,113,2,1.0
5571,180,13,20,33,2,1.0
5572,180,16,49,65,2,1.0
5573,180,37,65,102,2,1.0
5574,180,20,26,46,2,1.0
5575,180,4,13,17,2,1.0
5576,180,16,71,87,2,1.0
5577,180,5,8,13,2,1.0
5578,180,5,32,37,2,1.0
5579,180,36,81,117,2,1.0
5580,180,25,49,74,2,1.0
5581,180,31,46,77,2,1.0
5582,180,38,78,116,2,1.0
5583,180,36,73,109,2,1.0
5584,180,42,78,120,2,1.0
5585,180,16,24,40,2,1.0
5586,180,14,25,39,2,1.0
5587,180,5,11,16,2,1.0
5588,180,5,8,13,2,1.0
5589,180,1,18,19,2,1.0
5590,180,22,41,63,2,1.0
5591,180,50,97,147,2,1.0
5592,180,29,70,99,2,1.0
5593,180,76,120,196,2,1.0
5594,180,10,16,26,2,1.0
5595,180,22,25,47,2,1.0
5596,180,18,63,81,2,1.0
5597,180,5,3,8,2,1.0
5598,180,10,34,44,2,1.0
5599,180,9,17,26,2,1.0
5600,180,7,11,18,2,1.0
5601,180,8,32,40,2,1.0
5602,180,3,5,8,2,1.0
5603,30,34,55,89,2,10.0
5604,30,27,53,80,2,10.0
5605,30,36,53,89,2,10.0
5606,30,36,44,80,2,10.0
5607,30,52,82,134,2,10.0
5608,30,15,29,44,2,10.0
5609,30,36,74,110,2,10.0
5610,30,19,33,52,2,10.0
5611,30,27,46,73,2,10.0
5612,30,32,58,90,2,10.0
5613,30,39,40,79,2,10.0
5614,30,24,25,49,2,10.0
5615,30,14,18,32,2,10.0
5616,30,28,26,54,2,10.0
5617,30,3,19,22,2,10.0
5618,30,31,50,81,2,10.0
5619,30,45,48,93,2,10.0
5620,30,27,29,56,2,10.0
5621,30,27,31,58,2,10.0
5622,30,45,83,128,2,10.0
5623,30,53,58,111,2,10.0
5624,30,63,42,105,2,10.0
5625,30,42,48,90,2,10.0
5626,30,35,41,76,2,10.0
5627,30,52,84,136,2,10.0
5628,30,20,23,43,2,10.0
5629,30,18,26,44,2,10.0
5630,30,5,11,16,2,10.0
5631,30,20,37,57,2,10.0
5632,30,26,41,67,2,10.0
5633,30,6,5,11,2,10.0
5634,30,6,9,15,2,10.0
5635,30,2,8,10,2,10.0
5636,30,106,129,235,2,10.0
5637,30,48,46,94,2,10.0
5638,30,59,84,143,2,10.0
5639,30,10,28,38,2,10.0
5640,30,49,75,124,2,10.0
5641,30,72,43,115,2,10.0
5642,30,29,39,68,2,10.0
5643,30,28,47,75,2,10.0
5644,30,35,24,59,2,10.0
5645,30,11,17,28,2,10.0
5646,30,25,27,52,2,10.0
5647,30,50,69,119,2,10.0
5648,30,81,100,181,2,10.0
5649,30,8,19,27,2,10.0
5650,30,11,17,28,2,10.0
5651,30,22,30,52,2,10.0
5652,30,15,29,44,2,10.0
5653,30,24,25,49,2,10.0
5654,30,54,92,146,2,10.0
5655,30,32,37,69,2,10.0
5656,30,49,42,91,2,10.0
5657,30,41,81,122,2,10.0
5658,30,112,198,310,2,10.0
5659,30,20,46,66,2,10.0
5660,30,10,21,31,2,10.0
5661,30,14,17,31,2,10.0
5662,30,10,18,28,2,10.0
5663,30,19,23,42,2,10.0
5664,30,30,32,62,2,10.0
5665,30,8,23,31,2,10.0
5666,30,55,93,148,2,10.0
5667,30,31,74,105,2,10.0
5668,30,46,102,148,2,10.0
5669,30,72,123,195,2,10.0
5670,30,27,69,96,2,10.0
5671,30,15,15,30,2,10.0
5672,30,9,25,34,2,10.0
5673,30,9,38,47,2,10.0
5674,30,36,59,95,2,10.0
5675,30,10,22,32,2,10.0
5676,30,6,24,30,2,10.0
5677,30,30,45,75,2,10.0
5678,30,14,23,37,2,10.0
5679,30,11,10,21,2,10.0
5680,30,9,4,13,2,10.0
5681,30,8,22,30,2,10.0
5682,30,47,52,99,2,10.0
5683,30,7,25,32,2,10.0
5684,30,79,111,190,2,10.0
5685,30,7,19,26,2,10.0
5686,30,9,28,37,2,10.0
5687,30,45,64,109,2,10.0
5688,30,27,47,74,2,10.0
5689,30,25,48,73,2,10.0
5690,30,42,50,92,2,10.0
5691,30,26,29,55,2,10.0
5692,30,31,78,109,2,10.0
5693,30,38,62,100,2,10.0
5694,30,16,38,54,2,10.0
5695,30,15,34,49,2,10.0
5696,30,4,15,19,2,10.0
5697,30,63,146,209,2,10.0
5698,30,49,63,112,2,10.0
5699,30,41,62,103,2,10.0
5700,30,62,53,115,2,10.0
5701,30,45,60,105,2,10.0
5702,30,34,62,96,2,10.0
5703,30,45,43,88,2,10.0
5704,30,45,92,137,2,10.0
5705,30,24,42,66,2,10.0
5706,30,16,10,26,2,10.0
5707,30,0,2,2,2,10.0
5708,30,3,6,9,2,10.0
5709,30,65,134,199,2,10.0
5710,30,34,87,121,2,10.0
5711,30,36,72,108,2,10.0
5712,30,43,84,127,2,10.0
5713,30,37,53,90,2,10.0
5714,30,47,59,106,2,10.0
5715,30,60,77,137,2,10.0
5716,30,32,47,79,2,10.0
5717,30,28,38,66,2,10.0
5718,30,3,4,7,2,10.0
5719,30,28,42,70,2,10.0
5720,30,5,14,19,2,10.0
5721,30,2,7,9,2,10.0
5722,30,20,25,45,2,10.0
5723,30,62,90,152,2,10.0
5724,30,80,81,161,2,10.0
5725,30,24,95,119,2,10.0
5726,30,71,161,232,2,10.0
5727,30,44,110,154,2,10.0
5728,30,16,66,82,2,10.0
5729,30,75,95,170,2,10.0
5730,30,24,56,80,2,10.0
5731,30,50,60,110,2,10.0
5732,30,24,74,98,2,10.0
5733,30,69,140,209,2,10.0
5734,30,30,52,82,2,10.0
5735,30,15,24,39,2,10.0
5736,30,9,6,15,2,10.0
5737,30,21,59,80,2,10.0
5738,30,14,22,36,2,10.0
5739,30,36,53,89,2,10.0
5740,30,65,134,199,2,10.0
5741,30,54,60,114,2,10.0
5742,30,38,68,106,2,10.0
5743,30,14,18,32,2,10.0
5744,30,24,23,47,2,10.0
5745,30,17,16,33,2,10.0
5746,30,33,29,62,2,10.0
5747,30,36,48,84,2,10.0
5748,30,38,20,58,2,10.0
5749,30,8,15,23,2,10.0
5750,30,6,9,15,2,10.0
5751,30,17,14,31,2,10.0
5752,30,26,18,44,2,10.0
5753,30,22,35,57,2,10.0
5754,30,38,68,106,2,10.0
5755,30,26,40,66,2,10.0
5756,30,13,23,36,2,10.0
5757,30,47,74,121,2,10.0
5758,30,24,32,56,2,10.0
5759,30,37,45,82,2,10.0
5760,30,28,55,83,2,10.0
5761,30,49,69,118,2,10.0
5762,30,16,24,40,2,10.0
5763,30,4,12,16,2,10.0
5764,30,5,12,17,2,10.0
5765,30,6,16,22,2,10.0
5766,30,4,3,7,2,10.0
5767,30,13,10,23,2,10.0
5768,30,4,4,8,2,10.0
5769,30,0,0,0,2,10.0
5770,30,19,28,47,2,10.0
5771,30,30,20,50,2,10.0
5772,30,19,46,65,2,10.0
5773,30,8,12,20,2,10.0
5774,30,92,140,232,2,10.0
5775,30,27,43,70,2,10.0
5776,30,131,170,301,2,10.0
5777,30,114,177,291,2,10.0
5778,30,53,48,101,2,10.0
5779,30,48,46,94,2,10.0
5780,30,20,17,37,2,10.0
5781,30,14,10,24,2,10.0
5782,30,12,10,22,2,10.0
5783,30,17,16,33,2,10.0
5784,30,34,37,71,2,10.0
5785,30,40,40,80,2,10.0
5786,30,133,225,358,2,10.0
5787,30,46,47,93,2,10.0
5788,30,101,133,234,2,10.0
5789,30,66,101,167,2,10.0
5790,30,76,141,217,2,10.0
5791,30,184,194,378,2,10.0
5792,30,11,16,27,2,10.0
5793,30,4,8,12,2,10.0
5794,30,85,101,186,2,10.0
5795,30,109,128,237,2,10.0
5796,30,77,129,206,2,10.0
5797,30,52,129,181,2,10.0
5798,30,69,111,180,2,10.0
5799,30,86,104,190,2,10.0
5800,30,86,131,217,2,10.0
5801,30,62,92,154,2,10.0
5802,30,28,52,80,2,10.0
5803,30,18,24,42,2,10.0
5804,30,61,65,126,2,10.0
5805,30,0,0,0,2,10.0
5806,30,2,5,7,2,10.0
5807,30,32,57,89,2,10.0
5808,30,21,9,30,2,10.0
5809,30,31,38,69,2,10.0
5810,30,4,41,45,2,10.0
5811,30,52,55,107,2,10.0
5812,30,51,106,157,2,10.0
5813,30,38,49,87,2,10.0
5814,30,26,57,83,2,10.0
5815,30,54,56,110,2,10.0
5816,30,35,66,101,2,10.0
5817,30,7,12,19,2,10.0
5818,30,20,66,86,2,10.0
5819,30,20,49,69,2,10.0
5820,30,20,62,82,2,10.0
5821,30,3,4,7,2,10.0
5822,30,46,72,118,2,10.0
5823,30,23,52,75,2,10.0
5824,30,49,48,97,2,10.0
5825,30,34,34,68,2,10.0
5826,30,73,104,177,2,10.0
5827,30,32,40,72,2,10.0
5828,30,21,25,46,2,10.0
5829,30,34,66,100,2,10.0
5830,30,15,28,43,2,10.0
5831,30,25,20,45,2,10.0
5832,30,26,32,58,2,10.0
5833,30,19,23,42,2,10.0
5834,30,10,85,95,2,10.0
5835,30,1,3,4,2,10.0
5836,30,10,9,19,2,10.0
5837,30,10,16,26,2,10.0
5838,30,2,2,4,2,10.0
5839,30,5,3,8,2,10.0
5840,30,43,22,65,2,10.0
5841,30,39,105,144,2,10.0
5842,30,38,73,111,2,10.0
5843,30,52,86,138,2,10.0
5844,30,43,41,84,2,10.0
5845,30,10,27,37,2,10.0
5846,30,24,25,49,2,10.0
5847,30,62,59,121,2,10.0
5848,30,44,88,132,2,10.0
5849,30,28,36,64,2,10.0
5850,30,29,58,87,2,10.0
5851,30,13,81,94,2,10.0
5852,30,18,34,52,2,10.0
5853,30,6,135,141,2,10.0
5854,30,18,26,44,2,10.0
5855,30,82,106,188,2,10.0
5856,30,15,5,20,2,10.0
5857,30,81,107,188,2,10.0
5858,30,27,84,111,2,10.0
5859,30,74,69,143,2,10.0
5860,30,91,121,212,2,10.0
5861,30,14,29,43,2,10.0
5862,30,36,54,90,2,10.0
5863,30,24,49,73,2,10.0
5864,30,13,27,40,2,10.0
5865,30,16,23,39,2,10.0
5866,30,11,12,23,2,10.0
5867,30,24,25,49,2,10.0
5868,30,1,3,4,2,10.0
5869,30,7,7,14,2,10.0
5870,30,2,6,8,2,10.0
5871,30,65,102,167,2,10.0
5872,30,13,29,42,2,10.0
5873,30,26,64,90,2,10.0
5874,30,47,73,120,2,10.0
5875,30,53,100,153,2,10.0
5876,30,36,39,75,2,10.0
5877,30,37,22,59,2,10.0
5878,30,24,31,55,2,10.0
5879,30,22,13,35,2,10.0
5880,30,78,121,199,2,10.0
5881,30,46,77,123,2,10.0
5882,30,22,64,86,2,10.0
5883,30,22,48,70,2,10.0
5884,30,29,31,60,2,10.0
5885,30,16,24,40,2,10.0
5886,30,17,17,34,2,10.0
5887,30,68,70,138,2,10.0
5888,30,73,105,178,2,10.0
5889,30,40,79,119,2,10.0
5890,30,24,40,64,2,10.0
5891,30,44,89,133,2,10.0
5892,30,64,73,137,2,10.0
5893,30,34,91,125,2,10.0
5894,30,37,49,86,2,10.0
5895,30,20,29,49,2,10.0
5896,30,4,13,17,2,10.0
5897,30,5,2,7,2,10.0
5898,30,20,65,85,2,10.0
5899,30,35,47,82,2,10.0
5900,30,33,54,87,2,10.0
5901,30,57,77,134,2,10.0
5902,30,24,36,60,2,10.0
5903,30,18,46,64,2,10.0
5904,30,50,106,156,2,10.0
5905,30,41,86,127,2,10.0
5906,30,31,56,87,2,10.0
5907,30,20,28,48,2,10.0
5908,30,22,39,61,2,10.0
5909,30,9,8,17,2,10.0
5910,30,25,18,43,2,10.0
5911,30,7,10,17,2,10.0
5912,30,4,5,9,2,10.0
5913,30,24,54,78,2,10.0
5914,30,46,62,108,2,10.0
5915,30,11,13,24,2,10.0
5916,30,44,55,99,2,10.0
5917,30,65,95,160,2,10.0
5918,30,13,25,38,2,10.0
5919,30,89,137,226,2,10.0
5920,30,24,56,80,2,10.0
5921,30,35,58,93,2,10.0
5922,30,7,30,37,2,10.0
5923,30,26,31,57,2,10.0
5924,30,28,45,73,2,10.0
5925,30,20,12,32,2,10.0
5926,30,42,44,86,2,10.0
5927,30,14,7,21,2,10.0
5928,30,9,9,18,2,10.0
5929,30,27,94,121,2,10.0
5930,30,54,86,140,2,10.0
5931,30,65,100,165,2,10.0
5932,30,51,66,117,2,10.0
5933,30,79,191,270,2,10.0
5934,30,65,120,185,2,10.0
5935,30,34,36,70,2,10.0
5936,30,17,35,52,2,10.0
5937,30,25,28,53,2,10.0
5938,30,40,60,100,2,10.0
5939,30,18,27,45,2,10.0
5940,30,37,98,135,2,10.0
5941,30,8,13,21,2,10.0
5942,30,62,74,136,2,10.0
5943,30,71,170,241,2,10.0
5944,30,22,49,71,2,10.0
5945,30,14,32,46,2,10.0
5946,30,33,48,81,2,10.0
5947,30,29,99,128,2,10.0
5948,30,24,31,55,2,10.0
5949,30,58,95,153,2,10.0
5950,30,65,96,161,2,10.0
5951,30,31,44,75,2,10.0
5952,30,14,27,41,2,10.0
5953,30,34,58,92,2,10.0
5954,30,12,10,22,2,10.0
5955,30,5,9,14,2,10.0
5956,30,28,60,88,2,10.0
5957,30,84,173,257,2,10.0
5958,30,4,9,13,2,10.0
5959,30,87,80,167,2,10.0
5960,30,13,24,37,2,10.0
5961,30,27,74,101,2,10.0
5962,30,29,40,69,2,10.0
5963,30,41,85,126,2,10.0
5964,30,15,79,94,2,10.0
5965,30,21,50,71,2,10.0
5966,30,10,15,25,2,10.0
5967,30,28,46,74,2,10.0
5968,30,10,10,20,2,10.0
5969,30,8,17,25,2,10.0
5970,30,46,146,192,2,10.0
5971,30,55,74,129,2,10.0
5972,30,29,59,88,2,10.0
5973,30,12,12,24,2,10.0
5974,30,39,66,105,2,10.0
5975,30,52,90,142,2,10.0
5976,30,24,73,97,2,10.0
5977,30,22,41,63,2,10.0
5978,30,25,36,61,2,10.0
5979,30,15,44,59,2,10.0
5980,30,13,21,34,2,10.0
5981,30,3,6,9,2,10.0
5982,30,15,18,33,2,10.0
5983,30,35,47,82,2,10.0
5984,30,39,74,113,2,10.0
5985,30,38,54,92,2,10.0
5986,30,80,101,181,2,10.0
5987,30,42,58,100,2,10.0
5988,30,9,34,43,2,10.0
5989,30,35,29,64,2,10.0
5990,30,53,113,166,2,10.0
5991,30,64,90,154,2,10.0
5992,30,64,124,188,2,10.0
5993,30,22,23,45,2,10.0
5994,30,10,14,24,2,10.0
5995,30,4,3,7,2,10.0
5996,30,38,46,84,2,10.0
5997,30,27,44,71,2,10.0
5998,30,30,69,99,2,10.0
5999,30,85,188,273,2,10.0
6000,30,26,46,72,2,10.0
6001,30,22,36,58,2,10.0
6002,30,64,105,169,2,10.0
6003,30,15,13,28,2,10.0
6004,30,16,27,43,2,10.0
6005,30,54,90,144,2,10.0
6006,30,47,85,132,2,10.0
6007,30,1,3,4,2,10.0
6008,30,13,49,62,2,10.0
6009,30,17,30,47,2,10.0
6010,30,20,58,78,2,10.0
6011,30,9,11,20,2,10.0
6012,30,12,32,44,2,10.0
6013,30,5,3,8,2,10.0
6014,30,15,27,42,2,10.0
6015,30,20,46,66,2,10.0
6016,30,57,85,142,2,10.0
6017,30,62,88,150,2,10.0
6018,30,46,69,115,2,10.0
6019,30,18,18,36,2,10.0
6020,30,42,59,101,2,10.0
6021,30,23,31,54,2,10.0
6022,30,21,41,62,2,10.0
6023,30,8,13,21,2,10.0
6024,30,40,36,76,2,10.0
6025,30,18,21,39,2,10.0
6026,30,50,51,101,2,10.0
6027,30,8,9,17,2,10.0
6028,30,7,5,12,2,10.0
6029,30,2,0,2,2,10.0
6030,30,7,20,27,2,10.0
6031,30,24,23,47,2,10.0
6032,30,57,92,149,2,10.0
6033,30,4,8,12,2,10.0
6034,30,16,22,38,2,10.0
6035,30,164,265,429,2,10.0
6036,30,96,123,219,2,10.0
6037,30,31,35,66,2,10.0
6038,30,37,59,96,2,10.0
6039,30,30,56,86,2,10.0
6040,30,28,29,57,2,10.0
6041,30,21,20,41,2,10.0
6042,30,2,8,10,2,10.0
6043,30,42,58,100,2,10.0
6044,30,16,20,36,2,10.0
6045,30,20,39,59,2,10.0
6046,30,10,6,16,2,10.0
6047,30,2,5,7,2,10.0
6048,30,1,3,4,2,10.0
6049,50,28,63,91,2,10.0
6050,50,45,71,116,2,10.0
6051,50,50,62,112,2,10.0
6052,50,165,176,341,2,10.0
6053,50,76,155,231,2,10.0
6054,50,106,203,309,2,10.0
6055,50,22,30,52,2,10.0
6056,50,23,38,61,2,10.0
6057,50,18,30,48,2,10.0
6058,50,17,36,53,2,10.0
6059,50,28,36,64,2,10.0
6060,50,40,94,134,2,10.0
6061,50,4,12,16,2,10.0
6062,50,11,19,30,2,10.0
6063,50,98,180,278,2,10.0
6064,50,93,179,272,2,10.0
6065,50,33,105,138,2,10.0
6066,50,47,225,272,2,10.0
6067,50,72,194,266,2,10.0
6068,50,67,79,146,2,10.0
6069,50,40,113,153,2,10.0
6070,50,74,232,306,2,10.0
6071,50,56,179,235,2,10.0
6072,50,50,129,179,2,10.0
6073,50,14,42,56,2,10.0
6074,50,13,16,29,2,10.0
6075,50,42,80,122,2,10.0
6076,50,20,44,64,2,10.0
6077,50,77,187,264,2,10.0
6078,50,98,116,214,2,10.0
6079,50,138,197,335,2,10.0
6080,50,66,183,249,2,10.0
6081,50,91,107,198,2,10.0
6082,50,148,170,318,2,10.0
6083,50,56,116,172,2,10.0
6084,50,74,124,198,2,10.0
6085,50,49,80,129,2,10.0
6086,50,29,35,64,2,10.0
6087,50,20,61,81,2,10.0
6088,50,34,36,70,2,10.0
6089,50,47,105,152,2,10.0
6090,50,33,85,118,2,10.0
6091,50,41,92,133,2,10.0
6092,50,12,40,52,2,10.0
6093,50,90,73,163,2,10.0
6094,50,40,107,147,2,10.0
6095,50,28,59,87,2,10.0
6096,50,32,34,66,2,10.0
6097,50,45,125,170,2,10.0
6098,50,31,70,101,2,10.0
6099,50,46,86,132,2,10.0
6100,50,51,105,156,2,10.0
6101,50,41,72,113,2,10.0
6102,50,33,70,103,2,10.0
6103,50,21,21,42,2,10.0
6104,50,4,4,8,2,10.0
6105,50,81,108,189,2,10.0
6106,50,105,159,264,2,10.0
6107,50,51,97,148,2,10.0
6108,50,46,70,116,2,10.0
6109,50,31,57,88,2,10.0
6110,50,68,143,211,2,10.0
6111,50,48,92,140,2,10.0
6112,50,47,76,123,2,10.0
6113,50,70,101,171,2,10.0
6114,50,63,91,154,2,10.0
6115,50,9,11,20,2,10.0
6116,50,22,33,55,2,10.0
6117,50,21,20,41,2,10.0
6118,50,18,33,51,2,10.0
6119,50,35,27,62,2,10.0
6120,50,72,124,196,2,10.0
6121,50,44,80,124,2,10.0
6122,50,14,14,28,2,10.0
6123,50,93,160,253,2,10.0
6124,50,109,170,279,2,10.0
6125,50,85,130,215,2,10.0
6126,50,54,72,126,2,10.0
6127,50,77,193,270,2,10.0
6128,50,95,175,270,2,10.0
6129,50,113,200,313,2,10.0
6130,50,41,41,82,2,10.0
6131,50,158,127,285,2,10.0
6132,50,47,106,153,2,10.0
6133,50,23,66,89,2,10.0
6134,50,3,29,32,2,10.0
6135,50,10,7,17,2,10.0
6136,50,7,5,12,2,10.0
6137,50,107,168,275,2,10.0
6138,50,51,113,164,2,10.0
6139,50,105,145,250,2,10.0
6140,50,66,99,165,2,10.0
6141,50,53,102,155,2,10.0
6142,50,84,175,259,2,10.0
6143,50,145,334,479,2,10.0
6144,50,124,256,380,2,10.0
6145,50,47,90,137,2,10.0
6146,50,16,49,65,2,10.0
6147,50,42,91,133,2,10.0
6148,50,14,21,35,2,10.0
6149,50,28,26,54,2,10.0
6150,50,102,135,237,2,10.0
6151,50,55,110,165,2,10.0
6152,50,36,42,78,2,10.0
6153,50,139,175,314,2,10.0
6154,50,107,132,239,2,10.0
6155,50,70,80,150,2,10.0
6156,50,57,26,83,2,10.0
6157,50,122,275,397,2,10.0
6158,50,38,62,100,2,10.0
6159,50,65,61,126,2,10.0
6160,50,7,15,22,2,10.0
6161,50,61,111,172,2,10.0
6162,50,40,108,148,2,10.0
6163,50,8,3,11,2,10.0
6164,50,46,78,124,2,10.0
6165,50,52,38,90,2,10.0
6166,50,125,124,249,2,10.0
6167,50,77,170,247,2,10.0
6168,50,46,71,117,2,10.0
6169,50,49,53,102,2,10.0
6170,50,100,216,316,2,10.0
6171,50,69,140,209,2,10.0
6172,50,59,57,116,2,10.0
6173,50,113,164,277,2,10.0
6174,50,48,78,126,2,10.0
6175,50,21,29,50,2,10.0
6176,50,12,12,24,2,10.0
6177,50,7,19,26,2,10.0
6178,50,75,181,256,2,10.0
6179,50,31,76,107,2,10.0
6180,50,89,154,243,2,10.0
6181,50,38,41,79,2,10.0
6182,50,78,108,186,2,10.0
6183,50,19,55,74,2,10.0
6184,50,18,88,106,2,10.0
6185,50,74,102,176,2,10.0
6186,50,23,39,62,2,10.0
6187,50,26,48,74,2,10.0
6188,50,25,46,71,2,10.0
6189,50,13,38,51,2,10.0
6190,50,20,59,79,2,10.0
6191,50,85,115,200,2,10.0
6192,50,53,76,129,2,10.0
6193,50,35,22,57,2,10.0
6194,50,93,104,197,2,10.0
6195,50,30,19,49,2,10.0
6196,50,54,81,135,2,10.0
6197,50,34,78,112,2,10.0
6198,50,42,78,120,2,10.0
6199,50,68,112,180,2,10.0
6200,50,76,198,274,2,10.0
6201,50,58,78,136,2,10.0
6202,50,20,8,28,2,10.0
6203,50,49,110,159,2,10.0
6204,50,40,68,108,2,10.0
6205,50,41,68,109,2,10.0
6206,50,78,110,188,2,10.0
6207,50,52,67,119,2,10.0
6208,50,38,49,87,2,10.0
6209,50,30,58,88,2,10.0
6210,50,4,9,13,2,10.0
6211,50,48,54,102,2,10.0
6212,50,20,61,81,2,10.0
6213,50,62,73,135,2,10.0
6214,50,48,89,137,2,10.0
6215,50,34,97,131,2,10.0
6216,50,43,84,127,2,10.0
6217,50,23,32,55,2,10.0
6218,50,54,107,161,2,10.0
6219,50,35,47,82,2,10.0
6220,50,37,111,148,2,10.0
6221,50,18,28,46,2,10.0
6222,50,30,39,69,2,10.0
6223,50,58,97,155,2,10.0
6224,50,24,36,60,2,10.0
6225,50,28,62,90,2,10.0
6226,50,14,37,51,2,10.0
6227,50,19,97,116,2,10.0
6228,50,12,28,40,2,10.0
6229,50,48,97,145,2,10.0
6230,50,70,101,171,2,10.0
6231,50,55,70,125,2,10.0
6232,50,114,128,242,2,10.0
6233,50,47,127,174,2,10.0
6234,50,28,44,72,2,10.0
6235,50,20,69,89,2,10.0
6236,50,10,31,41,2,10.0
6237,50,38,44,82,2,10.0
6238,50,42,152,194,2,10.0
6239,50,32,68,100,2,10.0
6240,50,32,42,74,2,10.0
6241,50,25,19,44,2,10.0
6242,50,19,50,69,2,10.0
6243,50,67,129,196,2,10.0
6244,50,91,136,227,2,10.0
6245,50,41,44,85,2,10.0
6246,50,66,141,207,2,10.0
6247,50,41,83,124,2,10.0
6248,50,13,33,46,2,10.0
6249,50,91,178,269,2,10.0
6250,50,43,63,106,2,10.0
6251,50,28,73,101,2,10.0
6252,50,41,59,100,2,10.0
6253,50,2,7,9,2,10.0
6254,50,41,99,140,2,10.0
6255,50,75,118,193,2,10.0
6256,50,97,147,244,2,10.0
6257,50,102,152,254,2,10.0
6258,50,83,122,205,2,10.0
6259,50,57,84,141,2,10.0
6260,50,14,29,43,2,10.0
6261,50,84,90,174,2,10.0
6262,50,59,97,156,2,10.0
6263,50,79,121,200,2,10.0
6264,50,24,25,49,2,10.0
6265,50,67,102,169,2,10.0
6266,50,23,53,76,2,10.0
6267,50,21,23,44,2,10.0
6268,50,96,210,306,2,10.0
6269,50,76,126,202,2,10.0
6270,50,59,112,171,2,10.0
6271,50,46,83,129,2,10.0
6272,50,59,102,161,2,10.0
6273,50,93,201,294,2,10.0
6274,50,39,64,103,2,10.0
6275,50,41,61,102,2,10.0
6276,50,28,81,109,2,10.0
6277,50,28,53,81,2,10.0
6278,50,44,72,116,2,10.0
6279,50,19,27,46,2,10.0
6280,50,26,56,82,2,10.0
6281,50,9,8,17,2,10.0
6282,50,9,29,38,2,10.0
6283,50,97,128,225,2,10.0
6284,50,182,254,436,2,10.0
6285,50,20,77,97,2,10.0
6286,50,44,94,138,2,10.0
6287,50,46,170,216,2,10.0
6288,50,23,68,91,2,10.0
6289,50,36,106,142,2,10.0
6290,50,20,32,52,2,10.0
6291,50,15,36,51,2,10.0
6292,50,74,77,151,2,10.0
6293,50,60,154,214,2,10.0
6294,50,58,89,147,2,10.0
6295,50,108,158,266,2,10.0
6296,50,38,44,82,2,10.0
6297,50,63,93,156,2,10.0
6298,50,67,70,137,2,10.0
6299,50,94,219,313,2,10.0
6300,50,48,98,146,2,10.0
6301,50,50,148,198,2,10.0
6302,50,25,39,64,2,10.0
6303,50,3,4,7,2,10.0
6304,50,7,12,19,2,10.0
6305,50,53,109,162,2,10.0
6306,50,17,13,30,2,10.0
6307,50,2,10,12,2,10.0
6308,50,49,31,80,2,10.0
6309,50,179,230,409,2,10.0
6310,50,1,20,21,2,10.0
6311,50,30,69,99,2,10.0
6312,50,27,71,98,2,10.0
6313,50,25,48,73,2,10.0
6314,50,11,18,29,2,10.0
6315,50,32,76,108,2,10.0
6316,50,62,102,164,2,10.0
6317,50,27,48,75,2,10.0
6318,50,23,42,65,2,10.0
6319,50,22,43,65,2,10.0
6320,50,21,33,54,2,10.0
6321,50,21,83,104,2,10.0
6322,50,79,81,160,2,10.0
6323,50,89,179,268,2,10.0
6324,50,54,154,208,2,10.0
6325,50,57,71,128,2,10.0
6326,50,39,106,145,2,10.0
6327,50,23,96,119,2,10.0
6328,50,35,105,140,2,10.0
6329,50,13,15,28,2,10.0
6330,50,83,116,199,2,10.0
6331,50,92,91,183,2,10.0
6332,50,92,189,281,2,10.0
6333,50,45,72,117,2,10.0
6334,50,34,48,82,2,10.0
6335,50,27,54,81,2,10.0
6336,50,17,28,45,2,10.0
6337,50,10,10,20,2,10.0
6338,50,11,14,25,2,10.0
6339,50,17,43,60,2,10.0
6340,50,6,15,21,2,10.0
6341,50,2,8,10,2,10.0
6342,50,67,90,157,2,10.0
6343,50,77,141,218,2,10.0
6344,50,27,71,98,2,10.0
6345,50,96,174,270,2,10.0
6346,50,77,124,201,2,10.0
6347,50,35,62,97,2,10.0
6348,50,93,140,233,2,10.0
6349,50,67,103,170,2,10.0
6350,50,84,261,345,2,10.0
6351,50,66,159,225,2,10.0
6352,50,64,66,130,2,10.0
6353,50,46,99,145,2,10.0
6354,50,16,34,50,2,10.0
6355,50,18,27,45,2,10.0
6356,50,47,37,84,2,10.0
6357,50,59,70,129,2,10.0
6358,50,81,131,212,2,10.0
6359,50,35,59,94,2,10.0
6360,50,49,105,154,2,10.0
6361,50,51,132,183,2,10.0
6362,50,68,131,199,2,10.0
6363,50,82,98,180,2,10.0
6364,50,32,81,113,2,10.0
6365,50,87,91,178,2,10.0
6366,50,53,103,156,2,10.0
6367,50,39,67,106,2,10.0
6368,50,13,28,41,2,10.0
6369,50,14,23,37,2,10.0
6370,50,3,9,12,2,10.0
6371,50,7,19,26,2,10.0
6372,50,8,0,8,2,10.0
6373,50,9,3,12,2,10.0
6374,50,102,146,248,2,10.0
6375,50,62,94,156,2,10.0
6376,50,16,22,38,2,10.0
6377,50,116,146,262,2,10.0
6378,50,69,191,260,2,10.0
6379,50,48,86,134,2,10.0
6380,50,96,234,330,2,10.0
6381,50,87,110,197,2,10.0
6382,50,98,212,310,2,10.0
6383,50,72,118,190,2,10.0
6384,50,45,125,170,2,10.0
6385,50,86,122,208,2,10.0
6386,50,70,128,198,2,10.0
6387,50,24,78,102,2,10.0
6388,50,50,50,100,2,10.0
6389,50,35,65,100,2,10.0
6390,50,88,155,243,2,10.0
6391,50,27,42,69,2,10.0
6392,50,36,123,159,2,10.0
6393,50,124,186,310,2,10.0
6394,50,175,257,432,2,10.0
6395,50,38,83,121,2,10.0
6396,50,39,115,154,2,10.0
6397,50,27,45,72,2,10.0
6398,50,20,35,55,2,10.0
6399,50,25,20,45,2,10.0
6400,50,6,19,25,2,10.0
6401,50,18,41,59,2,10.0
6402,50,8,40,48,2,10.0
6403,50,13,44,57,2,10.0
6404,50,9,21,30,2,10.0
6405,50,123,209,332,2,10.0
6406,50,36,43,79,2,10.0
6407,50,94,226,320,2,10.0
6408,50,58,166,224,2,10.0
6409,50,87,205,292,2,10.0
6410,50,100,190,290,2,10.0
6411,50,59,155,214,2,10.0
6412,50,88,160,248,2,10.0
6413,50,16,66,82,2,10.0
6414,50,32,90,122,2,10.0
6415,50,15,16,31,2,10.0
6416,50,61,120,181,2,10.0
6417,50,26,67,93,2,10.0
6418,50,19,52,71,2,10.0
6419,50,26,59,85,2,10.0
6420,50,52,49,101,2,10.0
6421,50,83,141,224,2,10.0
6422,50,58,88,146,2,10.0
6423,50,65,71,136,2,10.0
6424,50,51,35,86,2,10.0
6425,50,73,128,201,2,10.0
6426,50,14,19,33,2,10.0
6427,50,34,33,67,2,10.0
6428,50,45,98,143,2,10.0
6429,50,49,119,168,2,10.0
6430,50,22,56,78,2,10.0
6431,50,23,81,104,2,10.0
6432,50,36,57,93,2,10.0
6433,50,35,89,124,2,10.0
6434,50,93,91,184,2,10.0
6435,50,12,14,26,2,10.0
6436,50,37,41,78,2,10.0
6437,50,11,22,33,2,10.0
6438,50,48,109,157,2,10.0
6439,50,74,125,199,2,10.0
6440,50,28,43,71,2,10.0
6441,50,40,58,98,2,10.0
6442,50,50,147,197,2,10.0
6443,50,32,78,110,2,10.0
6444,50,15,25,40,2,10.0
6445,50,8,32,40,2,10.0
6446,50,1,1,2,2,10.0
6447,50,1,5,6,2,10.0
6448,50,60,108,168,2,10.0
6449,50,77,60,137,2,10.0
6450,50,64,81,145,2,10.0
6451,50,8,18,26,2,10.0
6452,50,17,22,39,2,10.0
6453,50,20,29,49,2,10.0
6454,75,48,28,76,2,10.0
6455,75,86,186,272,2,10.0
6456,75,50,121,171,2,10.0
6457,75,65,144,209,2,10.0
6458,75,84,126,210,2,10.0
6459,75,68,137,205,2,10.0
6460,75,85,231,316,2,10.0
6461,75,119,144,263,2,10.0
6462,75,78,167,245,2,10.0
6463,75,82,123,205,2,10.0
6464,75,33,82,115,2,10.0
6465,75,50,93,143,2,10.0
6466,75,21,47,68,2,10.0
6467,75,87,163,250,2,10.0
6468,75,20,47,67,2,10.0
6469,75,110,180,290,2,10.0
6470,75,97,210,307,2,10.0
6471,75,146,257,403,2,10.0
6472,75,62,217,279,2,10.0
6473,75,55,107,162,2,10.0
6474,75,83,59,142,2,10.0
6475,75,60,137,197,2,10.0
6476,75,98,170,268,2,10.0
6477,75,43,111,154,2,10.0
6478,75,114,222,336,2,10.0
6479,75,112,197,309,2,10.0
6480,75,171,294,465,2,10.0
6481,75,140,284,424,2,10.0
6482,75,12,14,26,2,10.0
6483,75,40,123,163,2,10.0
6484,75,77,213,290,2,10.0
6485,75,122,253,375,2,10.0
6486,75,25,59,84,2,10.0
6487,75,53,68,121,2,10.0
6488,75,51,128,179,2,10.0
6489,75,29,97,126,2,10.0
6490,75,111,130,241,2,10.0
6491,75,50,83,133,2,10.0
6492,75,38,125,163,2,10.0
6493,75,73,88,161,2,10.0
6494,75,31,85,116,2,10.0
6495,75,33,52,85,2,10.0
6496,75,46,62,108,2,10.0
6497,75,20,56,76,2,10.0
6498,75,26,43,69,2,10.0
6499,75,37,65,102,2,10.0
6500,75,113,207,320,2,10.0
6501,75,28,66,94,2,10.0
6502,75,97,109,206,2,10.0
6503,75,127,179,306,2,10.0
6504,75,81,105,186,2,10.0
6505,75,110,200,310,2,10.0
6506,75,141,123,264,2,10.0
6507,75,41,66,107,2,10.0
6508,75,70,78,148,2,10.0
6509,75,109,242,351,2,10.0
6510,75,98,158,256,2,10.0
6511,75,49,90,139,2,10.0
6512,75,25,56,81,2,10.0
6513,75,101,204,305,2,10.0
6514,75,102,205,307,2,10.0
6515,75,41,101,142,2,10.0
6516,75,31,57,88,2,10.0
6517,75,96,136,232,2,10.0
6518,75,86,131,217,2,10.0
6519,75,58,93,151,2,10.0
6520,75,58,210,268,2,10.0
6521,75,29,91,120,2,10.0
6522,75,53,113,166,2,10.0
6523,75,24,19,43,2,10.0
6524,75,70,99,169,2,10.0
6525,75,10,17,27,2,10.0
6526,75,33,46,79,2,10.0
6527,75,31,74,105,2,10.0
6528,75,89,118,207,2,10.0
6529,75,62,112,174,2,10.0
6530,75,94,233,327,2,10.0
6531,75,49,115,164,2,10.0
6532,75,96,106,202,2,10.0
6533,75,84,208,292,2,10.0
6534,75,56,71,127,2,10.0
6535,75,106,223,329,2,10.0
6536,75,97,175,272,2,10.0
6537,75,160,263,423,2,10.0
6538,75,67,171,238,2,10.0
6539,75,97,166,263,2,10.0
6540,75,60,56,116,2,10.0
6541,75,29,92,121,2,10.0
6542,75,63,111,174,2,10.0
6543,75,148,288,436,2,10.0
6544,75,67,188,255,2,10.0
6545,75,43,67,110,2,10.0
6546,75,23,73,96,2,10.0
6547,75,98,208,306,2,10.0
6548,75,32,90,122,2,10.0
6549,75,68,90,158,2,10.0
6550,75,66,118,184,2,10.0
6551,75,48,86,134,2,10.0
6552,75,59,85,144,2,10.0
6553,75,54,111,165,2,10.0
6554,75,139,233,372,2,10.0
6555,75,201,342,543,2,10.0
6556,75,85,181,266,2,10.0
6557,75,25,67,92,2,10.0
6558,75,144,236,380,2,10.0
6559,75,102,215,317,2,10.0
6560,75,46,48,94,2,10.0
6561,75,93,147,240,2,10.0
6562,75,23,28,51,2,10.0
6563,75,61,149,210,2,10.0
6564,75,50,89,139,2,10.0
6565,75,35,63,98,2,10.0
6566,75,29,39,68,2,10.0
6567,75,54,80,134,2,10.0
6568,75,48,96,144,2,10.0
6569,75,69,122,191,2,10.0
6570,75,84,212,296,2,10.0
6571,75,49,151,200,2,10.0
6572,75,36,68,104,2,10.0
6573,75,62,99,161,2,10.0
6574,75,50,166,216,2,10.0
6575,75,58,109,167,2,10.0
6576,75,59,101,160,2,10.0
6577,75,43,73,116,2,10.0
6578,75,83,129,212,2,10.0
6579,75,40,110,150,2,10.0
6580,75,46,99,145,2,10.0
6581,75,41,53,94,2,10.0
6582,75,49,84,133,2,10.0
6583,75,37,83,120,2,10.0
6584,75,13,34,47,2,10.0
6585,75,51,92,143,2,10.0
6586,75,128,303,431,2,10.0
6587,75,84,166,250,2,10.0
6588,75,96,252,348,2,10.0
6589,75,11,35,46,2,10.0
6590,75,52,121,173,2,10.0
6591,75,74,109,183,2,10.0
6592,75,76,118,194,2,10.0
6593,75,80,105,185,2,10.0
6594,75,58,111,169,2,10.0
6595,75,58,104,162,2,10.0
6596,75,30,49,79,2,10.0
6597,75,47,59,106,2,10.0
6598,75,26,56,82,2,10.0
6599,75,16,44,60,2,10.0
6600,75,3,15,18,2,10.0
6601,75,93,180,273,2,10.0
6602,75,109,195,304,2,10.0
6603,75,171,266,437,2,10.0
6604,75,85,168,253,2,10.0
6605,75,125,236,361,2,10.0
6606,75,129,257,386,2,10.0
6607,75,84,155,239,2,10.0
6608,75,68,172,240,2,10.0
6609,75,30,92,122,2,10.0
6610,75,17,57,74,2,10.0
6611,75,11,51,62,2,10.0
6612,75,134,338,472,2,10.0
6613,75,39,104,143,2,10.0
6614,75,94,182,276,2,10.0
6615,75,72,216,288,2,10.0
6616,75,29,23,52,2,10.0
6617,75,57,110,167,2,10.0
6618,75,76,173,249,2,10.0
6619,75,82,181,263,2,10.0
6620,75,48,90,138,2,10.0
6621,75,37,60,97,2,10.0
6622,75,47,46,93,2,10.0
6623,75,36,133,169,2,10.0
6624,75,58,69,127,2,10.0
6625,75,47,64,111,2,10.0
6626,75,154,258,412,2,10.0
6627,75,33,60,93,2,10.0
6628,75,35,62,97,2,10.0
6629,75,128,249,377,2,10.0
6630,75,70,131,201,2,10.0
6631,75,17,63,80,2,10.0
6632,75,25,44,69,2,10.0
6633,75,8,14,22,2,10.0
6634,75,36,70,106,2,10.0
6635,75,32,31,63,2,10.0
6636,75,9,18,27,2,10.0
6637,75,14,27,41,2,10.0
6638,75,11,12,23,2,10.0
6639,75,73,67,140,2,10.0
6640,75,97,218,315,2,10.0
6641,75,65,203,268,2,10.0
6642,75,109,246,355,2,10.0
6643,75,68,186,254,2,10.0
6644,75,45,112,157,2,10.0
6645,75,89,177,266,2,10.0
6646,75,91,210,301,2,10.0
6647,75,40,149,189,2,10.0
6648,75,31,41,72,2,10.0
6649,75,49,60,109,2,10.0
6650,75,51,173,224,2,10.0
6651,75,26,57,83,2,10.0
6652,75,16,36,52,2,10.0
6653,75,83,121,204,2,10.0
6654,75,45,52,97,2,10.0
6655,75,136,184,320,2,10.0
6656,75,69,122,191,2,10.0
6657,75,76,153,229,2,10.0
6658,75,46,154,200,2,10.0
6659,75,63,119,182,2,10.0
6660,75,89,203,292,2,10.0
6661,75,52,106,158,2,10.0
6662,75,65,142,207,2,10.0
6663,75,71,152,223,2,10.0
6664,75,49,36,85,2,10.0
6665,75,64,212,276,2,10.0
6666,75,68,71,139,2,10.0
6667,75,32,56,88,2,10.0
6668,75,4,6,10,2,10.0
6669,75,93,221,314,2,10.0
6670,75,67,157,224,2,10.0
6671,75,50,136,186,2,10.0
6672,75,82,166,248,2,10.0
6673,75,82,246,328,2,10.0
6674,75,81,197,278,2,10.0
6675,75,124,230,354,2,10.0
6676,75,65,157,222,2,10.0
6677,75,65,106,171,2,10.0
6678,75,59,110,169,2,10.0
6679,75,59,119,178,2,10.0
6680,75,82,134,216,2,10.0
6681,75,75,160,235,2,10.0
6682,75,58,112,170,2,10.0
6683,75,57,137,194,2,10.0
6684,75,74,116,190,2,10.0
6685,75,54,87,141,2,10.0
6686,75,97,131,228,2,10.0
6687,75,24,83,107,2,10.0
6688,75,61,112,173,2,10.0
6689,75,22,52,74,2,10.0
6690,75,24,27,51,2,10.0
6691,75,65,204,269,2,10.0
6692,75,50,70,120,2,10.0
6693,75,103,218,321,2,10.0
6694,75,114,245,359,2,10.0
6695,75,77,145,222,2,10.0
6696,75,88,214,302,2,10.0
6697,75,52,111,163,2,10.0
6698,75,64,147,211,2,10.0
6699,75,60,134,194,2,10.0
6700,75,109,161,270,2,10.0
6701,75,46,83,129,2,10.0
6702,75,43,101,144,2,10.0
6703,75,22,33,55,2,10.0
6704,75,21,48,69,2,10.0
6705,75,6,10,16,2,10.0
6706,75,27,52,79,2,10.0
6707,75,39,79,118,2,10.0
6708,75,40,73,113,2,10.0
6709,75,31,77,108,2,10.0
6710,75,62,104,166,2,10.0
6711,75,39,115,154,2,10.0
6712,75,63,70,133,2,10.0
6713,75,45,60,105,2,10.0
6714,75,60,191,251,2,10.0
6715,75,87,277,364,2,10.0
6716,75,47,225,272,2,10.0
6717,75,133,274,407,2,10.0
6718,75,264,535,799,2,10.0
6719,75,47,131,178,2,10.0
6720,75,150,287,437,2,10.0
6721,75,81,127,208,2,10.0
6722,75,122,255,377,2,10.0
6723,75,47,234,281,2,10.0
6724,75,45,95,140,2,10.0
6725,75,67,224,291,2,10.0
6726,75,11,62,73,2,10.0
6727,75,21,67,88,2,10.0
6728,75,90,207,297,2,10.0
6729,75,89,140,229,2,10.0
6730,75,58,88,146,2,10.0
6731,75,83,245,328,2,10.0
6732,75,58,97,155,2,10.0
6733,75,45,137,182,2,10.0
6734,75,52,178,230,2,10.0
6735,75,85,266,351,2,10.0
6736,75,76,159,235,2,10.0
6737,75,51,112,163,2,10.0
6738,75,30,54,84,2,10.0
6739,75,9,18,27,2,10.0
6740,75,15,16,31,2,10.0
6741,75,82,166,248,2,10.0
6742,75,136,166,302,2,10.0
6743,75,41,73,114,2,10.0
6744,75,164,280,444,2,10.0
6745,75,86,94,180,2,10.0
6746,75,153,237,390,2,10.0
6747,75,40,74,114,2,10.0
6748,75,77,184,261,2,10.0
6749,75,138,277,415,2,10.0
6750,75,56,105,161,2,10.0
6751,75,51,97,148,2,10.0
6752,75,57,146,203,2,10.0
6753,75,58,84,142,2,10.0
6754,75,64,167,231,2,10.0
6755,75,32,52,84,2,10.0
6756,75,16,29,45,2,10.0
6757,75,119,254,373,2,10.0
6758,75,105,198,303,2,10.0
6759,75,76,150,226,2,10.0
6760,75,77,155,232,2,10.0
6761,75,78,138,216,2,10.0
6762,75,91,154,245,2,10.0
6763,75,27,59,86,2,10.0
6764,75,31,33,64,2,10.0
6765,75,4,8,12,2,10.0
6766,75,18,62,80,2,10.0
6767,75,13,18,31,2,10.0
6768,75,63,154,217,2,10.0
6769,75,108,205,313,2,10.0
6770,75,76,75,151,2,10.0
6771,75,94,116,210,2,10.0
6772,75,62,175,237,2,10.0
6773,75,24,71,95,2,10.0
6774,75,100,146,246,2,10.0
6775,75,78,150,228,2,10.0
6776,75,39,103,142,2,10.0
6777,75,56,29,85,2,10.0
6778,75,13,16,29,2,10.0
6779,75,38,50,88,2,10.0
6780,75,31,49,80,2,10.0
6781,75,27,38,65,2,10.0
6782,75,9,25,34,2,10.0
6783,75,7,14,21,2,10.0
6784,75,95,131,226,2,10.0
6785,75,49,102,151,2,10.0
6786,75,53,124,177,2,10.0
6787,75,61,90,151,2,10.0
6788,75,27,67,94,2,10.0
6789,75,64,138,202,2,10.0
6790,75,109,106,215,2,10.0
6791,75,48,80,128,2,10.0
6792,75,19,43,62,2,10.0
6793,75,24,116,140,2,10.0
6794,75,35,75,110,2,10.0
6795,75,36,53,89,2,10.0
6796,75,117,199,316,2,10.0
6797,75,18,14,32,2,10.0
6798,75,30,37,67,2,10.0
6799,75,49,99,148,2,10.0
6800,75,26,76,102,2,10.0
6801,75,60,94,154,2,10.0
6802,75,104,165,269,2,10.0
6803,75,48,119,167,2,10.0
6804,75,47,157,204,2,10.0
6805,75,92,141,233,2,10.0
6806,75,45,100,145,2,10.0
6807,75,72,132,204,2,10.0
6808,75,108,162,270,2,10.0
6809,75,48,65,113,2,10.0
6810,75,8,20,28,2,10.0
6811,75,33,103,136,2,10.0
6812,75,26,32,58,2,10.0
6813,75,59,115,174,2,10.0
6814,75,6,7,13,2,10.0
6815,75,1,3,4,2,10.0
6816,75,22,32,54,2,10.0
6817,75,75,107,182,2,10.0
6818,75,52,75,127,2,10.0
6819,75,82,178,260,2,10.0
6820,75,75,181,256,2,10.0
6821,75,24,35,59,2,10.0
6822,75,78,151,229,2,10.0
6823,75,94,180,274,2,10.0
6824,75,43,72,115,2,10.0
6825,75,27,39,66,2,10.0
6826,75,18,38,56,2,10.0
6827,75,25,64,89,2,10.0
6828,75,26,71,97,2,10.0
6829,75,69,77,146,2,10.0
6830,75,152,192,344,2,10.0
6831,75,82,137,219,2,10.0
6832,75,119,211,330,2,10.0
6833,75,47,82,129,2,10.0
6834,75,56,94,150,2,10.0
6835,75,119,194,313,2,10.0
6836,75,98,229,327,2,10.0
6837,75,47,127,174,2,10.0
6838,75,76,224,300,2,10.0
6839,75,61,98,159,2,10.0
6840,75,15,27,42,2,10.0
6841,75,82,182,264,2,10.0
6842,75,30,68,98,2,10.0
6843,75,52,121,173,2,10.0
6844,75,16,27,43,2,10.0
6845,75,66,109,175,2,10.0
6846,75,124,285,409,2,10.0
6847,75,52,197,249,2,10.0
6848,75,151,444,595,2,10.0
6849,75,86,169,255,2,10.0
6850,75,106,253,359,2,10.0
6851,75,131,209,340,2,10.0
6852,75,7,11,18,2,10.0
6853,75,92,113,205,2,10.0
6854,75,49,137,186,2,10.0
6855,75,6,7,13,2,10.0
6856,75,21,35,56,2,10.0
6857,75,47,132,179,2,10.0
6858,75,67,119,186,2,10.0
6859,75,111,152,263,2,10.0
6860,75,37,67,104,2,10.0
6861,75,137,205,342,2,10.0
6862,75,145,264,409,2,10.0
6863,75,116,136,252,2,10.0
6864,75,53,123,176,2,10.0
6865,75,70,137,207,2,10.0
6866,75,56,152,208,2,10.0
6867,75,80,161,241,2,10.0
6868,75,41,64,105,2,10.0
6869,75,145,145,290,2,10.0
6870,75,76,128,204,2,10.0
6871,90,22,59,81,2,10.0
6872,90,68,164,232,2,10.0
6873,90,26,61,87,2,10.0
6874,90,10,16,26,2,10.0
6875,90,36,75,111,2,10.0
6876,90,63,116,179,2,10.0
6877,90,49,121,170,2,10.0
6878,90,93,194,287,2,10.0
6879,90,18,50,68,2,10.0
6880,90,124,265,389,2,10.0
6881,90,31,70,101,2,10.0
6882,90,16,42,58,2,10.0
6883,90,3,15,18,2,10.0
6884,90,57,100,157,2,10.0
6885,90,10,24,34,2,10.0
6886,90,59,196,255,2,10.0
6887,90,23,81,104,2,10.0
6888,90,61,167,228,2,10.0
6889,90,49,80,129,2,10.0
6890,90,201,346,547,2,10.0
6891,90,124,226,350,2,10.0
6892,90,99,203,302,2,10.0
6893,90,88,106,194,2,10.0
6894,90,12,29,41,2,10.0
6895,90,36,62,98,2,10.0
6896,90,97,190,287,2,10.0
6897,90,77,229,306,2,10.0
6898,90,95,133,228,2,10.0
6899,90,75,189,264,2,10.0
6900,90,50,82,132,2,10.0
6901,90,22,164,186,2,10.0
6902,90,56,119,175,2,10.0
6903,90,62,136,198,2,10.0
6904,90,74,98,172,2,10.0
6905,90,69,131,200,2,10.0
6906,90,78,163,241,2,10.0
6907,90,27,57,84,2,10.0
6908,90,62,106,168,2,10.0
6909,90,140,269,409,2,10.0
6910,90,47,115,162,2,10.0
6911,90,129,332,461,2,10.0
6912,90,46,97,143,2,10.0
6913,90,97,217,314,2,10.0
6914,90,87,137,224,2,10.0
6915,90,94,190,284,2,10.0
6916,90,34,48,82,2,10.0
6917,90,54,102,156,2,10.0
6918,90,27,43,70,2,10.0
6919,90,28,95,123,2,10.0
6920,90,40,82,122,2,10.0
6921,90,17,39,56,2,10.0
6922,90,69,103,172,2,10.0
6923,90,66,87,153,2,10.0
6924,90,42,59,101,2,10.0
6925,90,66,93,159,2,10.0
6926,90,23,43,66,2,10.0
6927,90,41,57,98,2,10.0
6928,90,52,102,154,2,10.0
6929,90,23,49,72,2,10.0
6930,90,27,69,96,2,10.0
6931,90,19,58,77,2,10.0
6932,90,11,26,37,2,10.0
6933,90,28,26,54,2,10.0
6934,90,5,13,18,2,10.0
6935,90,18,24,42,2,10.0
6936,90,4,20,24,2,10.0
6937,90,52,136,188,2,10.0
6938,90,84,60,144,2,10.0
6939,90,56,108,164,2,10.0
6940,90,67,117,184,2,10.0
6941,90,62,104,166,2,10.0
6942,90,61,89,150,2,10.0
6943,90,61,104,165,2,10.0
6944,90,39,97,136,2,10.0
6945,90,155,405,560,2,10.0
6946,90,46,46,92,2,10.0
6947,90,32,53,85,2,10.0
6948,90,53,58,111,2,10.0
6949,90,28,45,73,2,10.0
6950,90,46,127,173,2,10.0
6951,90,40,80,120,2,10.0
6952,90,56,153,209,2,10.0
6953,90,39,57,96,2,10.0
6954,90,14,54,68,2,10.0
6955,90,40,109,149,2,10.0
6956,90,48,72,120,2,10.0
6957,90,86,113,199,2,10.0
6958,90,57,87,144,2,10.0
6959,90,4,34,38,2,10.0
6960,90,30,86,116,2,10.0
6961,90,19,69,88,2,10.0
6962,90,15,35,50,2,10.0
6963,90,28,83,111,2,10.0
6964,90,20,40,60,2,10.0
6965,90,2,10,12,2,10.0
6966,90,18,56,74,2,10.0
6967,90,48,123,171,2,10.0
6968,90,97,203,300,2,10.0
6969,90,62,53,115,2,10.0
6970,90,78,60,138,2,10.0
6971,90,43,155,198,2,10.0
6972,90,87,59,146,2,10.0
6973,90,75,80,155,2,10.0
6974,90,120,225,345,2,10.0
6975,90,170,302,472,2,10.0
6976,90,57,73,130,2,10.0
6977,90,47,45,92,2,10.0
6978,90,55,135,190,2,10.0
6979,90,36,41,77,2,10.0
6980,90,60,98,158,2,10.0
6981,90,42,112,154,2,10.0
6982,90,21,54,75,2,10.0
6983,90,50,130,180,2,10.0
6984,90,20,24,44,2,10.0
6985,90,60,95,155,2,10.0
6986,90,85,130,215,2,10.0
6987,90,44,103,147,2,10.0
6988,90,187,99,286,2,10.0
6989,90,87,104,191,2,10.0
6990,90,47,150,197,2,10.0
6991,90,45,62,107,2,10.0
6992,90,77,157,234,2,10.0
6993,90,43,58,101,2,10.0
6994,90,56,72,128,2,10.0
6995,90,50,78,128,2,10.0
6996,90,41,39,80,2,10.0
6997,90,58,72,130,2,10.0
6998,90,23,26,49,2,10.0
6999,90,59,140,199,2,10.0
7000,90,64,151,215,2,10.0
7001,90,34,61,95,2,10.0
7002,90,52,100,152,2,10.0
7003,90,37,101,138,2,10.0
7004,90,55,177,232,2,10.0
7005,90,39,83,122,2,10.0
7006,90,118,142,260,2,10.0
7007,90,87,143,230,2,10.0
7008,90,31,82,113,2,10.0
7009,90,92,162,254,2,10.0
7010,90,59,50,109,2,10.0
7011,90,95,181,276,2,10.0
7012,90,50,109,159,2,10.0
7013,90,29,46,75,2,10.0
7014,90,5,29,34,2,10.0
7015,90,28,33,61,2,10.0
7016,90,5,14,19,2,10.0
7017,90,3,6,9,2,10.0
7018,90,119,132,251,2,10.0
7019,90,96,244,340,2,10.0
7020,90,67,149,216,2,10.0
7021,90,72,169,241,2,10.0
7022,90,82,173,255,2,10.0
7023,90,47,111,158,2,10.0
7024,90,59,111,170,2,10.0
7025,90,46,89,135,2,10.0
7026,90,56,126,182,2,10.0
7027,90,26,34,60,2,10.0
7028,90,56,71,127,2,10.0
7029,90,39,95,134,2,10.0
7030,90,43,119,162,2,10.0
7031,90,17,32,49,2,10.0
7032,90,7,13,20,2,10.0
7033,90,11,30,41,2,10.0
7034,90,28,69,97,2,10.0
7035,90,44,124,168,2,10.0
7036,90,59,99,158,2,10.0
7037,90,81,174,255,2,10.0
7038,90,21,50,71,2,10.0
7039,90,21,56,77,2,10.0
7040,90,31,73,104,2,10.0
7041,90,56,90,146,2,10.0
7042,90,59,104,163,2,10.0
7043,90,18,51,69,2,10.0
7044,90,30,112,142,2,10.0
7045,90,21,27,48,2,10.0
7046,90,34,87,121,2,10.0
7047,90,28,41,69,2,10.0
7048,90,30,76,106,2,10.0
7049,90,121,148,269,2,10.0
7050,90,82,120,202,2,10.0
7051,90,113,259,372,2,10.0
7052,90,113,185,298,2,10.0
7053,90,73,112,185,2,10.0
7054,90,181,276,457,2,10.0
7055,90,42,159,201,2,10.0
7056,90,74,159,233,2,10.0
7057,90,59,56,115,2,10.0
7058,90,56,79,135,2,10.0
7059,90,76,99,175,2,10.0
7060,90,62,138,200,2,10.0
7061,90,13,23,36,2,10.0
7062,90,6,21,27,2,10.0
7063,90,170,361,531,2,10.0
7064,90,113,352,465,2,10.0
7065,90,73,216,289,2,10.0
7066,90,29,103,132,2,10.0
7067,90,51,236,287,2,10.0
7068,90,42,77,119,2,10.0
7069,90,53,97,150,2,10.0
7070,90,77,115,192,2,10.0
7071,90,15,33,48,2,10.0
7072,90,34,88,122,2,10.0
7073,90,160,296,456,2,10.0
7074,90,29,66,95,2,10.0
7075,90,103,91,194,2,10.0
7076,90,13,29,42,2,10.0
7077,90,17,26,43,2,10.0
7078,90,31,101,132,2,10.0
7079,90,133,221,354,2,10.0
7080,90,131,187,318,2,10.0
7081,90,124,215,339,2,10.0
7082,90,95,123,218,2,10.0
7083,90,104,187,291,2,10.0
7084,90,147,285,432,2,10.0
7085,90,38,65,103,2,10.0
7086,90,181,352,533,2,10.0
7087,90,18,11,29,2,10.0
7088,90,84,270,354,2,10.0
7089,90,59,80,139,2,10.0
7090,90,235,372,607,2,10.0
7091,90,45,92,137,2,10.0
7092,90,48,64,112,2,10.0
7093,90,11,21,32,2,10.0
7094,90,34,39,73,2,10.0
7095,90,111,214,325,2,10.0
7096,90,67,149,216,2,10.0
7097,90,68,138,206,2,10.0
7098,90,120,237,357,2,10.0
7099,90,25,51,76,2,10.0
7100,90,142,205,347,2,10.0
7101,90,80,120,200,2,10.0
7102,90,59,90,149,2,10.0
7103,90,61,159,220,2,10.0
7104,90,93,131,224,2,10.0
7105,90,75,160,235,2,10.0
7106,90,18,37,55,2,10.0
7107,90,75,143,218,2,10.0
7108,90,30,109,139,2,10.0
7109,90,85,125,210,2,10.0
7110,90,107,164,271,2,10.0
7111,90,34,12,46,2,10.0
7112,90,28,27,55,2,10.0
7113,90,72,104,176,2,10.0
7114,90,40,58,98,2,10.0
7115,90,49,49,98,2,10.0
7116,90,3,12,15,2,10.0
7117,90,26,30,56,2,10.0
7118,90,58,104,162,2,10.0
7119,90,88,201,289,2,10.0
7120,90,91,192,283,2,10.0
7121,90,106,223,329,2,10.0
7122,90,38,37,75,2,10.0
7123,90,85,132,217,2,10.0
7124,90,55,66,121,2,10.0
7125,90,38,71,109,2,10.0
7126,90,44,100,144,2,10.0
7127,90,12,34,46,2,10.0
7128,90,16,45,61,2,10.0
7129,90,52,67,119,2,10.0
7130,90,57,87,144,2,10.0
7131,90,35,53,88,2,10.0
7132,90,96,92,188,2,10.0
7133,90,33,47,80,2,10.0
7134,90,57,86,143,2,10.0
7135,90,56,92,148,2,10.0
7136,90,10,15,25,2,10.0
7137,90,28,54,82,2,10.0
7138,90,43,75,118,2,10.0
7139,90,17,45,62,2,10.0
7140,90,9,22,31,2,10.0
7141,90,20,29,49,2,10.0
7142,90,31,41,72,2,10.0
7143,90,64,202,266,2,10.0
7144,90,46,149,195,2,10.0
7145,90,105,260,365,2,10.0
7146,90,109,235,344,2,10.0
7147,90,50,87,137,2,10.0
7148,90,54,200,254,2,10.0
7149,90,65,183,248,2,10.0
7150,90,42,110,152,2,10.0
7151,90,34,77,111,2,10.0
7152,90,54,109,163,2,10.0
7153,90,15,20,35,2,10.0
7154,90,113,201,314,2,10.0
7155,90,118,263,381,2,10.0
7156,90,69,34,103,2,10.0
7157,90,68,195,263,2,10.0
7158,90,23,87,110,2,10.0
7159,90,76,142,218,2,10.0
7160,90,32,121,153,2,10.0
7161,90,37,98,135,2,10.0
7162,90,81,191,272,2,10.0
7163,90,50,64,114,2,10.0
7164,90,28,63,91,2,10.0
7165,90,77,56,133,2,10.0
7166,90,81,82,163,2,10.0
7167,90,51,89,140,2,10.0
7168,90,53,97,150,2,10.0
7169,90,90,152,242,2,10.0
7170,90,37,56,93,2,10.0
7171,90,93,54,147,2,10.0
7172,90,9,26,35,2,10.0
7173,90,110,121,231,2,10.0
7174,90,88,170,258,2,10.0
7175,90,8,19,27,2,10.0
7176,90,63,103,166,2,10.0
7177,90,30,67,97,2,10.0
7178,90,78,231,309,2,10.0
7179,90,32,58,90,2,10.0
7180,90,15,31,46,2,10.0
7181,90,31,39,70,2,10.0
7182,90,30,75,105,2,10.0
7183,90,24,19,43,2,10.0
7184,90,19,44,63,2,10.0
7185,90,1,2,3,2,10.0
7186,90,26,143,169,2,10.0
7187,90,75,197,272,2,10.0
7188,90,128,259,387,2,10.0
7189,90,67,127,194,2,10.0
7190,90,130,231,361,2,10.0
7191,90,40,48,88,2,10.0
7192,90,13,35,48,2,10.0
7193,90,38,137,175,2,10.0
7194,90,73,142,215,2,10.0
7195,90,68,192,260,2,10.0
7196,90,20,47,67,2,10.0
7197,90,64,119,183,2,10.0
7198,90,19,46,65,2,10.0
7199,90,1,1,2,2,10.0
7200,90,12,12,24,2,10.0
7201,90,10,46,56,2,10.0
7202,90,57,114,171,2,10.0
7203,90,69,176,245,2,10.0
7204,90,80,132,212,2,10.0
7205,90,63,154,217,2,10.0
7206,90,61,127,188,2,10.0
7207,90,42,115,157,2,10.0
7208,90,12,57,69,2,10.0
7209,90,58,147,205,2,10.0
7210,90,41,70,111,2,10.0
7211,90,14,82,96,2,10.0
7212,90,25,51,76,2,10.0
7213,90,31,64,95,2,10.0
7214,90,5,13,18,2,10.0
7215,90,5,6,11,2,10.0
7216,90,1,19,20,2,10.0
7217,90,66,202,268,2,10.0
7218,90,33,103,136,2,10.0
7219,90,36,37,73,2,10.0
7220,90,53,78,131,2,10.0
7221,90,131,275,406,2,10.0
7222,90,35,71,106,2,10.0
7223,90,92,297,389,2,10.0
7224,90,84,195,279,2,10.0
7225,90,109,188,297,2,10.0
7226,90,51,108,159,2,10.0
7227,90,34,68,102,2,10.0
7228,90,50,34,84,2,10.0
7229,90,35,60,95,2,10.0
7230,90,53,69,122,2,10.0
7231,90,61,80,141,2,10.0
7232,90,42,78,120,2,10.0
7233,90,45,52,97,2,10.0
7234,90,111,29,140,2,10.0
7235,90,21,42,63,2,10.0
7236,90,10,19,29,2,10.0
7237,90,26,32,58,2,10.0
7238,90,18,7,25,2,10.0
7239,90,86,94,180,2,10.0
7240,90,46,103,149,2,10.0
7241,90,101,127,228,2,10.0
7242,90,55,83,138,2,10.0
7243,90,69,165,234,2,10.0
7244,90,31,90,121,2,10.0
7245,90,131,269,400,2,10.0
7246,90,68,108,176,2,10.0
7247,90,9,13,22,2,10.0
7248,90,66,120,186,2,10.0
7249,90,55,86,141,2,10.0
7250,90,41,98,139,2,10.0
7251,90,17,51,68,2,10.0
7252,90,62,160,222,2,10.0
7253,90,106,242,348,2,10.0
7254,90,74,174,248,2,10.0
7255,90,59,123,182,2,10.0
7256,90,22,20,42,2,10.0
7257,90,85,223,308,2,10.0
7258,90,24,20,44,2,10.0
7259,90,96,147,243,2,10.0
7260,90,101,168,269,2,10.0
7261,90,16,65,81,2,10.0
7262,90,41,95,136,2,10.0
7263,90,97,159,256,2,10.0
7264,90,28,73,101,2,10.0
7265,90,77,181,258,2,10.0
7266,90,102,175,277,2,10.0
7267,90,83,73,156,2,10.0
7268,90,79,155,234,2,10.0
7269,90,51,60,111,2,10.0
7270,90,66,104,170,2,10.0
7271,90,67,72,139,2,10.0
7272,90,68,108,176,2,10.0
7273,90,71,140,211,2,10.0
7274,90,96,151,247,2,10.0
7275,90,42,61,103,2,10.0
7276,120,61,103,164,2,10.0
7277,120,94,212,306,2,10.0
7278,120,31,71,102,2,10.0
7279,120,26,94,120,2,10.0
7280,120,65,88,153,2,10.0
7281,120,38,67,105,2,10.0
7282,120,82,189,271,2,10.0
7283,120,102,177,279,2,10.0
7284,120,14,59,73,2,10.0
7285,120,4,6,10,2,10.0
7286,120,7,33,40,2,10.0
7287,120,22,36,58,2,10.0
7288,120,3,3,6,2,10.0
7289,120,49,124,173,2,10.0
7290,120,104,146,250,2,10.0
7291,120,53,70,123,2,10.0
7292,120,27,54,81,2,10.0
7293,120,59,124,183,2,10.0
7294,120,29,56,85,2,10.0
7295,120,29,85,114,2,10.0
7296,120,16,30,46,2,10.0
7297,120,39,136,175,2,10.0
7298,120,29,83,112,2,10.0
7299,120,2,5,7,2,10.0
7300,120,25,42,67,2,10.0
7301,120,16,23,39,2,10.0
7302,120,11,5,16,2,10.0
7303,120,40,55,95,2,10.0
7304,120,45,77,122,2,10.0
7305,120,68,90,158,2,10.0
7306,120,97,54,151,2,10.0
7307,120,33,69,102,2,10.0
7308,120,82,88,170,2,10.0
7309,120,72,79,151,2,10.0
7310,120,67,117,184,2,10.0
7311,120,18,50,68,2,10.0
7312,120,36,82,118,2,10.0
7313,120,14,24,38,2,10.0
7314,120,13,27,40,2,10.0
7315,120,2,4,6,2,10.0
7316,120,14,14,28,2,10.0
7317,120,3,9,12,2,10.0
7318,120,5,5,10,2,10.0
7319,120,5,14,19,2,10.0
7320,120,109,210,319,2,10.0
7321,120,45,119,164,2,10.0
7322,120,28,62,90,2,10.0
7323,120,139,193,332,2,10.0
7324,120,57,98,155,2,10.0
7325,120,44,116,160,2,10.0
7326,120,20,39,59,2,10.0
7327,120,22,47,69,2,10.0
7328,120,54,62,116,2,10.0
7329,120,39,79,118,2,10.0
7330,120,33,29,62,2,10.0
7331,120,13,42,55,2,10.0
7332,120,14,32,46,2,10.0
7333,120,12,32,44,2,10.0
7334,120,13,8,21,2,10.0
7335,120,9,38,47,2,10.0
7336,120,24,17,41,2,10.0
7337,120,41,62,103,2,10.0
7338,120,46,93,139,2,10.0
7339,120,84,134,218,2,10.0
7340,120,43,80,123,2,10.0
7341,120,38,59,97,2,10.0
7342,120,78,135,213,2,10.0
7343,120,35,94,129,2,10.0
7344,120,51,116,167,2,10.0
7345,120,20,75,95,2,10.0
7346,120,6,12,18,2,10.0
7347,120,22,60,82,2,10.0
7348,120,49,55,104,2,10.0
7349,120,31,37,68,2,10.0
7350,120,94,129,223,2,10.0
7351,120,73,91,164,2,10.0
7352,120,68,90,158,2,10.0
7353,120,71,114,185,2,10.0
7354,120,45,63,108,2,10.0
7355,120,45,56,101,2,10.0
7356,120,21,60,81,2,10.0
7357,120,39,54,93,2,10.0
7358,120,10,9,19,2,10.0
7359,120,1,4,5,2,10.0
7360,120,32,62,94,2,10.0
7361,120,20,33,53,2,10.0
7362,120,7,10,17,2,10.0
7363,120,54,139,193,2,10.0
7364,120,60,118,178,2,10.0
7365,120,19,24,43,2,10.0
7366,120,46,95,141,2,10.0
7367,120,47,114,161,2,10.0
7368,120,84,166,250,2,10.0
7369,120,57,29,86,2,10.0
7370,120,15,44,59,2,10.0
7371,120,60,90,150,2,10.0
7372,120,39,55,94,2,10.0
7373,120,40,74,114,2,10.0
7374,120,32,53,85,2,10.0
7375,120,32,23,55,2,10.0
7376,120,20,43,63,2,10.0
7377,120,10,23,33,2,10.0
7378,120,58,62,120,2,10.0
7379,120,11,19,30,2,10.0
7380,120,47,47,94,2,10.0
7381,120,37,38,75,2,10.0
7382,120,36,63,99,2,10.0
7383,120,18,31,49,2,10.0
7384,120,44,77,121,2,10.0
7385,120,41,48,89,2,10.0
7386,120,84,139,223,2,10.0
7387,120,37,23,60,2,10.0
7388,120,40,60,100,2,10.0
7389,120,61,103,164,2,10.0
7390,120,78,156,234,2,10.0
7391,120,58,143,201,2,10.0
7392,120,48,60,108,2,10.0
7393,120,25,35,60,2,10.0
7394,120,45,115,160,2,10.0
7395,120,26,55,81,2,10.0
7396,120,49,94,143,2,10.0
7397,120,61,118,179,2,10.0
7398,120,11,17,28,2,10.0
7399,120,20,31,51,2,10.0
7400,120,3,19,22,2,10.0
7401,120,1,11,12,2,10.0
7402,120,23,46,69,2,10.0
7403,120,5,6,11,2,10.0
7404,120,112,200,312,2,10.0
7405,120,129,233,362,2,10.0
7406,120,94,191,285,2,10.0
7407,120,82,106,188,2,10.0
7408,120,46,40,86,2,10.0
7409,120,57,100,157,2,10.0
7410,120,32,95,127,2,10.0
7411,120,30,58,88,2,10.0
7412,120,24,60,84,2,10.0
7413,120,36,62,98,2,10.0
7414,120,5,26,31,2,10.0
7415,120,17,26,43,2,10.0
7416,120,101,152,253,2,10.0
7417,120,45,107,152,2,10.0
7418,120,80,150,230,2,10.0
7419,120,88,252,340,2,10.0
7420,120,108,148,256,2,10.0
7421,120,131,261,392,2,10.0
7422,120,10,14,24,2,10.0
7423,120,32,81,113,2,10.0
7424,120,78,136,214,2,10.0
7425,120,45,74,119,2,10.0
7426,120,16,66,82,2,10.0
7427,120,22,40,62,2,10.0
7428,120,20,34,54,2,10.0
7429,120,13,30,43,2,10.0
7430,120,2,5,7,2,10.0
7431,120,3,15,18,2,10.0
7432,120,67,86,153,2,10.0
7433,120,106,136,242,2,10.0
7434,120,70,197,267,2,10.0
7435,120,73,128,201,2,10.0
7436,120,71,136,207,2,10.0
7437,120,26,64,90,2,10.0
7438,120,25,52,77,2,10.0
7439,120,33,62,95,2,10.0
7440,120,52,75,127,2,10.0
7441,120,16,31,47,2,10.0
7442,120,56,107,163,2,10.0
7443,120,45,80,125,2,10.0
7444,120,41,24,65,2,10.0
7445,120,12,31,43,2,10.0
7446,120,54,118,172,2,10.0
7447,120,43,111,154,2,10.0
7448,120,152,204,356,2,10.0
7449,120,46,86,132,2,10.0
7450,120,78,88,166,2,10.0
7451,120,64,87,151,2,10.0
7452,120,66,84,150,2,10.0
7453,120,20,15,35,2,10.0
7454,120,61,149,210,2,10.0
7455,120,36,58,94,2,10.0
7456,120,40,76,116,2,10.0
7457,120,21,58,79,2,10.0
7458,120,53,93,146,2,10.0
7459,120,64,111,175,2,10.0
7460,120,43,76,119,2,10.0
7461,120,86,232,318,2,10.0
7462,120,34,42,76,2,10.0
7463,120,29,68,97,2,10.0
7464,120,21,31,52,2,10.0
7465,120,45,60,105,2,10.0
7466,120,155,209,364,2,10.0
7467,120,8,27,35,2,10.0
7468,120,9,41,50,2,10.0
7469,120,9,31,40,2,10.0
7470,120,3,24,27,2,10.0
7471,120,68,68,136,2,10.0
7472,120,22,65,87,2,10.0
7473,120,92,191,283,2,10.0
7474,120,116,288,404,2,10.0
7475,120,61,110,171,2,10.0
7476,120,127,126,253,2,10.0
7477,120,60,112,172,2,10.0
7478,120,48,97,145,2,10.0
7479,120,219,277,496,2,10.0
7480,120,67,110,177,2,10.0
7481,120,36,49,85,2,10.0
7482,120,97,171,268,2,10.0
7483,120,36,72,108,2,10.0
7484,120,28,36,64,2,10.0
7485,120,28,86,114,2,10.0
7486,120,31,36,67,2,10.0
7487,120,111,288,399,2,10.0
7488,120,69,223,292,2,10.0
7489,120,67,121,188,2,10.0
7490,120,70,151,221,2,10.0
7491,120,17,50,67,2,10.0
7492,120,53,70,123,2,10.0
7493,120,45,74,119,2,10.0
7494,120,34,118,152,2,10.0
7495,120,85,164,249,2,10.0
7496,120,25,49,74,2,10.0
7497,120,6,32,38,2,10.0
7498,120,79,98,177,2,10.0
7499,120,93,59,152,2,10.0
7500,120,145,239,384,2,10.0
7501,120,176,190,366,2,10.0
7502,120,97,61,158,2,10.0
7503,120,62,146,208,2,10.0
7504,120,110,173,283,2,10.0
7505,120,67,173,240,2,10.0
7506,120,26,32,58,2,10.0
7507,120,68,137,205,2,10.0
7508,120,28,45,73,2,10.0
7509,120,34,107,141,2,10.0
7510,120,38,48,86,2,10.0
7511,120,14,34,48,2,10.0
7512,120,21,49,70,2,10.0
7513,120,15,14,29,2,10.0
7514,120,52,89,141,2,10.0
7515,120,109,185,294,2,10.0
7516,120,19,38,57,2,10.0
7517,120,107,127,234,2,10.0
7518,120,43,90,133,2,10.0
7519,120,118,152,270,2,10.0
7520,120,17,45,62,2,10.0
7521,120,46,116,162,2,10.0
7522,120,37,65,102,2,10.0
7523,120,34,84,118,2,10.0
7524,120,25,53,78,2,10.0
7525,120,33,40,73,2,10.0
7526,120,12,13,25,2,10.0
7527,120,51,141,192,2,10.0
7528,120,12,20,32,2,10.0
7529,120,2,12,14,2,10.0
7530,120,46,82,128,2,10.0
7531,120,47,55,102,2,10.0
7532,120,25,53,78,2,10.0
7533,120,77,71,148,2,10.0
7534,120,86,95,181,2,10.0
7535,120,29,48,77,2,10.0
7536,120,62,98,160,2,10.0
7537,120,97,105,202,2,10.0
7538,120,76,100,176,2,10.0
7539,120,17,52,69,2,10.0
7540,120,43,34,77,2,10.0
7541,120,44,75,119,2,10.0
7542,120,31,44,75,2,10.0
7543,120,28,46,74,2,10.0
7544,120,29,83,112,2,10.0
7545,120,10,11,21,2,10.0
7546,120,2,1,3,2,10.0
7547,120,7,9,16,2,10.0
7548,120,9,13,22,2,10.0
7549,120,55,129,184,2,10.0
7550,120,59,74,133,2,10.0
7551,120,42,48,90,2,10.0
7552,120,35,21,56,2,10.0
7553,120,77,94,171,2,10.0
7554,120,72,110,182,2,10.0
7555,120,31,21,52,2,10.0
7556,120,23,44,67,2,10.0
7557,120,151,203,354,2,10.0
7558,120,42,55,97,2,10.0
7559,120,71,112,183,2,10.0
7560,120,32,73,105,2,10.0
7561,120,45,88,133,2,10.0
7562,120,25,40,65,2,10.0
7563,120,33,46,79,2,10.0
7564,120,33,33,66,2,10.0
7565,120,6,29,35,2,10.0
7566,120,21,35,56,2,10.0
7567,120,45,95,140,2,10.0
7568,120,15,50,65,2,10.0
7569,120,6,28,34,2,10.0
7570,120,26,114,140,2,10.0
7571,120,87,156,243,2,10.0
7572,120,52,109,161,2,10.0
7573,120,95,131,226,2,10.0
7574,120,57,77,134,2,10.0
7575,120,42,103,145,2,10.0
7576,120,57,84,141,2,10.0
7577,120,52,71,123,2,10.0
7578,120,40,40,80,2,10.0
7579,120,61,132,193,2,10.0
7580,120,30,65,95,2,10.0
7581,120,41,52,93,2,10.0
7582,120,35,89,124,2,10.0
7583,120,54,103,157,2,10.0
7584,120,26,72,98,2,10.0
7585,120,26,39,65,2,10.0
7586,120,14,29,43,2,10.0
7587,120,31,70,101,2,10.0
7588,120,65,119,184,2,10.0
7589,120,30,67,97,2,10.0
7590,120,35,84,119,2,10.0
7591,120,14,38,52,2,10.0
7592,120,17,44,61,2,10.0
7593,120,18,25,43,2,10.0
7594,120,6,6,12,2,10.0
7595,120,5,9,14,2,10.0
7596,120,2,0,2,2,10.0
7597,120,4,4,8,2,10.0
7598,120,105,244,349,2,10.0
7599,120,18,51,69,2,10.0
7600,120,33,109,142,2,10.0
7601,120,45,78,123,2,10.0
7602,120,199,307,506,2,10.0
7603,120,26,71,97,2,10.0
7604,120,82,136,218,2,10.0
7605,120,79,86,165,2,10.0
7606,120,54,113,167,2,10.0
7607,120,42,136,178,2,10.0
7608,120,22,34,56,2,10.0
7609,120,9,23,32,2,10.0
7610,120,5,12,17,2,10.0
7611,120,4,12,16,2,10.0
7612,120,12,20,32,2,10.0
7613,120,17,40,57,2,10.0
7614,120,63,114,177,2,10.0
7615,120,104,103,207,2,10.0
7616,120,10,20,30,2,10.0
7617,120,71,95,166,2,10.0
7618,120,61,113,174,2,10.0
7619,120,27,49,76,2,10.0
7620,120,38,87,125,2,10.0
7621,120,80,91,171,2,10.0
7622,120,6,38,44,2,10.0
7623,120,35,47,82,2,10.0
7624,120,3,12,15,2,10.0
7625,120,43,88,131,2,10.0
7626,120,2,11,13,2,10.0
7627,120,10,2,12,2,10.0
7628,120,6,0,6,2,10.0
7629,120,42,94,136,2,10.0
7630,120,7,2,9,2,10.0
7631,120,29,80,109,2,10.0
7632,120,46,119,165,2,10.0
7633,120,104,108,212,2,10.0
7634,120,81,101,182,2,10.0
7635,120,47,90,137,2,10.0
7636,120,63,101,164,2,10.0
7637,120,42,81,123,2,10.0
7638,120,19,21,40,2,10.0
7639,120,82,83,165,2,10.0
7640,120,34,65,99,2,10.0
7641,120,51,65,116,2,10.0
7642,120,10,25,35,2,10.0
7643,120,60,146,206,2,10.0
7644,120,37,22,59,2,10.0
7645,120,57,85,142,2,10.0
7646,120,57,106,163,2,10.0
7647,120,49,166,215,2,10.0
7648,120,67,117,184,2,10.0
7649,120,123,165,288,2,10.0
7650,120,156,166,322,2,10.0
7651,120,63,132,195,2,10.0
7652,120,98,185,283,2,10.0
7653,120,46,144,190,2,10.0
7654,120,88,198,286,2,10.0
7655,120,27,42,69,2,10.0
7656,120,113,134,247,2,10.0
7657,120,25,42,67,2,10.0
7658,120,28,48,76,2,10.0
7659,120,5,10,15,2,10.0
7660,120,156,304,460,2,10.0
7661,120,52,108,160,2,10.0
7662,120,121,208,329,2,10.0
7663,120,29,21,50,2,10.0
7664,120,88,189,277,2,10.0
7665,120,38,53,91,2,10.0
7666,120,120,176,296,2,10.0
7667,120,51,68,119,2,10.0
7668,120,26,59,85,2,10.0
7669,120,136,295,431,2,10.0
7670,120,18,55,73,2,10.0
7671,120,50,78,128,2,10.0
7672,120,4,19,23,2,10.0
7673,120,28,25,53,2,10.0
7674,120,56,86,142,2,10.0
7675,120,10,32,42,2,10.0
7676,120,7,10,17,2,10.0
7677,120,6,10,16,2,10.0
7678,120,58,99,157,2,10.0
7679,120,23,78,101,2,10.0
7680,120,64,147,211,2,10.0
7681,120,77,152,229,2,10.0
7682,120,46,58,104,2,10.0
7683,120,119,190,309,2,10.0
7684,120,140,271,411,2,10.0
7685,120,76,119,195,2,10.0
7686,120,64,71,135,2,10.0
7687,120,58,80,138,2,10.0
7688,120,60,87,147,2,10.0
7689,120,48,76,124,2,10.0
7690,120,16,29,45,2,10.0
7691,120,33,118,151,2,10.0
7692,120,78,117,195,2,10.0
7693,120,36,125,161,2,10.0
7694,120,89,151,240,2,10.0
7695,120,56,71,127,2,10.0
7696,120,52,88,140,2,10.0
7697,120,65,136,201,2,10.0
7698,120,42,92,134,2,10.0
7699,120,12,32,44,2,10.0
7700,120,57,134,191,2,10.0
7701,120,45,79,124,2,10.0
7702,120,28,50,78,2,10.0
7703,120,8,20,28,2,10.0
7704,120,3,9,12,2,10.0
7705,120,11,10,21,2,10.0
7706,120,2,13,15,2,10.0
7707,120,81,151,232,2,10.0
7708,120,82,107,189,2,10.0
7709,120,74,164,238,2,10.0
7710,120,22,64,86,2,10.0
7711,120,55,91,146,2,10.0
7712,120,16,23,39,2,10.0
7713,120,50,58,108,2,10.0
7714,120,81,67,148,2,10.0
7715,120,52,107,159,2,10.0
7716,120,38,63,101,2,10.0
7717,120,37,143,180,2,10.0
7718,120,25,55,80,2,10.0
7719,120,50,228,278,2,10.0
7720,120,16,31,47,2,10.0
7721,120,18,20,38,2,10.0
7722,180,75,179,254,2,10.0
7723,180,57,127,184,2,10.0
7724,180,58,115,173,2,10.0
7725,180,96,151,247,2,10.0
7726,180,61,52,113,2,10.0
7727,180,43,125,168,2,10.0
7728,180,53,65,118,2,10.0
7729,180,45,98,143,2,10.0
7730,180,24,66,90,2,10.0
7731,180,17,74,91,2,10.0
7732,180,40,34,74,2,10.0
7733,180,63,213,276,2,10.0
7734,180,85,164,249,2,10.0
7735,180,73,133,206,2,10.0
7736,180,65,96,161,2,10.0
7737,180,40,113,153,2,10.0
7738,180,69,97,166,2,10.0
7739,180,28,73,101,2,10.0
7740,180,33,60,93,2,10.0
7741,180,29,40,69,2,10.0
7742,180,65,124,189,2,10.0
7743,180,45,58,103,2,10.0
7744,180,18,46,64,2,10.0
7745,180,76,207,283,2,10.0
7746,180,89,198,287,2,10.0
7747,180,25,78,103,2,10.0
7748,180,77,114,191,2,10.0
7749,180,70,102,172,2,10.0
7750,180,54,101,155,2,10.0
7751,180,20,82,102,2,10.0
7752,180,32,105,137,2,10.0
7753,180,56,103,159,2,10.0
7754,180,16,35,51,2,10.0
7755,180,44,81,125,2,10.0
7756,180,177,224,401,2,10.0
7757,180,49,68,117,2,10.0
7758,180,56,127,183,2,10.0
7759,180,21,30,51,2,10.0
7760,180,81,168,249,2,10.0
7761,180,53,193,246,2,10.0
7762,180,42,122,164,2,10.0
7763,180,38,125,163,2,10.0
7764,180,18,50,68,2,10.0
7765,180,51,22,73,2,10.0
7766,180,12,45,57,2,10.0
7767,180,78,120,198,2,10.0
7768,180,64,85,149,2,10.0
7769,180,28,52,80,2,10.0
7770,180,46,103,149,2,10.0
7771,180,85,178,263,2,10.0
7772,180,17,48,65,2,10.0
7773,180,43,54,97,2,10.0
7774,180,66,98,164,2,10.0
7775,180,31,43,74,2,10.0
7776,180,60,141,201,2,10.0
7777,180,38,51,89,2,10.0
7778,180,2,20,22,2,10.0
7779,180,45,113,158,2,10.0
7780,180,61,149,210,2,10.0
7781,180,0,0,0,2,10.0
7782,180,29,55,84,2,10.0
7783,180,34,75,109,2,10.0
7784,180,5,28,33,2,10.0
7785,180,30,56,86,2,10.0
7786,180,13,7,20,2,10.0
7787,180,48,88,136,2,10.0
7788,180,88,156,244,2,10.0
7789,180,28,71,99,2,10.0
7790,180,71,87,158,2,10.0
7791,180,122,173,295,2,10.0
7792,180,53,102,155,2,10.0
7793,180,150,229,379,2,10.0
7794,180,41,78,119,2,10.0
7795,180,79,158,237,2,10.0
7796,180,76,93,169,2,10.0
7797,180,3,17,20,2,10.0
7798,180,25,31,56,2,10.0
7799,180,10,16,26,2,10.0
7800,180,99,142,241,2,10.0
7801,180,103,206,309,2,10.0
7802,180,74,140,214,2,10.0
7803,180,78,164,242,2,10.0
7804,180,62,159,221,2,10.0
7805,180,68,151,219,2,10.0
7806,180,32,85,117,2,10.0
7807,180,63,122,185,2,10.0
7808,180,29,59,88,2,10.0
7809,180,29,68,97,2,10.0
7810,180,95,156,251,2,10.0
7811,180,41,64,105,2,10.0
7812,180,49,128,177,2,10.0
7813,180,17,36,53,2,10.0
7814,180,13,36,49,2,10.0
7815,180,59,122,181,2,10.0
7816,180,72,68,140,2,10.0
7817,180,40,77,117,2,10.0
7818,180,77,116,193,2,10.0
7819,180,48,101,149,2,10.0
7820,180,98,154,252,2,10.0
7821,180,24,48,72,2,10.0
7822,180,16,28,44,2,10.0
7823,180,8,26,34,2,10.0
7824,180,3,12,15,2,10.0
7825,180,52,89,141,2,10.0
7826,180,87,201,288,2,10.0
7827,180,70,210,280,2,10.0
7828,180,44,63,107,2,10.0
7829,180,32,54,86,2,10.0
7830,180,105,190,295,2,10.0
7831,180,66,136,202,2,10.0
7832,180,105,178,283,2,10.0
7833,180,40,83,123,2,10.0
7834,180,20,44,64,2,10.0
7835,180,22,50,72,2,10.0
7836,180,20,25,45,2,10.0
7837,180,68,146,214,2,10.0
7838,180,44,47,91,2,10.0
7839,180,67,194,261,2,10.0
7840,180,80,106,186,2,10.0
7841,180,29,63,92,2,10.0
7842,180,29,72,101,2,10.0
7843,180,50,67,117,2,10.0
7844,180,151,146,297,2,10.0
7845,180,32,78,110,2,10.0
7846,180,63,117,180,2,10.0
7847,180,39,72,111,2,10.0
7848,180,18,60,78,2,10.0
7849,180,0,3,3,2,10.0
7850,180,10,7,17,2,10.0
7851,180,117,216,333,2,10.0
7852,180,57,109,166,2,10.0
7853,180,16,36,52,2,10.0
7854,180,98,119,217,2,10.0
7855,180,30,43,73,2,10.0
7856,180,80,123,203,2,10.0
7857,180,13,23,36,2,10.0
7858,180,49,151,200,2,10.0
7859,180,43,96,139,2,10.0
7860,180,19,34,53,2,10.0
7861,180,37,84,121,2,10.0
7862,180,33,64,97,2,10.0
7863,180,21,36,57,2,10.0
7864,180,22,12,34,2,10.0
7865,180,5,15,20,2,10.0
7866,180,8,18,26,2,10.0
7867,180,16,33,49,2,10.0
7868,180,77,155,232,2,10.0
7869,180,140,241,381,2,10.0
7870,180,72,121,193,2,10.0
7871,180,73,161,234,2,10.0
7872,180,102,94,196,2,10.0
7873,180,54,64,118,2,10.0
7874,180,136,139,275,2,10.0
7875,180,33,48,81,2,10.0
7876,180,42,83,125,2,10.0
7877,180,49,66,115,2,10.0
7878,180,23,50,73,2,10.0
7879,180,9,37,46,2,10.0
7880,180,26,60,86,2,10.0
7881,180,14,27,41,2,10.0
7882,180,48,98,146,2,10.0
7883,180,81,154,235,2,10.0
7884,180,47,114,161,2,10.0
7885,180,130,181,311,2,10.0
7886,180,56,138,194,2,10.0
7887,180,95,99,194,2,10.0
7888,180,91,115,206,2,10.0
7889,180,39,84,123,2,10.0
7890,180,32,79,111,2,10.0
7891,180,42,40,82,2,10.0
7892,180,43,107,150,2,10.0
7893,180,49,98,147,2,10.0
7894,180,92,132,224,2,10.0
7895,180,44,40,84,2,10.0
7896,180,26,49,75,2,10.0
7897,180,47,80,127,2,10.0
7898,180,196,374,570,2,10.0
7899,180,11,46,57,2,10.0
7900,180,120,224,344,2,10.0
7901,180,31,33,64,2,10.0
7902,180,62,89,151,2,10.0
7903,180,87,124,211,2,10.0
7904,180,91,119,210,2,10.0
7905,180,12,27,39,2,10.0
7906,180,84,125,209,2,10.0
7907,180,29,60,89,2,10.0
7908,180,116,450,566,2,10.0
7909,180,4,13,17,2,10.0
7910,180,58,44,102,2,10.0
7911,180,88,177,265,2,10.0
7912,180,47,84,131,2,10.0
7913,180,35,65,100,2,10.0
7914,180,117,129,246,2,10.0
7915,180,87,150,237,2,10.0
7916,180,90,136,226,2,10.0
7917,180,85,140,225,2,10.0
7918,180,46,76,122,2,10.0
7919,180,37,52,89,2,10.0
7920,180,35,29,64,2,10.0
7921,180,140,230,370,2,10.0
7922,180,137,160,297,2,10.0
7923,180,129,223,352,2,10.0
7924,180,149,120,269,2,10.0
7925,180,30,115,145,2,10.0
7926,180,137,218,355,2,10.0
7927,180,54,111,165,2,10.0
7928,180,62,128,190,2,10.0
7929,180,82,85,167,2,10.0
7930,180,36,74,110,2,10.0
7931,180,41,99,140,2,10.0
7932,180,95,87,182,2,10.0
7933,180,74,153,227,2,10.0
7934,180,34,86,120,2,10.0
7935,180,228,159,387,2,10.0
7936,180,6,41,47,2,10.0
7937,180,128,151,279,2,10.0
7938,180,12,102,114,2,10.0
7939,180,8,16,24,2,10.0
7940,180,44,45,89,2,10.0
7941,180,25,50,75,2,10.0
7942,180,105,114,219,2,10.0
7943,180,77,152,229,2,10.0
7944,180,52,39,91,2,10.0
7945,180,59,89,148,2,10.0
7946,180,134,275,409,2,10.0
7947,180,59,68,127,2,10.0
7948,180,89,127,216,2,10.0
7949,180,36,64,100,2,10.0
7950,180,161,147,308,2,10.0
7951,180,97,168,265,2,10.0
7952,180,60,43,103,2,10.0
7953,180,39,65,104,2,10.0
7954,180,61,142,203,2,10.0
7955,180,177,173,350,2,10.0
7956,180,27,34,61,2,10.0
7957,180,1,1,2,2,10.0
7958,180,17,4,21,2,10.0
7959,180,12,2,14,2,10.0
7960,180,105,148,253,2,10.0
7961,180,90,147,237,2,10.0
7962,180,100,98,198,2,10.0
7963,180,69,121,190,2,10.0
7964,180,108,99,207,2,10.0
7965,180,89,179,268,2,10.0
7966,180,31,46,77,2,10.0
7967,180,52,59,111,2,10.0
7968,180,69,120,189,2,10.0
7969,180,64,76,140,2,10.0
7970,180,40,130,170,2,10.0
7971,180,117,154,271,2,10.0
7972,180,47,97,144,2,10.0
7973,180,62,93,155,2,10.0
7974,180,45,53,98,2,10.0
7975,180,9,6,15,2,10.0
7976,180,65,110,175,2,10.0
7977,180,71,103,174,2,10.0
7978,180,97,145,242,2,10.0
7979,180,71,104,175,2,10.0
7980,180,47,112,159,2,10.0
7981,180,44,96,140,2,10.0
7982,180,119,138,257,2,10.0
7983,180,35,73,108,2,10.0
7984,180,44,74,118,2,10.0
7985,180,35,46,81,2,10.0
7986,180,37,44,81,2,10.0
7987,180,31,42,73,2,10.0
7988,180,17,20,37,2,10.0
7989,180,8,31,39,2,10.0
7990,180,23,39,62,2,10.0
7991,180,24,55,79,2,10.0
7992,180,40,116,156,2,10.0
7993,180,100,148,248,2,10.0
7994,180,42,42,84,2,10.0
7995,180,51,92,143,2,10.0
7996,180,52,86,138,2,10.0
7997,180,60,77,137,2,10.0
7998,180,19,32,51,2,10.0
7999,180,33,68,101,2,10.0
8000,180,18,35,53,2,10.0
8001,180,11,18,29,2,10.0
8002,180,13,29,42,2,10.0
8003,180,23,14,37,2,10.0
8004,180,10,22,32,2,10.0
8005,180,131,178,309,2,10.0
8006,180,64,110,174,2,10.0
8007,180,47,68,115,2,10.0
8008,180,45,74,119,2,10.0
8009,180,55,119,174,2,10.0
8010,180,91,127,218,2,10.0
8011,180,104,110,214,2,10.0
8012,180,51,72,123,2,10.0
8013,180,122,73,195,2,10.0
8014,180,16,60,76,2,10.0
8015,180,5,39,44,2,10.0
8016,180,50,75,125,2,10.0
8017,180,69,162,231,2,10.0
8018,180,36,62,98,2,10.0
8019,180,12,64,76,2,10.0
8020,180,2,14,16,2,10.0
8021,180,106,156,262,2,10.0
8022,180,125,225,350,2,10.0
8023,180,32,43,75,2,10.0
8024,180,53,73,126,2,10.0
8025,180,103,189,292,2,10.0
8026,180,82,92,174,2,10.0
8027,180,120,212,332,2,10.0
8028,180,28,73,101,2,10.0
8029,180,58,67,125,2,10.0
8030,180,167,328,495,2,10.0
8031,180,44,98,142,2,10.0
8032,180,40,97,137,2,10.0
8033,180,19,71,90,2,10.0
8034,180,33,42,75,2,10.0
8035,180,55,144,199,2,10.0
8036,180,59,123,182,2,10.0
8037,180,88,142,230,2,10.0
8038,180,72,88,160,2,10.0
8039,180,67,121,188,2,10.0
8040,180,46,102,148,2,10.0
8041,180,43,81,124,2,10.0
8042,180,155,244,399,2,10.0
8043,180,28,74,102,2,10.0
8044,180,49,135,184,2,10.0
8045,180,51,69,120,2,10.0
8046,180,63,108,171,2,10.0
8047,180,29,94,123,2,10.0
8048,180,47,84,131,2,10.0
8049,180,26,66,92,2,10.0
8050,180,17,41,58,2,10.0
8051,180,7,20,27,2,10.0
8052,180,15,30,45,2,10.0
8053,180,78,183,261,2,10.0
8054,180,65,145,210,2,10.0
8055,180,121,124,245,2,10.0
8056,180,52,108,160,2,10.0
8057,180,94,204,298,2,10.0
8058,180,69,123,192,2,10.0
8059,180,47,100,147,2,10.0
8060,180,92,127,219,2,10.0
8061,180,3,19,22,2,10.0
8062,180,81,168,249,2,10.0
8063,180,38,61,99,2,10.0
8064,180,35,44,79,2,10.0
8065,180,5,13,18,2,10.0
8066,180,16,21,37,2,10.0
8067,180,106,286,392,2,10.0
8068,180,116,209,325,2,10.0
8069,180,188,223,411,2,10.0
8070,180,54,86,140,2,10.0
8071,180,31,80,111,2,10.0
8072,180,82,157,239,2,10.0
8073,180,105,193,298,2,10.0
8074,180,56,101,157,2,10.0
8075,180,41,83,124,2,10.0
8076,180,27,38,65,2,10.0
8077,180,81,173,254,2,10.0
8078,180,30,51,81,2,10.0
8079,180,84,169,253,2,10.0
8080,180,65,70,135,2,10.0
8081,180,65,150,215,2,10.0
8082,180,66,136,202,2,10.0
8083,180,99,193,292,2,10.0
8084,180,25,65,90,2,10.0
8085,180,117,185,302,2,10.0
8086,180,70,142,212,2,10.0
8087,180,63,72,135,2,10.0
8088,180,72,104,176,2,10.0
8089,180,54,53,107,2,10.0
8090,180,25,107,132,2,10.0
8091,180,81,74,155,2,10.0
8092,180,60,141,201,2,10.0
8093,180,105,67,172,2,10.0
8094,180,74,115,189,2,10.0
8095,180,95,172,267,2,10.0
8096,180,20,47,67,2,10.0
8097,180,59,93,152,2,10.0
8098,180,85,106,191,2,10.0
8099,180,50,118,168,2,10.0
8100,180,21,70,91,2,10.0
8101,180,24,53,77,2,10.0
8102,180,18,50,68,2,10.0
8103,180,44,83,127,2,10.0
8104,180,143,169,312,2,10.0
8105,180,63,98,161,2,10.0
8106,180,180,313,493,2,10.0
8107,180,53,82,135,2,10.0
8108,180,135,245,380,2,10.0
8109,180,129,243,372,2,10.0
8110,180,56,176,232,2,10.0
8111,180,111,193,304,2,10.0
8112,180,37,34,71,2,10.0
8113,180,93,168,261,2,10.0
8114,180,17,34,51,2,10.0
8115,180,13,12,25,2,10.0
8116,180,78,117,195,2,10.0
8117,180,59,102,161,2,10.0
8118,180,60,127,187,2,10.0
8119,180,88,269,357,2,10.0
8120,180,41,69,110,2,10.0
8121,180,23,51,74,2,10.0
8122,180,41,90,131,2,10.0
8123,180,54,105,159,2,10.0
8124,180,32,55,87,2,10.0
8125,180,32,65,97,2,10.0
8126,180,51,72,123,2,10.0
8127,180,41,59,100,2,10.0
8128,180,86,102,188,2,10.0
8129,180,59,139,198,2,10.0
8130,180,11,19,30,2,10.0
0,0,42,128,170,3,0.0
1,0,24,87,111,3,0.0
2,0,56,85,141,3,0.0
3,0,18,49,67,3,0.0
4,0,38,57,95,3,0.0
5,0,44,67,111,3,0.0
6,0,21,52,73,3,0.0
7,0,8,16,24,3,0.0
8,0,21,34,55,3,0.0
9,0,5,8,13,3,0.0
10,0,18,43,61,3,0.0
11,0,7,15,22,3,0.0
12,0,7,13,20,3,0.0
13,0,2,17,19,3,0.0
14,0,30,127,157,3,0.0
15,0,37,173,210,3,0.0
16,0,15,22,37,3,0.0
17,0,16,56,72,3,0.0
18,0,26,135,161,3,0.0
19,0,21,83,104,3,0.0
20,0,32,82,114,3,0.0
21,0,8,23,31,3,0.0
22,0,17,30,47,3,0.0
23,0,4,5,9,3,0.0
24,0,5,20,25,3,0.0
25,0,12,25,37,3,0.0
26,0,1,16,17,3,0.0
27,0,33,84,117,3,0.0
28,0,14,103,117,3,0.0
29,0,41,123,164,3,0.0
30,0,27,123,150,3,0.0
31,0,13,75,88,3,0.0
32,0,28,47,75,3,0.0
33,0,32,45,77,3,0.0
34,0,17,35,52,3,0.0
35,0,47,82,129,3,0.0
36,0,33,88,121,3,0.0
37,0,17,70,87,3,0.0
38,0,6,28,34,3,0.0
39,0,60,192,252,3,0.0
40,0,26,54,80,3,0.0
41,0,16,25,41,3,0.0
42,0,15,36,51,3,0.0
43,0,21,32,53,3,0.0
44,0,3,16,19,3,0.0
45,0,4,7,11,3,0.0
46,0,40,164,204,3,0.0
47,0,36,81,117,3,0.0
48,0,36,47,83,3,0.0
49,0,70,103,173,3,0.0
50,0,40,128,168,3,0.0
51,0,13,14,27,3,0.0
52,0,31,100,131,3,0.0
53,0,13,24,37,3,0.0
54,0,25,92,117,3,0.0
55,0,17,92,109,3,0.0
56,0,15,49,64,3,0.0
57,0,12,22,34,3,0.0
58,0,13,31,44,3,0.0
59,0,27,35,62,3,0.0
60,0,19,28,47,3,0.0
61,0,2,1,3,3,0.0
62,0,3,7,10,3,0.0
63,0,15,18,33,3,0.0
64,0,2,1,3,3,0.0
65,0,13,47,60,3,0.0
66,0,30,18,48,3,0.0
67,0,22,46,68,3,0.0
68,0,11,15,26,3,0.0
69,0,16,55,71,3,0.0
70,0,25,46,71,3,0.0
71,0,9,13,22,3,0.0
72,0,14,52,66,3,0.0
73,0,29,48,77,3,0.0
74,0,4,15,19,3,0.0
75,0,9,11,20,3,0.0
76,0,9,24,33,3,0.0
77,0,19,28,47,3,0.0
78,0,8,7,15,3,0.0
79,0,17,14,31,3,0.0
80,0,28,72,100,3,0.0
81,0,41,82,123,3,0.0
82,0,48,159,207,3,0.0
83,0,31,123,154,3,0.0
84,0,34,88,122,3,0.0
85,0,12,20,32,3,0.0
86,0,15,59,74,3,0.0
87,0,51,141,192,3,0.0
88,0,24,47,71,3,0.0
89,0,13,81,94,3,0.0
90,0,23,49,72,3,0.0
91,0,12,31,43,3,0.0
92,0,3,11,14,3,0.0
93,0,10,23,33,3,0.0
94,0,3,6,9,3,0.0
95,0,17,66,83,3,0.0
96,0,67,170,237,3,0.0
97,0,4,13,17,3,0.0
98,0,11,18,29,3,0.0
99,0,39,89,128,3,0.0
100,0,6,42,48,3,0.0
101,0,19,102,121,3,0.0
102,0,34,111,145,3,0.0
103,0,46,104,150,3,0.0
104,0,9,28,37,3,0.0
105,0,7,18,25,3,0.0
106,0,13,44,57,3,0.0
107,0,23,41,64,3,0.0
108,0,16,27,43,3,0.0
109,0,4,19,23,3,0.0
110,0,6,23,29,3,0.0
111,0,9,27,36,3,0.0
112,0,5,24,29,3,0.0
113,0,28,119,147,3,0.0
114,0,21,110,131,3,0.0
115,0,80,152,232,3,0.0
116,0,12,125,137,3,0.0
117,0,26,36,62,3,0.0
118,0,59,138,197,3,0.0
119,0,11,19,30,3,0.0
120,0,16,32,48,3,0.0
121,0,31,145,176,3,0.0
122,0,12,37,49,3,0.0
123,0,10,19,29,3,0.0
124,0,8,31,39,3,0.0
125,0,16,46,62,3,0.0
126,0,24,21,45,3,0.0
127,0,22,73,95,3,0.0
128,0,52,50,102,3,0.0
129,0,102,59,161,3,0.0
130,0,38,108,146,3,0.0
131,0,23,73,96,3,0.0
132,0,31,156,187,3,0.0
133,0,48,190,238,3,0.0
134,0,39,115,154,3,0.0
135,0,27,102,129,3,0.0
136,0,18,49,67,3,0.0
137,0,22,28,50,3,0.0
138,0,14,15,29,3,0.0
139,0,15,18,33,3,0.0
140,0,1,5,6,3,0.0
141,0,4,16,20,3,0.0
142,0,16,19,35,3,0.0
143,0,35,100,135,3,0.0
144,0,14,48,62,3,0.0
145,0,21,59,80,3,0.0
146,0,7,30,37,3,0.0
147,0,5,39,44,3,0.0
148,0,1,29,30,3,0.0
149,0,13,49,62,3,0.0
150,0,14,56,70,3,0.0
151,0,29,31,60,3,0.0
152,0,4,13,17,3,0.0
153,0,5,5,10,3,0.0
154,0,2,7,9,3,0.0
155,0,5,15,20,3,0.0
156,0,10,8,18,3,0.0
157,0,4,2,6,3,0.0
158,0,3,2,5,3,0.0
159,0,4,21,25,3,0.0
160,0,28,92,120,3,0.0
161,0,35,62,97,3,0.0
162,0,32,49,81,3,0.0
163,0,51,160,211,3,0.0
164,0,28,114,142,3,0.0
165,0,36,105,141,3,0.0
166,0,1,12,13,3,0.0
167,0,51,138,189,3,0.0
168,0,14,71,85,3,0.0
169,0,6,19,25,3,0.0
170,0,12,29,41,3,0.0
171,0,13,33,46,3,0.0
172,0,25,40,65,3,0.0
173,0,2,11,13,3,0.0
174,0,3,7,10,3,0.0
175,0,9,13,22,3,0.0
176,0,23,96,119,3,0.0
177,0,14,47,61,3,0.0
178,0,18,55,73,3,0.0
179,0,38,117,155,3,0.0
180,0,6,49,55,3,0.0
181,0,37,55,92,3,0.0
182,0,51,101,152,3,0.0
183,0,38,44,82,3,0.0
184,0,5,11,16,3,0.0
185,0,11,7,18,3,0.0
186,0,8,11,19,3,0.0
187,0,5,17,22,3,0.0
188,0,10,46,56,3,0.0
189,0,11,54,65,3,0.0
190,0,20,103,123,3,0.0
191,0,4,24,28,3,0.0
192,0,13,106,119,3,0.0
193,0,14,64,78,3,0.0
194,0,17,22,39,3,0.0
195,0,13,32,45,3,0.0
196,0,9,52,61,3,0.0
197,0,7,14,21,3,0.0
198,0,9,25,34,3,0.0
199,0,5,7,12,3,0.0
200,0,3,16,19,3,0.0
201,0,4,13,17,3,0.0
202,0,13,25,38,3,0.0
203,0,11,41,52,3,0.0
204,0,29,101,130,3,0.0
205,0,8,44,52,3,0.0
206,0,16,78,94,3,0.0
207,0,34,81,115,3,0.0
208,0,24,64,88,3,0.0
209,0,22,59,81,3,0.0
210,0,20,55,75,3,0.0
211,0,7,58,65,3,0.0
212,0,12,25,37,3,0.0
213,0,25,62,87,3,0.0
214,0,15,94,109,3,0.0
215,0,39,113,152,3,0.0
216,0,37,125,162,3,0.0
217,0,12,46,58,3,0.0
218,0,34,49,83,3,0.0
219,0,43,147,190,3,0.0
220,0,17,46,63,3,0.0
221,0,38,88,126,3,0.0
222,0,18,35,53,3,0.0
223,0,2,13,15,3,0.0
224,0,7,11,18,3,0.0
225,0,9,31,40,3,0.0
226,0,0,0,0,3,0.0
227,0,45,146,191,3,0.0
228,0,12,23,35,3,0.0
229,0,7,57,64,3,0.0
230,0,9,8,17,3,0.0
231,0,34,56,90,3,0.0
232,0,5,16,21,3,0.0
233,0,20,78,98,3,0.0
234,0,14,36,50,3,0.0
235,0,39,91,130,3,0.0
236,0,38,62,100,3,0.0
237,0,5,9,14,3,0.0
238,0,13,24,37,3,0.0
239,0,13,24,37,3,0.0
240,0,1,2,3,3,0.0
241,0,1,3,4,3,0.0
242,0,6,6,12,3,0.0
243,0,3,10,13,3,0.0
244,0,6,15,21,3,0.0
245,0,25,83,108,3,0.0
246,0,29,64,93,3,0.0
247,0,16,54,70,3,0.0
248,0,18,44,62,3,0.0
249,0,13,23,36,3,0.0
250,0,29,49,78,3,0.0
251,0,12,48,60,3,0.0
252,0,9,12,21,3,0.0
253,0,5,14,19,3,0.0
254,0,4,2,6,3,0.0
255,0,5,13,18,3,0.0
256,0,2,5,7,3,0.0
257,0,9,10,19,3,0.0
258,0,0,6,6,3,0.0
259,0,2,3,5,3,0.0
260,0,1,4,5,3,0.0
261,0,1,2,3,3,0.0
262,0,20,59,79,3,0.0
263,0,24,60,84,3,0.0
264,0,12,36,48,3,0.0
265,0,8,29,37,3,0.0
266,0,12,31,43,3,0.0
267,0,16,57,73,3,0.0
268,0,4,19,23,3,0.0
269,0,21,37,58,3,0.0
270,0,9,27,36,3,0.0
271,0,10,26,36,3,0.0
272,0,8,8,16,3,0.0
273,0,5,24,29,3,0.0
274,0,1,5,6,3,0.0
275,0,8,3,11,3,0.0
276,0,10,34,44,3,0.0
277,0,36,52,88,3,0.0
278,0,7,30,37,3,0.0
279,0,23,43,66,3,0.0
280,0,9,10,19,3,0.0
281,0,28,112,140,3,0.0
282,0,12,34,46,3,0.0
283,0,42,79,121,3,0.0
284,0,12,22,34,3,0.0
285,0,17,45,62,3,0.0
286,0,9,8,17,3,0.0
287,0,3,8,11,3,0.0
288,0,4,6,10,3,0.0
289,0,0,2,2,3,0.0
290,0,0,0,0,3,0.0
291,30,23,61,84,3,0.3
292,30,21,85,106,3,0.3
293,30,21,37,58,3,0.3
294,30,9,28,37,3,0.3
295,30,15,49,64,3,0.3
296,30,40,86,126,3,0.3
297,30,16,51,67,3,0.3
298,30,4,15,19,3,0.3
299,30,19,46,65,3,0.3
300,30,11,31,42,3,0.3
301,30,18,31,49,3,0.3
302,30,0,16,16,3,0.3
303,30,11,25,36,3,0.3
304,30,0,4,4,3,0.3
305,30,5,4,9,3,0.3
306,30,5,28,33,3,0.3
307,30,6,3,9,3,0.3
308,30,20,65,85,3,0.3
309,30,35,95,130,3,0.3
310,30,21,88,109,3,0.3
311,30,3,9,12,3,0.3
312,30,32,155,187,3,0.3
313,30,14,63,77,3,0.3
314,30,18,91,109,3,0.3
315,30,10,21,31,3,0.3
316,30,2,13,15,3,0.3
317,30,11,21,32,3,0.3
318,30,10,12,22,3,0.3
319,30,18,13,31,3,0.3
320,30,3,3,6,3,0.3
321,30,4,13,17,3,0.3
322,30,3,7,10,3,0.3
323,30,6,27,33,3,0.3
324,30,5,14,19,3,0.3
325,30,16,57,73,3,0.3
326,30,26,83,109,3,0.3
327,30,16,37,53,3,0.3
328,30,41,21,62,3,0.3
329,30,11,32,43,3,0.3
330,30,20,47,67,3,0.3
331,30,4,8,12,3,0.3
332,30,7,18,25,3,0.3
333,30,11,16,27,3,0.3
334,30,1,6,7,3,0.3
335,30,30,38,68,3,0.3
336,30,4,9,13,3,0.3
337,30,0,0,0,3,0.3
338,30,7,15,22,3,0.3
339,30,2,13,15,3,0.3
340,30,15,60,75,3,0.3
341,30,17,23,40,3,0.3
342,30,24,60,84,3,0.3
343,30,16,44,60,3,0.3
344,30,28,81,109,3,0.3
345,30,51,88,139,3,0.3
346,30,6,19,25,3,0.3
347,30,21,41,62,3,0.3
348,30,25,57,82,3,0.3
349,30,12,22,34,3,0.3
350,30,3,10,13,3,0.3
351,30,1,6,7,3,0.3
352,30,10,72,82,3,0.3
353,30,20,66,86,3,0.3
354,30,10,21,31,3,0.3
355,30,8,33,41,3,0.3
356,30,3,1,4,3,0.3
357,30,44,85,129,3,0.3
358,30,19,45,64,3,0.3
359,30,1,12,13,3,0.3
360,30,29,75,104,3,0.3
361,30,8,16,24,3,0.3
362,30,17,26,43,3,0.3
363,30,5,17,22,3,0.3
364,30,4,8,12,3,0.3
365,30,0,10,10,3,0.3
366,30,11,31,42,3,0.3
367,30,0,4,4,3,0.3
368,30,4,5,9,3,0.3
369,30,0,0,0,3,0.3
370,30,13,18,31,3,0.3
371,30,4,29,33,3,0.3
372,30,17,35,52,3,0.3
373,30,0,0,0,3,0.3
374,30,1,8,9,3,0.3
375,30,18,39,57,3,0.3
376,30,12,34,46,3,0.3
377,30,8,11,19,3,0.3
378,30,26,34,60,3,0.3
379,30,15,17,32,3,0.3
380,30,19,26,45,3,0.3
381,30,8,32,40,3,0.3
382,30,3,3,6,3,0.3
383,30,3,6,9,3,0.3
384,30,9,8,17,3,0.3
385,30,0,4,4,3,0.3
386,30,0,0,0,3,0.3
387,30,0,0,0,3,0.3
388,30,1,2,3,3,0.3
389,30,7,66,73,3,0.3
390,30,10,26,36,3,0.3
391,30,14,23,37,3,0.3
392,30,29,110,139,3,0.3
393,30,22,62,84,3,0.3
394,30,36,124,160,3,0.3
395,30,17,24,41,3,0.3
396,30,6,27,33,3,0.3
397,30,6,9,15,3,0.3
398,30,5,19,24,3,0.3
399,30,10,23,33,3,0.3
400,30,2,10,12,3,0.3
401,30,4,7,11,3,0.3
402,30,2,6,8,3,0.3
403,30,0,0,0,3,0.3
404,30,38,95,133,3,0.3
405,30,21,58,79,3,0.3
406,30,10,48,58,3,0.3
407,30,44,73,117,3,0.3
408,30,15,63,78,3,0.3
409,30,4,25,29,3,0.3
410,30,20,72,92,3,0.3
411,30,5,14,19,3,0.3
412,30,26,76,102,3,0.3
413,30,5,12,17,3,0.3
414,30,1,6,7,3,0.3
415,30,3,1,4,3,0.3
416,30,0,0,0,3,0.3
417,30,0,0,0,3,0.3
418,30,12,11,23,3,0.3
419,30,2,7,9,3,0.3
420,30,32,66,98,3,0.3
421,30,29,71,100,3,0.3
422,30,12,43,55,3,0.3
423,30,9,33,42,3,0.3
424,30,32,55,87,3,0.3
425,30,6,14,20,3,0.3
426,30,9,30,39,3,0.3
427,30,5,7,12,3,0.3
428,30,3,5,8,3,0.3
429,30,0,6,6,3,0.3
430,30,7,2,9,3,0.3
431,30,0,2,2,3,0.3
432,30,17,46,63,3,0.3
433,30,31,86,117,3,0.3
434,30,17,78,95,3,0.3
435,30,52,87,139,3,0.3
436,30,15,47,62,3,0.3
437,30,6,13,19,3,0.3
438,30,1,11,12,3,0.3
439,30,17,40,57,3,0.3
440,30,6,19,25,3,0.3
441,30,10,33,43,3,0.3
442,30,0,0,0,3,0.3
443,30,6,5,11,3,0.3
444,30,4,4,8,3,0.3
445,30,78,125,203,3,0.3
446,30,40,78,118,3,0.3
447,30,44,104,148,3,0.3
448,30,56,130,186,3,0.3
449,30,17,86,103,3,0.3
450,30,21,42,63,3,0.3
451,30,67,91,158,3,0.3
452,30,25,54,79,3,0.3
453,30,12,36,48,3,0.3
454,30,56,90,146,3,0.3
455,30,6,13,19,3,0.3
456,30,0,3,3,3,0.3
457,30,5,11,16,3,0.3
458,30,7,10,17,3,0.3
459,30,15,43,58,3,0.3
460,30,13,54,67,3,0.3
461,30,7,46,53,3,0.3
462,30,15,43,58,3,0.3
463,30,10,19,29,3,0.3
464,30,5,20,25,3,0.3
465,30,6,10,16,3,0.3
466,30,5,13,18,3,0.3
467,30,2,16,18,3,0.3
468,30,1,9,10,3,0.3
469,30,6,4,10,3,0.3
470,30,13,36,49,3,0.3
471,30,34,121,155,3,0.3
472,30,23,75,98,3,0.3
473,30,38,111,149,3,0.3
474,30,39,50,89,3,0.3
475,30,15,30,45,3,0.3
476,30,12,11,23,3,0.3
477,30,5,5,10,3,0.3
478,30,4,10,14,3,0.3
479,30,3,4,7,3,0.3
480,30,2,6,8,3,0.3
481,30,9,16,25,3,0.3
482,30,12,34,46,3,0.3
483,30,20,36,56,3,0.3
484,30,36,76,112,3,0.3
485,30,18,54,72,3,0.3
486,30,23,78,101,3,0.3
487,30,13,41,54,3,0.3
488,30,29,80,109,3,0.3
489,30,1,4,5,3,0.3
490,30,0,5,5,3,0.3
491,30,3,6,9,3,0.3
492,30,0,2,2,3,0.3
493,30,36,71,107,3,0.3
494,30,5,35,40,3,0.3
495,30,15,71,86,3,0.3
496,30,1,9,10,3,0.3
497,30,27,64,91,3,0.3
498,30,23,42,65,3,0.3
499,30,40,23,63,3,0.3
500,30,37,104,141,3,0.3
501,30,30,38,68,3,0.3
502,30,10,26,36,3,0.3
503,30,7,26,33,3,0.3
504,30,1,3,4,3,0.3
505,30,0,0,0,3,0.3
506,30,0,2,2,3,0.3
507,30,43,85,128,3,0.3
508,30,15,17,32,3,0.3
509,30,2,4,6,3,0.3
510,30,22,51,73,3,0.3
511,30,5,30,35,3,0.3
512,30,34,96,130,3,0.3
513,30,8,11,19,3,0.3
514,30,14,26,40,3,0.3
515,30,12,47,59,3,0.3
516,30,73,119,192,3,0.3
517,30,0,5,5,3,0.3
518,30,23,33,56,3,0.3
519,30,22,31,53,3,0.3
520,30,5,8,13,3,0.3
521,30,1,2,3,3,0.3
522,30,6,12,18,3,0.3
523,30,1,1,2,3,0.3
524,30,0,0,0,3,0.3
525,30,36,58,94,3,0.3
526,30,54,80,134,3,0.3
527,30,27,73,100,3,0.3
528,30,23,66,89,3,0.3
529,30,9,34,43,3,0.3
530,30,19,31,50,3,0.3
531,30,8,9,17,3,0.3
532,30,77,98,175,3,0.3
533,30,8,6,14,3,0.3
534,30,8,20,28,3,0.3
535,30,8,15,23,3,0.3
536,30,4,11,15,3,0.3
537,30,10,26,36,3,0.3
538,30,2,7,9,3,0.3
539,30,4,10,14,3,0.3
540,30,17,34,51,3,0.3
541,30,21,35,56,3,0.3
542,30,42,80,122,3,0.3
543,30,30,81,111,3,0.3
544,30,8,24,32,3,0.3
545,30,57,122,179,3,0.3
546,30,27,46,73,3,0.3
547,30,13,31,44,3,0.3
548,30,16,34,50,3,0.3
549,30,10,35,45,3,0.3
550,30,27,29,56,3,0.3
551,30,16,23,39,3,0.3
552,30,0,4,4,3,0.3
553,30,0,3,3,3,0.3
554,50,4,5,9,3,0.3
555,50,16,64,80,3,0.3
556,50,17,14,31,3,0.3
557,50,29,45,74,3,0.3
558,50,16,52,68,3,0.3
559,50,14,34,48,3,0.3
560,50,31,58,89,3,0.3
561,50,24,39,63,3,0.3
562,50,8,10,18,3,0.3
563,50,14,48,62,3,0.3
564,50,7,13,20,3,0.3
565,50,12,39,51,3,0.3
566,50,8,19,27,3,0.3
567,50,1,2,3,3,0.3
568,50,21,9,30,3,0.3
569,50,9,12,21,3,0.3
570,50,12,38,50,3,0.3
571,50,0,3,3,3,0.3
572,50,3,12,15,3,0.3
573,50,26,65,91,3,0.3
574,50,9,20,29,3,0.3
575,50,20,48,68,3,0.3
576,50,11,6,17,3,0.3
577,50,18,33,51,3,0.3
578,50,7,24,31,3,0.3
579,50,10,13,23,3,0.3
580,50,7,36,43,3,0.3
581,50,6,6,12,3,0.3
582,50,12,17,29,3,0.3
583,50,10,31,41,3,0.3
584,50,5,12,17,3,0.3
585,50,5,19,24,3,0.3
586,50,5,19,24,3,0.3
587,50,8,16,24,3,0.3
588,50,12,23,35,3,0.3
589,50,3,5,8,3,0.3
590,50,8,26,34,3,0.3
591,50,16,30,46,3,0.3
592,50,34,94,128,3,0.3
593,50,43,56,99,3,0.3
594,50,17,95,112,3,0.3
595,50,16,63,79,3,0.3
596,50,32,76,108,3,0.3
597,50,18,82,100,3,0.3
598,50,35,91,126,3,0.3
599,50,2,14,16,3,0.3
600,50,56,82,138,3,0.3
601,50,20,88,108,3,0.3
602,50,8,13,21,3,0.3
603,50,38,53,91,3,0.3
604,50,41,43,84,3,0.3
605,50,14,36,50,3,0.3
606,50,9,17,26,3,0.3
607,50,8,4,12,3,0.3
608,50,14,48,62,3,0.3
609,50,26,87,113,3,0.3
610,50,15,39,54,3,0.3
611,50,28,90,118,3,0.3
612,50,23,124,147,3,0.3
613,50,43,137,180,3,0.3
614,50,21,58,79,3,0.3
615,50,39,78,117,3,0.3
616,50,7,33,40,3,0.3
617,50,14,41,55,3,0.3
618,50,11,12,23,3,0.3
619,50,1,12,13,3,0.3
620,50,38,57,95,3,0.3
621,50,18,43,61,3,0.3
622,50,26,87,113,3,0.3
623,50,17,42,59,3,0.3
624,50,85,150,235,3,0.3
625,50,33,49,82,3,0.3
626,50,93,271,364,3,0.3
627,50,25,80,105,3,0.3
628,50,46,70,116,3,0.3
629,50,6,10,16,3,0.3
630,50,16,12,28,3,0.3
631,50,10,37,47,3,0.3
632,50,2,2,4,3,0.3
633,50,1,30,31,3,0.3
634,50,17,49,66,3,0.3
635,50,42,116,158,3,0.3
636,50,75,199,274,3,0.3
637,50,22,53,75,3,0.3
638,50,34,123,157,3,0.3
639,50,11,20,31,3,0.3
640,50,20,79,99,3,0.3
641,50,13,23,36,3,0.3
642,50,22,33,55,3,0.3
643,50,11,16,27,3,0.3
644,50,17,26,43,3,0.3
645,50,3,13,16,3,0.3
646,50,11,67,78,3,0.3
647,50,2,6,8,3,0.3
648,50,15,43,58,3,0.3
649,50,23,77,100,3,0.3
650,50,22,52,74,3,0.3
651,50,27,34,61,3,0.3
652,50,16,42,58,3,0.3
653,50,11,23,34,3,0.3
654,50,60,100,160,3,0.3
655,50,16,57,73,3,0.3
656,50,1,11,12,3,0.3
657,50,14,55,69,3,0.3
658,50,17,34,51,3,0.3
659,50,32,76,108,3,0.3
660,50,3,3,6,3,0.3
661,50,20,40,60,3,0.3
662,50,3,16,19,3,0.3
663,50,3,13,16,3,0.3
664,50,24,26,50,3,0.3
665,50,34,74,108,3,0.3
666,50,20,78,98,3,0.3
667,50,27,36,63,3,0.3
668,50,19,59,78,3,0.3
669,50,29,82,111,3,0.3
670,50,18,20,38,3,0.3
671,50,23,57,80,3,0.3
672,50,18,53,71,3,0.3
673,50,20,26,46,3,0.3
674,50,40,82,122,3,0.3
675,50,6,13,19,3,0.3
676,50,0,0,0,3,0.3
677,50,8,16,24,3,0.3
678,50,52,109,161,3,0.3
679,50,16,66,82,3,0.3
680,50,3,5,8,3,0.3
681,50,9,15,24,3,0.3
682,50,4,17,21,3,0.3
683,50,25,105,130,3,0.3
684,50,10,37,47,3,0.3
685,50,44,29,73,3,0.3
686,50,83,110,193,3,0.3
687,50,28,64,92,3,0.3
688,50,15,32,47,3,0.3
689,50,7,4,11,3,0.3
690,50,6,20,26,3,0.3
691,50,2,5,7,3,0.3
692,50,4,15,19,3,0.3
693,50,2,1,3,3,0.3
694,50,19,43,62,3,0.3
695,50,22,28,50,3,0.3
696,50,12,25,37,3,0.3
697,50,19,23,42,3,0.3
698,50,18,45,63,3,0.3
699,50,3,12,15,3,0.3
700,50,0,0,0,3,0.3
701,50,13,22,35,3,0.3
702,50,5,11,16,3,0.3
703,50,5,14,19,3,0.3
704,50,7,30,37,3,0.3
705,50,4,4,8,3,0.3
706,50,18,34,52,3,0.3
707,50,15,29,44,3,0.3
708,50,22,12,34,3,0.3
709,50,13,23,36,3,0.3
710,50,9,18,27,3,0.3
711,50,4,5,9,3,0.3
712,50,0,2,2,3,0.3
713,50,46,100,146,3,0.3
714,50,30,44,74,3,0.3
715,50,21,57,78,3,0.3
716,50,17,65,82,3,0.3
717,50,28,50,78,3,0.3
718,50,25,49,74,3,0.3
719,50,19,40,59,3,0.3
720,50,12,36,48,3,0.3
721,50,10,13,23,3,0.3
722,50,15,39,54,3,0.3
723,50,25,39,64,3,0.3
724,50,8,28,36,3,0.3
725,50,12,22,34,3,0.3
726,50,0,5,5,3,0.3
727,50,22,68,90,3,0.3
728,50,47,69,116,3,0.3
729,50,61,99,160,3,0.3
730,50,26,27,53,3,0.3
731,50,5,35,40,3,0.3
732,50,15,66,81,3,0.3
733,50,9,41,50,3,0.3
734,50,20,33,53,3,0.3
735,50,7,20,27,3,0.3
736,50,8,25,33,3,0.3
737,50,11,11,22,3,0.3
738,50,3,2,5,3,0.3
739,50,142,330,472,3,0.3
740,50,104,248,352,3,0.3
741,50,177,356,533,3,0.3
742,50,62,145,207,3,0.3
743,50,155,222,377,3,0.3
744,50,32,57,89,3,0.3
745,50,135,190,325,3,0.3
746,50,92,163,255,3,0.3
747,50,46,131,177,3,0.3
748,50,64,167,231,3,0.3
749,50,74,179,253,3,0.3
750,50,99,276,375,3,0.3
751,50,55,128,183,3,0.3
752,50,56,125,181,3,0.3
753,50,46,135,181,3,0.3
754,50,12,15,27,3,0.3
755,50,20,29,49,3,0.3
756,50,11,14,25,3,0.3
757,50,34,49,83,3,0.3
758,50,76,178,254,3,0.3
759,50,27,47,74,3,0.3
760,50,61,131,192,3,0.3
761,50,32,46,78,3,0.3
762,50,45,92,137,3,0.3
763,50,41,190,231,3,0.3
764,50,47,91,138,3,0.3
765,50,68,201,269,3,0.3
766,50,53,175,228,3,0.3
767,50,26,28,54,3,0.3
768,50,126,312,438,3,0.3
769,50,58,68,126,3,0.3
770,50,49,130,179,3,0.3
771,50,16,49,65,3,0.3
772,50,13,21,34,3,0.3
773,50,0,0,0,3,0.3
774,50,32,73,105,3,0.3
775,50,39,78,117,3,0.3
776,50,33,34,67,3,0.3
777,50,50,118,168,3,0.3
778,50,44,85,129,3,0.3
779,50,81,174,255,3,0.3
780,50,20,37,57,3,0.3
781,50,45,93,138,3,0.3
782,50,82,94,176,3,0.3
783,50,22,36,58,3,0.3
784,50,28,59,87,3,0.3
785,50,1,21,22,3,0.3
786,50,5,9,14,3,0.3
787,50,11,23,34,3,0.3
788,50,3,5,8,3,0.3
789,50,86,195,281,3,0.3
790,50,27,15,42,3,0.3
791,50,24,21,45,3,0.3
792,50,77,190,267,3,0.3
793,50,33,81,114,3,0.3
794,50,69,154,223,3,0.3
795,50,17,31,48,3,0.3
796,50,94,142,236,3,0.3
797,50,44,90,134,3,0.3
798,50,26,55,81,3,0.3
799,50,92,106,198,3,0.3
800,50,6,51,57,3,0.3
801,50,13,28,41,3,0.3
802,50,28,70,98,3,0.3
803,50,16,71,87,3,0.3
804,50,15,52,67,3,0.3
805,50,36,128,164,3,0.3
806,50,33,37,70,3,0.3
807,50,14,58,72,3,0.3
808,50,58,171,229,3,0.3
809,50,9,19,28,3,0.3
810,50,13,48,61,3,0.3
811,50,34,52,86,3,0.3
812,50,14,27,41,3,0.3
813,50,15,25,40,3,0.3
814,50,4,3,7,3,0.3
815,50,0,4,4,3,0.3
816,50,5,31,36,3,0.3
817,50,10,31,41,3,0.3
818,50,27,82,109,3,0.3
819,50,12,19,31,3,0.3
820,50,15,28,43,3,0.3
821,50,11,23,34,3,0.3
822,50,19,35,54,3,0.3
823,50,28,28,56,3,0.3
824,50,1,9,10,3,0.3
825,50,7,15,22,3,0.3
826,50,9,17,26,3,0.3
827,50,10,21,31,3,0.3
828,50,2,4,6,3,0.3
829,50,5,6,11,3,0.3
830,50,1,3,4,3,0.3
831,50,0,2,2,3,0.3
832,50,21,31,52,3,0.3
833,50,60,125,185,3,0.3
834,50,15,22,37,3,0.3
835,50,26,89,115,3,0.3
836,50,40,76,116,3,0.3
837,50,14,20,34,3,0.3
838,50,29,95,124,3,0.3
839,50,17,44,61,3,0.3
840,50,19,36,55,3,0.3
841,50,10,13,23,3,0.3
842,50,6,13,19,3,0.3
843,50,7,35,42,3,0.3
844,50,0,3,3,3,0.3
845,50,7,16,23,3,0.3
846,50,3,7,10,3,0.3
847,50,4,5,9,3,0.3
848,75,34,78,112,3,0.3
849,75,27,117,144,3,0.3
850,75,34,93,127,3,0.3
851,75,17,27,44,3,0.3
852,75,64,126,190,3,0.3
853,75,20,63,83,3,0.3
854,75,24,137,161,3,0.3
855,75,34,52,86,3,0.3
856,75,13,44,57,3,0.3
857,75,21,42,63,3,0.3
858,75,13,41,54,3,0.3
859,75,14,53,67,3,0.3
860,75,13,46,59,3,0.3
861,75,21,58,79,3,0.3
862,75,19,20,39,3,0.3
863,75,9,16,25,3,0.3
864,75,22,65,87,3,0.3
865,75,15,45,60,3,0.3
866,75,16,83,99,3,0.3
867,75,11,39,50,3,0.3
868,75,9,18,27,3,0.3
869,75,5,12,17,3,0.3
870,75,8,6,14,3,0.3
871,75,17,28,45,3,0.3
872,75,1,1,2,3,0.3
873,75,8,19,27,3,0.3
874,75,0,0,0,3,0.3
875,75,6,9,15,3,0.3
876,75,16,27,43,3,0.3
877,75,9,34,43,3,0.3
878,75,37,63,100,3,0.3
879,75,24,47,71,3,0.3
880,75,16,88,104,3,0.3
881,75,9,29,38,3,0.3
882,75,10,30,40,3,0.3
883,75,17,26,43,3,0.3
884,75,12,41,53,3,0.3
885,75,14,59,73,3,0.3
886,75,13,19,32,3,0.3
887,75,22,72,94,3,0.3
888,75,4,13,17,3,0.3
889,75,3,7,10,3,0.3
890,75,26,24,50,3,0.3
891,75,3,5,8,3,0.3
892,75,0,0,0,3,0.3
893,75,16,64,80,3,0.3
894,75,9,31,40,3,0.3
895,75,22,84,106,3,0.3
896,75,24,79,103,3,0.3
897,75,15,74,89,3,0.3
898,75,78,198,276,3,0.3
899,75,6,9,15,3,0.3
900,75,26,35,61,3,0.3
901,75,19,62,81,3,0.3
902,75,39,103,142,3,0.3
903,75,3,23,26,3,0.3
904,75,29,41,70,3,0.3
905,75,19,60,79,3,0.3
906,75,16,51,67,3,0.3
907,75,2,16,18,3,0.3
908,75,47,173,220,3,0.3
909,75,6,17,23,3,0.3
910,75,14,47,61,3,0.3
911,75,50,138,188,3,0.3
912,75,1,3,4,3,0.3
913,75,15,62,77,3,0.3
914,75,7,43,50,3,0.3
915,75,5,22,27,3,0.3
916,75,28,50,78,3,0.3
917,75,39,83,122,3,0.3
918,75,3,13,16,3,0.3
919,75,15,38,53,3,0.3
920,75,53,101,154,3,0.3
921,75,0,11,11,3,0.3
922,75,17,37,54,3,0.3
923,75,26,35,61,3,0.3
924,75,22,47,69,3,0.3
925,75,31,93,124,3,0.3
926,75,25,71,96,3,0.3
927,75,26,52,78,3,0.3
928,75,53,138,191,3,0.3
929,75,25,31,56,3,0.3
930,75,12,33,45,3,0.3
931,75,13,15,28,3,0.3
932,75,7,29,36,3,0.3
933,75,28,51,79,3,0.3
934,75,5,14,19,3,0.3
935,75,1,6,7,3,0.3
936,75,2,11,13,3,0.3
937,75,23,76,99,3,0.3
938,75,6,18,24,3,0.3
939,75,35,58,93,3,0.3
940,75,38,43,81,3,0.3
941,75,27,120,147,3,0.3
942,75,35,130,165,3,0.3
943,75,21,72,93,3,0.3
944,75,5,11,16,3,0.3
945,75,10,41,51,3,0.3
946,75,7,36,43,3,0.3
947,75,7,5,12,3,0.3
948,75,23,39,62,3,0.3
949,75,13,34,47,3,0.3
950,75,1,9,10,3,0.3
951,75,0,2,2,3,0.3
952,75,5,3,8,3,0.3
953,75,36,99,135,3,0.3
954,75,8,11,19,3,0.3
955,75,46,160,206,3,0.3
956,75,41,99,140,3,0.3
957,75,56,158,214,3,0.3
958,75,8,29,37,3,0.3
959,75,7,20,27,3,0.3
960,75,18,42,60,3,0.3
961,75,43,87,130,3,0.3
962,75,5,20,25,3,0.3
963,75,3,8,11,3,0.3
964,75,5,22,27,3,0.3
965,75,5,15,20,3,0.3
966,75,22,64,86,3,0.3
967,75,16,44,60,3,0.3
968,75,7,43,50,3,0.3
969,75,10,26,36,3,0.3
970,75,22,75,97,3,0.3
971,75,10,46,56,3,0.3
972,75,49,96,145,3,0.3
973,75,5,23,28,3,0.3
974,75,19,64,83,3,0.3
975,75,7,20,27,3,0.3
976,75,43,80,123,3,0.3
977,75,12,30,42,3,0.3
978,75,10,18,28,3,0.3
979,75,3,11,14,3,0.3
980,75,0,4,4,3,0.3
981,75,0,0,0,3,0.3
982,75,3,31,34,3,0.3
983,75,9,22,31,3,0.3
984,75,13,15,28,3,0.3
985,75,6,43,49,3,0.3
986,75,42,100,142,3,0.3
987,75,32,86,118,3,0.3
988,75,19,76,95,3,0.3
989,75,22,83,105,3,0.3
990,75,3,25,28,3,0.3
991,75,42,82,124,3,0.3
992,75,0,2,2,3,0.3
993,75,2,9,11,3,0.3
994,75,3,2,5,3,0.3
995,75,5,23,28,3,0.3
996,75,4,2,6,3,0.3
997,75,5,0,5,3,0.3
998,75,66,74,140,3,0.3
999,75,2,4,6,3,0.3
1000,75,20,57,77,3,0.3
1001,75,30,120,150,3,0.3
1002,75,40,132,172,3,0.3
1003,75,26,96,122,3,0.3
1004,75,18,42,60,3,0.3
1005,75,3,11,14,3,0.3
1006,75,10,26,36,3,0.3
1007,75,7,15,22,3,0.3
1008,75,21,44,65,3,0.3
1009,75,6,4,10,3,0.3
1010,75,3,4,7,3,0.3
1011,75,14,28,42,3,0.3
1012,75,13,27,40,3,0.3
1013,75,23,43,66,3,0.3
1014,75,24,71,95,3,0.3
1015,75,28,81,109,3,0.3
1016,75,10,11,21,3,0.3
1017,75,28,63,91,3,0.3
1018,75,30,79,109,3,0.3
1019,75,12,42,54,3,0.3
1020,75,5,12,17,3,0.3
1021,75,27,26,53,3,0.3
1022,75,5,7,12,3,0.3
1023,75,6,20,26,3,0.3
1024,75,8,5,13,3,0.3
1025,75,5,6,11,3,0.3
1026,75,8,21,29,3,0.3
1027,75,1,1,2,3,0.3
1028,75,20,69,89,3,0.3
1029,75,3,5,8,3,0.3
1030,75,12,23,35,3,0.3
1031,75,16,32,48,3,0.3
1032,75,49,102,151,3,0.3
1033,75,31,59,90,3,0.3
1034,75,32,82,114,3,0.3
1035,75,12,16,28,3,0.3
1036,75,10,58,68,3,0.3
1037,75,18,27,45,3,0.3
1038,75,18,50,68,3,0.3
1039,75,36,60,96,3,0.3
1040,75,11,22,33,3,0.3
1041,75,2,5,7,3,0.3
1042,75,6,22,28,3,0.3
1043,75,15,28,43,3,0.3
1044,75,37,103,140,3,0.3
1045,75,19,33,52,3,0.3
1046,75,14,54,68,3,0.3
1047,75,53,177,230,3,0.3
1048,75,40,32,72,3,0.3
1049,75,24,57,81,3,0.3
1050,75,13,53,66,3,0.3
1051,75,12,42,54,3,0.3
1052,75,13,25,38,3,0.3
1053,75,6,13,19,3,0.3
1054,75,1,8,9,3,0.3
1055,75,3,5,8,3,0.3
1056,75,0,4,4,3,0.3
1057,75,28,47,75,3,0.3
1058,75,10,28,38,3,0.3
1059,75,87,240,327,3,0.3
1060,75,42,96,138,3,0.3
1061,75,37,105,142,3,0.3
1062,75,9,28,37,3,0.3
1063,75,20,68,88,3,0.3
1064,75,17,60,77,3,0.3
1065,75,47,70,117,3,0.3
1066,75,17,60,77,3,0.3
1067,75,23,77,100,3,0.3
1068,75,8,30,38,3,0.3
1069,75,12,20,32,3,0.3
1070,75,2,7,9,3,0.3
1071,75,24,115,139,3,0.3
1072,75,5,32,37,3,0.3
1073,75,17,76,93,3,0.3
1074,75,23,105,128,3,0.3
1075,75,49,109,158,3,0.3
1076,75,33,124,157,3,0.3
1077,75,28,71,99,3,0.3
1078,75,11,61,72,3,0.3
1079,75,24,24,48,3,0.3
1080,75,4,29,33,3,0.3
1081,75,19,27,46,3,0.3
1082,75,65,80,145,3,0.3
1083,75,23,76,99,3,0.3
1084,75,14,28,42,3,0.3
1085,75,8,15,23,3,0.3
1086,75,33,123,156,3,0.3
1087,75,15,29,44,3,0.3
1088,75,25,60,85,3,0.3
1089,75,24,31,55,3,0.3
1090,75,31,43,74,3,0.3
1091,75,18,74,92,3,0.3
1092,75,30,53,83,3,0.3
1093,75,20,50,70,3,0.3
1094,75,11,23,34,3,0.3
1095,75,17,45,62,3,0.3
1096,75,73,108,181,3,0.3
1097,75,19,49,68,3,0.3
1098,75,13,25,38,3,0.3
1099,75,10,21,31,3,0.3
1100,75,3,3,6,3,0.3
1101,75,14,36,50,3,0.3
1102,75,32,86,118,3,0.3
1103,75,44,108,152,3,0.3
1104,75,53,148,201,3,0.3
1105,75,18,47,65,3,0.3
1106,75,33,70,103,3,0.3
1107,75,16,90,106,3,0.3
1108,75,15,50,65,3,0.3
1109,75,16,40,56,3,0.3
1110,75,18,48,66,3,0.3
1111,75,9,17,26,3,0.3
1112,75,0,0,0,3,0.3
1113,75,5,15,20,3,0.3
1114,75,4,8,12,3,0.3
1115,75,7,13,20,3,0.3
1116,75,21,78,99,3,0.3
1117,75,15,33,48,3,0.3
1118,75,15,104,119,3,0.3
1119,75,47,202,249,3,0.3
1120,75,18,107,125,3,0.3
1121,75,49,33,82,3,0.3
1122,75,24,78,102,3,0.3
1123,75,71,144,215,3,0.3
1124,75,17,49,66,3,0.3
1125,75,37,128,165,3,0.3
1126,75,7,26,33,3,0.3
1127,75,20,54,74,3,0.3
1128,75,23,54,77,3,0.3
1129,75,12,19,31,3,0.3
1130,75,11,17,28,3,0.3
1131,75,6,9,15,3,0.3
1132,90,22,36,58,3,0.3
1133,90,73,135,208,3,0.3
1134,90,99,219,318,3,0.3
1135,90,18,65,83,3,0.3
1136,90,20,85,105,3,0.3
1137,90,14,33,47,3,0.3
1138,90,33,109,142,3,0.3
1139,90,6,16,22,3,0.3
1140,90,11,19,30,3,0.3
1141,90,15,19,34,3,0.3
1142,90,9,28,37,3,0.3
1143,90,5,11,16,3,0.3
1144,90,13,23,36,3,0.3
1145,90,9,26,35,3,0.3
1146,90,5,8,13,3,0.3
1147,90,52,131,183,3,0.3
1148,90,41,164,205,3,0.3
1149,90,18,59,77,3,0.3
1150,90,54,215,269,3,0.3
1151,90,10,44,54,3,0.3
1152,90,38,130,168,3,0.3
1153,90,13,63,76,3,0.3
1154,90,17,47,64,3,0.3
1155,90,7,21,28,3,0.3
1156,90,7,35,42,3,0.3
1157,90,28,38,66,3,0.3
1158,90,7,28,35,3,0.3
1159,90,32,115,147,3,0.3
1160,90,11,50,61,3,0.3
1161,90,15,24,39,3,0.3
1162,90,53,171,224,3,0.3
1163,90,37,103,140,3,0.3
1164,90,46,94,140,3,0.3
1165,90,31,90,121,3,0.3
1166,90,9,38,47,3,0.3
1167,90,15,51,66,3,0.3
1168,90,27,45,72,3,0.3
1169,90,6,24,30,3,0.3
1170,90,7,4,11,3,0.3
1171,90,46,103,149,3,0.3
1172,90,15,72,87,3,0.3
1173,90,35,71,106,3,0.3
1174,90,38,113,151,3,0.3
1175,90,25,62,87,3,0.3
1176,90,36,59,95,3,0.3
1177,90,21,38,59,3,0.3
1178,90,15,43,58,3,0.3
1179,90,6,17,23,3,0.3
1180,90,9,20,29,3,0.3
1181,90,20,14,34,3,0.3
1182,90,8,6,14,3,0.3
1183,90,2,13,15,3,0.3
1184,90,8,21,29,3,0.3
1185,90,5,11,16,3,0.3
1186,90,15,28,43,3,0.3
1187,90,54,117,171,3,0.3
1188,90,15,36,51,3,0.3
1189,90,40,97,137,3,0.3
1190,90,17,60,77,3,0.3
1191,90,20,60,80,3,0.3
1192,90,4,0,4,3,0.3
1193,90,10,57,67,3,0.3
1194,90,2,7,9,3,0.3
1195,90,11,18,29,3,0.3
1196,90,8,11,19,3,0.3
1197,90,17,30,47,3,0.3
1198,90,28,56,84,3,0.3
1199,90,42,152,194,3,0.3
1200,90,6,33,39,3,0.3
1201,90,36,104,140,3,0.3
1202,90,19,51,70,3,0.3
1203,90,59,79,138,3,0.3
1204,90,22,29,51,3,0.3
1205,90,15,42,57,3,0.3
1206,90,19,43,62,3,0.3
1207,90,20,37,57,3,0.3
1208,90,14,61,75,3,0.3
1209,90,15,22,37,3,0.3
1210,90,12,26,38,3,0.3
1211,90,17,64,81,3,0.3
1212,90,34,64,98,3,0.3
1213,90,18,27,45,3,0.3
1214,90,17,32,49,3,0.3
1215,90,35,91,126,3,0.3
1216,90,6,9,15,3,0.3
1217,90,46,83,129,3,0.3
1218,90,38,76,114,3,0.3
1219,90,23,62,85,3,0.3
1220,90,20,40,60,3,0.3
1221,90,21,41,62,3,0.3
1222,90,29,28,57,3,0.3
1223,90,10,24,34,3,0.3
1224,90,0,7,7,3,0.3
1225,90,3,3,6,3,0.3
1226,90,27,91,118,3,0.3
1227,90,36,99,135,3,0.3
1228,90,14,28,42,3,0.3
1229,90,29,72,101,3,0.3
1230,90,39,128,167,3,0.3
1231,90,36,97,133,3,0.3
1232,90,27,50,77,3,0.3
1233,90,6,12,18,3,0.3
1234,90,38,133,171,3,0.3
1235,90,31,86,117,3,0.3
1236,90,14,44,58,3,0.3
1237,90,9,19,28,3,0.3
1238,90,9,13,22,3,0.3
1239,90,12,28,40,3,0.3
1240,90,5,6,11,3,0.3
1241,90,78,142,220,3,0.3
1242,90,21,52,73,3,0.3
1243,90,20,46,66,3,0.3
1244,90,3,15,18,3,0.3
1245,90,20,46,66,3,0.3
1246,90,26,97,123,3,0.3
1247,90,32,145,177,3,0.3
1248,90,49,79,128,3,0.3
1249,90,13,59,72,3,0.3
1250,90,4,25,29,3,0.3
1251,90,30,83,113,3,0.3
1252,90,37,81,118,3,0.3
1253,90,13,31,44,3,0.3
1254,90,36,42,78,3,0.3
1255,90,6,7,13,3,0.3
1256,90,12,4,16,3,0.3
1257,90,22,64,86,3,0.3
1258,90,83,153,236,3,0.3
1259,90,33,114,147,3,0.3
1260,90,40,187,227,3,0.3
1261,90,21,63,84,3,0.3
1262,90,7,6,13,3,0.3
1263,90,12,32,44,3,0.3
1264,90,21,29,50,3,0.3
1265,90,19,36,55,3,0.3
1266,90,17,17,34,3,0.3
1267,90,9,19,28,3,0.3
1268,90,12,36,48,3,0.3
1269,90,28,54,82,3,0.3
1270,90,68,181,249,3,0.3
1271,90,9,21,30,3,0.3
1272,90,30,96,126,3,0.3
1273,90,15,26,41,3,0.3
1274,90,55,106,161,3,0.3
1275,90,19,60,79,3,0.3
1276,90,44,71,115,3,0.3
1277,90,19,53,72,3,0.3
1278,90,9,12,21,3,0.3
1279,90,15,48,63,3,0.3
1280,90,9,36,45,3,0.3
1281,90,14,45,59,3,0.3
1282,90,15,41,56,3,0.3
1283,90,7,16,23,3,0.3
1284,90,3,3,6,3,0.3
1285,90,21,38,59,3,0.3
1286,90,52,85,137,3,0.3
1287,90,83,125,208,3,0.3
1288,90,40,102,142,3,0.3
1289,90,55,170,225,3,0.3
1290,90,10,52,62,3,0.3
1291,90,40,70,110,3,0.3
1292,90,15,16,31,3,0.3
1293,90,10,8,18,3,0.3
1294,90,6,29,35,3,0.3
1295,90,22,59,81,3,0.3
1296,90,0,4,4,3,0.3
1297,90,22,95,117,3,0.3
1298,90,19,36,55,3,0.3
1299,90,61,155,216,3,0.3
1300,90,13,40,53,3,0.3
1301,90,24,90,114,3,0.3
1302,90,27,113,140,3,0.3
1303,90,6,4,10,3,0.3
1304,90,20,36,56,3,0.3
1305,90,21,46,67,3,0.3
1306,90,25,44,69,3,0.3
1307,90,3,8,11,3,0.3
1308,90,4,22,26,3,0.3
1309,90,23,55,78,3,0.3
1310,90,2,10,12,3,0.3
1311,90,0,50,50,3,0.3
1312,90,30,88,118,3,0.3
1313,90,24,107,131,3,0.3
1314,90,19,77,96,3,0.3
1315,90,7,20,27,3,0.3
1316,90,14,28,42,3,0.3
1317,90,9,13,22,3,0.3
1318,90,30,66,96,3,0.3
1319,90,18,61,79,3,0.3
1320,90,13,10,23,3,0.3
1321,90,6,22,28,3,0.3
1322,90,7,13,20,3,0.3
1323,90,25,30,55,3,0.3
1324,90,8,11,19,3,0.3
1325,90,2,2,4,3,0.3
1326,90,20,45,65,3,0.3
1327,90,19,56,75,3,0.3
1328,90,15,18,33,3,0.3
1329,90,16,65,81,3,0.3
1330,90,18,39,57,3,0.3
1331,90,22,81,103,3,0.3
1332,90,8,31,39,3,0.3
1333,90,26,98,124,3,0.3
1334,90,36,49,85,3,0.3
1335,90,4,31,35,3,0.3
1336,90,10,5,15,3,0.3
1337,90,34,75,109,3,0.3
1338,90,9,24,33,3,0.3
1339,90,9,17,26,3,0.3
1340,90,6,17,23,3,0.3
1341,90,11,14,25,3,0.3
1342,90,5,1,6,3,0.3
1343,90,7,47,54,3,0.3
1344,90,18,38,56,3,0.3
1345,90,66,150,216,3,0.3
1346,90,24,25,49,3,0.3
1347,90,14,24,38,3,0.3
1348,90,18,56,74,3,0.3
1349,90,21,33,54,3,0.3
1350,90,30,87,117,3,0.3
1351,90,34,44,78,3,0.3
1352,90,6,12,18,3,0.3
1353,90,6,13,19,3,0.3
1354,90,4,10,14,3,0.3
1355,90,8,12,20,3,0.3
1356,90,9,22,31,3,0.3
1357,90,24,37,61,3,0.3
1358,90,28,57,85,3,0.3
1359,90,26,106,132,3,0.3
1360,90,21,72,93,3,0.3
1361,90,21,37,58,3,0.3
1362,90,19,66,85,3,0.3
1363,90,14,46,60,3,0.3
1364,90,17,57,74,3,0.3
1365,90,9,26,35,3,0.3
1366,90,8,21,29,3,0.3
1367,90,4,16,20,3,0.3
1368,90,34,115,149,3,0.3
1369,90,5,13,18,3,0.3
1370,90,16,57,73,3,0.3
1371,90,12,54,66,3,0.3
1372,90,21,29,50,3,0.3
1373,90,25,47,72,3,0.3
1374,90,8,27,35,3,0.3
1375,90,1,31,32,3,0.3
1376,90,10,14,24,3,0.3
1377,90,20,107,127,3,0.3
1378,90,9,24,33,3,0.3
1379,90,3,5,8,3,0.3
1380,90,1,4,5,3,0.3
1381,90,20,74,94,3,0.3
1382,90,19,60,79,3,0.3
1383,90,19,127,146,3,0.3
1384,90,9,20,29,3,0.3
1385,90,92,138,230,3,0.3
1386,90,73,128,201,3,0.3
1387,90,15,55,70,3,0.3
1388,90,13,57,70,3,0.3
1389,90,24,42,66,3,0.3
1390,90,8,21,29,3,0.3
1391,90,6,6,12,3,0.3
1392,90,88,232,320,3,0.3
1393,90,41,70,111,3,0.3
1394,90,53,182,235,3,0.3
1395,90,79,198,277,3,0.3
1396,90,31,75,106,3,0.3
1397,90,53,152,205,3,0.3
1398,90,49,145,194,3,0.3
1399,90,36,112,148,3,0.3
1400,90,30,54,84,3,0.3
1401,90,21,39,60,3,0.3
1402,90,21,18,39,3,0.3
1403,90,4,13,17,3,0.3
1404,120,24,109,133,3,0.3
1405,120,34,142,176,3,0.3
1406,120,54,250,304,3,0.3
1407,120,24,115,139,3,0.3
1408,120,75,190,265,3,0.3
1409,120,36,139,175,3,0.3
1410,120,65,134,199,3,0.3
1411,120,15,64,79,3,0.3
1412,120,44,39,83,3,0.3
1413,120,10,23,33,3,0.3
1414,120,11,28,39,3,0.3
1415,120,5,10,15,3,0.3
1416,120,21,57,78,3,0.3
1417,120,58,187,245,3,0.3
1418,120,18,77,95,3,0.3
1419,120,43,187,230,3,0.3
1420,120,78,292,370,3,0.3
1421,120,8,13,21,3,0.3
1422,120,58,228,286,3,0.3
1423,120,67,184,251,3,0.3
1424,120,28,78,106,3,0.3
1425,120,5,31,36,3,0.3
1426,120,34,81,115,3,0.3
1427,120,10,36,46,3,0.3
1428,120,7,10,17,3,0.3
1429,120,3,18,21,3,0.3
1430,120,39,156,195,3,0.3
1431,120,113,397,510,3,0.3
1432,120,27,87,114,3,0.3
1433,120,24,129,153,3,0.3
1434,120,43,132,175,3,0.3
1435,120,17,100,117,3,0.3
1436,120,29,121,150,3,0.3
1437,120,54,93,147,3,0.3
1438,120,45,118,163,3,0.3
1439,120,19,33,52,3,0.3
1440,120,6,10,16,3,0.3
1441,120,1,5,6,3,0.3
1442,120,51,66,117,3,0.3
1443,120,29,116,145,3,0.3
1444,120,69,199,268,3,0.3
1445,120,26,79,105,3,0.3
1446,120,25,106,131,3,0.3
1447,120,52,130,182,3,0.3
1448,120,27,87,114,3,0.3
1449,120,62,215,277,3,0.3
1450,120,56,149,205,3,0.3
1451,120,26,82,108,3,0.3
1452,120,19,64,83,3,0.3
1453,120,2,6,8,3,0.3
1454,120,18,39,57,3,0.3
1455,120,2,13,15,3,0.3
1456,120,7,8,15,3,0.3
1457,120,3,1,4,3,0.3
1458,120,46,140,186,3,0.3
1459,120,6,42,48,3,0.3
1460,120,55,150,205,3,0.3
1461,120,57,105,162,3,0.3
1462,120,9,40,49,3,0.3
1463,120,28,171,199,3,0.3
1464,120,45,163,208,3,0.3
1465,120,33,56,89,3,0.3
1466,120,29,64,93,3,0.3
1467,120,9,57,66,3,0.3
1468,120,82,112,194,3,0.3
1469,120,10,45,55,3,0.3
1470,120,10,33,43,3,0.3
1471,120,25,61,86,3,0.3
1472,120,32,23,55,3,0.3
1473,120,21,56,77,3,0.3
1474,120,30,67,97,3,0.3
1475,120,42,77,119,3,0.3
1476,120,44,77,121,3,0.3
1477,120,19,82,101,3,0.3
1478,120,65,161,226,3,0.3
1479,120,23,28,51,3,0.3
1480,120,34,57,91,3,0.3
1481,120,24,47,71,3,0.3
1482,120,4,25,29,3,0.3
1483,120,12,30,42,3,0.3
1484,120,29,52,81,3,0.3
1485,120,11,19,30,3,0.3
1486,120,1,5,6,3,0.3
1487,120,3,4,7,3,0.3
1488,120,7,13,20,3,0.3
1489,120,4,38,42,3,0.3
1490,120,14,37,51,3,0.3
1491,120,20,48,68,3,0.3
1492,120,7,25,32,3,0.3
1493,120,15,61,76,3,0.3
1494,120,12,59,71,3,0.3
1495,120,50,126,176,3,0.3
1496,120,30,89,119,3,0.3
1497,120,27,55,82,3,0.3
1498,120,21,72,93,3,0.3
1499,120,8,41,49,3,0.3
1500,120,2,8,10,3,0.3
1501,120,13,24,37,3,0.3
1502,120,22,27,49,3,0.3
1503,120,13,19,32,3,0.3
1504,120,1,4,5,3,0.3
1505,120,27,57,84,3,0.3
1506,120,20,55,75,3,0.3
1507,120,35,116,151,3,0.3
1508,120,46,47,93,3,0.3
1509,120,51,96,147,3,0.3
1510,120,22,78,100,3,0.3
1511,120,8,26,34,3,0.3
1512,120,71,135,206,3,0.3
1513,120,17,38,55,3,0.3
1514,120,1,7,8,3,0.3
1515,120,62,102,164,3,0.3
1516,120,6,16,22,3,0.3
1517,120,3,6,9,3,0.3
1518,120,13,18,31,3,0.3
1519,120,28,54,82,3,0.3
1520,120,16,55,71,3,0.3
1521,120,23,75,98,3,0.3
1522,120,41,111,152,3,0.3
1523,120,90,110,200,3,0.3
1524,120,20,89,109,3,0.3
1525,120,39,83,122,3,0.3
1526,120,11,28,39,3,0.3
1527,120,28,67,95,3,0.3
1528,120,19,72,91,3,0.3
1529,120,14,29,43,3,0.3
1530,120,30,70,100,3,0.3
1531,120,11,15,26,3,0.3
1532,120,31,84,115,3,0.3
1533,120,27,107,134,3,0.3
1534,120,35,155,190,3,0.3
1535,120,35,125,160,3,0.3
1536,120,29,112,141,3,0.3
1537,120,85,199,284,3,0.3
1538,120,28,75,103,3,0.3
1539,120,8,20,28,3,0.3
1540,120,45,126,171,3,0.3
1541,120,5,25,30,3,0.3
1542,120,19,46,65,3,0.3
1543,120,4,12,16,3,0.3
1544,120,27,32,59,3,0.3
1545,120,30,61,91,3,0.3
1546,120,7,24,31,3,0.3
1547,120,39,83,122,3,0.3
1548,120,9,39,48,3,0.3
1549,120,37,51,88,3,0.3
1550,120,35,119,154,3,0.3
1551,120,39,141,180,3,0.3
1552,120,43,149,192,3,0.3
1553,120,4,16,20,3,0.3
1554,120,24,41,65,3,0.3
1555,120,9,57,66,3,0.3
1556,120,18,24,42,3,0.3
1557,120,11,10,21,3,0.3
1558,120,6,16,22,3,0.3
1559,120,27,56,83,3,0.3
1560,120,33,89,122,3,0.3
1561,120,26,177,203,3,0.3
1562,120,9,25,34,3,0.3
1563,120,46,199,245,3,0.3
1564,120,98,200,298,3,0.3
1565,120,40,146,186,3,0.3
1566,120,24,89,113,3,0.3
1567,120,75,139,214,3,0.3
1568,120,34,64,98,3,0.3
1569,120,103,97,200,3,0.3
1570,120,15,40,55,3,0.3
1571,120,9,45,54,3,0.3
1572,120,17,16,33,3,0.3
1573,120,7,43,50,3,0.3
1574,120,9,25,34,3,0.3
1575,120,29,81,110,3,0.3
1576,120,24,32,56,3,0.3
1577,120,64,127,191,3,0.3
1578,120,17,54,71,3,0.3
1579,120,63,196,259,3,0.3
1580,120,73,137,210,3,0.3
1581,120,15,28,43,3,0.3
1582,120,22,83,105,3,0.3
1583,120,44,41,85,3,0.3
1584,120,20,59,79,3,0.3
1585,120,17,38,55,3,0.3
1586,120,5,7,12,3,0.3
1587,120,4,6,10,3,0.3
1588,120,13,34,47,3,0.3
1589,120,17,37,54,3,0.3
1590,120,1,2,3,3,0.3
1591,120,40,122,162,3,0.3
1592,120,25,101,126,3,0.3
1593,120,21,88,109,3,0.3
1594,120,45,129,174,3,0.3
1595,120,47,149,196,3,0.3
1596,120,17,27,44,3,0.3
1597,120,17,52,69,3,0.3
1598,120,26,77,103,3,0.3
1599,120,17,71,88,3,0.3
1600,120,20,52,72,3,0.3
1601,120,23,30,53,3,0.3
1602,120,21,45,66,3,0.3
1603,120,14,31,45,3,0.3
1604,120,8,45,53,3,0.3
1605,120,17,39,56,3,0.3
1606,120,58,132,190,3,0.3
1607,120,12,85,97,3,0.3
1608,120,33,48,81,3,0.3
1609,120,61,118,179,3,0.3
1610,120,51,141,192,3,0.3
1611,120,22,44,66,3,0.3
1612,120,24,74,98,3,0.3
1613,120,15,37,52,3,0.3
1614,120,11,10,21,3,0.3
1615,120,24,66,90,3,0.3
1616,120,6,14,20,3,0.3
1617,120,8,19,27,3,0.3
1618,120,6,10,16,3,0.3
1619,120,33,60,93,3,0.3
1620,120,28,97,125,3,0.3
1621,120,137,237,374,3,0.3
1622,120,41,55,96,3,0.3
1623,120,44,55,99,3,0.3
1624,120,32,73,105,3,0.3
1625,120,4,6,10,3,0.3
1626,120,7,35,42,3,0.3
1627,120,16,33,49,3,0.3
1628,120,14,13,27,3,0.3
1629,120,17,21,38,3,0.3
1630,120,0,0,0,3,0.3
1631,120,110,59,169,3,0.3
1632,120,59,148,207,3,0.3
1633,120,37,149,186,3,0.3
1634,120,60,230,290,3,0.3
1635,120,20,20,40,3,0.3
1636,120,16,55,71,3,0.3
1637,120,54,184,238,3,0.3
1638,120,38,89,127,3,0.3
1639,120,39,123,162,3,0.3
1640,120,25,35,60,3,0.3
1641,120,25,47,72,3,0.3
1642,120,7,8,15,3,0.3
1643,120,10,5,15,3,0.3
1644,120,4,2,6,3,0.3
1645,120,4,1,5,3,0.3
1646,120,6,31,37,3,0.3
1647,120,25,59,84,3,0.3
1648,120,8,24,32,3,0.3
1649,120,44,134,178,3,0.3
1650,120,41,96,137,3,0.3
1651,120,44,124,168,3,0.3
1652,120,17,25,42,3,0.3
1653,120,16,38,54,3,0.3
1654,120,21,46,67,3,0.3
1655,120,31,55,86,3,0.3
1656,120,11,37,48,3,0.3
1657,120,13,38,51,3,0.3
1658,120,14,49,63,3,0.3
1659,120,28,44,72,3,0.3
1660,120,10,18,28,3,0.3
1661,120,8,12,20,3,0.3
1662,120,42,47,89,3,0.3
1663,120,20,52,72,3,0.3
1664,120,31,83,114,3,0.3
1665,120,38,54,92,3,0.3
1666,120,32,40,72,3,0.3
1667,120,40,58,98,3,0.3
1668,120,33,48,81,3,0.3
1669,120,37,68,105,3,0.3
1670,120,9,18,27,3,0.3
1671,120,23,50,73,3,0.3
1672,120,10,27,37,3,0.3
1673,120,10,24,34,3,0.3
1674,120,6,7,13,3,0.3
1675,120,32,89,121,3,0.3
1676,120,17,54,71,3,0.3
1677,120,43,121,164,3,0.3
1678,120,19,99,118,3,0.3
1679,120,9,10,19,3,0.3
1680,120,19,94,113,3,0.3
1681,120,65,143,208,3,0.3
1682,120,35,66,101,3,0.3
1683,120,24,66,90,3,0.3
1684,120,25,34,59,3,0.3
1685,120,14,7,21,3,0.3
1686,120,0,4,4,3,0.3
1687,120,8,21,29,3,0.3
1688,180,32,109,141,3,0.3
1689,180,28,49,77,3,0.3
1690,180,16,84,100,3,0.3
1691,180,6,27,33,3,0.3
1692,180,20,97,117,3,0.3
1693,180,19,63,82,3,0.3
1694,180,20,28,48,3,0.3
1695,180,50,108,158,3,0.3
1696,180,29,118,147,3,0.3
1697,180,55,132,187,3,0.3
1698,180,11,22,33,3,0.3
1699,180,10,20,30,3,0.3
1700,180,19,53,72,3,0.3
1701,180,16,54,70,3,0.3
1702,180,18,55,73,3,0.3
1703,180,6,34,40,3,0.3
1704,180,22,55,77,3,0.3
1705,180,15,56,71,3,0.3
1706,180,34,159,193,3,0.3
1707,180,23,110,133,3,0.3
1708,180,25,44,69,3,0.3
1709,180,18,60,78,3,0.3
1710,180,42,83,125,3,0.3
1711,180,7,5,12,3,0.3
1712,180,1,7,8,3,0.3
1713,180,4,14,18,3,0.3
1714,180,6,38,44,3,0.3
1715,180,42,70,112,3,0.3
1716,180,5,23,28,3,0.3
1717,180,52,93,145,3,0.3
1718,180,15,59,74,3,0.3
1719,180,28,63,91,3,0.3
1720,180,13,31,44,3,0.3
1721,180,4,28,32,3,0.3
1722,180,16,30,46,3,0.3
1723,180,28,31,59,3,0.3
1724,180,5,9,14,3,0.3
1725,180,11,13,24,3,0.3
1726,180,4,7,11,3,0.3
1727,180,11,28,39,3,0.3
1728,180,2,4,6,3,0.3
1729,180,21,55,76,3,0.3
1730,180,46,74,120,3,0.3
1731,180,25,41,66,3,0.3
1732,180,27,55,82,3,0.3
1733,180,22,54,76,3,0.3
1734,180,9,9,18,3,0.3
1735,180,19,26,45,3,0.3
1736,180,19,27,46,3,0.3
1737,180,20,39,59,3,0.3
1738,180,4,12,16,3,0.3
1739,180,24,14,38,3,0.3
1740,180,1,6,7,3,0.3
1741,180,2,19,21,3,0.3
1742,180,12,40,52,3,0.3
1743,180,6,24,30,3,0.3
1744,180,47,65,112,3,0.3
1745,180,11,34,45,3,0.3
1746,180,18,52,70,3,0.3
1747,180,45,109,154,3,0.3
1748,180,8,16,24,3,0.3
1749,180,45,42,87,3,0.3
1750,180,3,9,12,3,0.3
1751,180,7,11,18,3,0.3
1752,180,9,12,21,3,0.3
1753,180,5,1,6,3,0.3
1754,180,18,66,84,3,0.3
1755,180,1,4,5,3,0.3
1756,180,2,12,14,3,0.3
1757,180,1,7,8,3,0.3
1758,180,9,55,64,3,0.3
1759,180,12,44,56,3,0.3
1760,180,69,97,166,3,0.3
1761,180,36,136,172,3,0.3
1762,180,26,62,88,3,0.3
1763,180,29,89,118,3,0.3
1764,180,17,41,58,3,0.3
1765,180,14,45,59,3,0.3
1766,180,10,11,21,3,0.3
1767,180,9,44,53,3,0.3
1768,180,9,30,39,3,0.3
1769,180,3,6,9,3,0.3
1770,180,7,39,46,3,0.3
1771,180,2,10,12,3,0.3
1772,180,81,111,192,3,0.3
1773,180,35,53,88,3,0.3
1774,180,5,2,7,3,0.3
1775,180,72,158,230,3,0.3
1776,180,101,236,337,3,0.3
1777,180,16,36,52,3,0.3
1778,180,37,102,139,3,0.3
1779,180,6,20,26,3,0.3
1780,180,40,82,122,3,0.3
1781,180,18,59,77,3,0.3
1782,180,15,40,55,3,0.3
1783,180,4,27,31,3,0.3
1784,180,16,38,54,3,0.3
1785,180,7,23,30,3,0.3
1786,180,1,4,5,3,0.3
1787,180,86,112,198,3,0.3
1788,180,0,2,2,3,0.3
1789,180,22,37,59,3,0.3
1790,180,61,96,157,3,0.3
1791,180,26,90,116,3,0.3
1792,180,45,108,153,3,0.3
1793,180,34,92,126,3,0.3
1794,180,15,23,38,3,0.3
1795,180,61,230,291,3,0.3
1796,180,11,10,21,3,0.3
1797,180,9,54,63,3,0.3
1798,180,19,27,46,3,0.3
1799,180,6,19,25,3,0.3
1800,180,13,24,37,3,0.3
1801,180,3,5,8,3,0.3
1802,180,16,46,62,3,0.3
1803,180,38,79,117,3,0.3
1804,180,45,79,124,3,0.3
1805,180,9,10,19,3,0.3
1806,180,40,82,122,3,0.3
1807,180,45,95,140,3,0.3
1808,180,20,32,52,3,0.3
1809,180,9,40,49,3,0.3
1810,180,34,75,109,3,0.3
1811,180,5,11,16,3,0.3
1812,180,11,34,45,3,0.3
1813,180,15,20,35,3,0.3
1814,180,2,8,10,3,0.3
1815,180,3,2,5,3,0.3
1816,180,2,0,2,3,0.3
1817,180,5,9,14,3,0.3
1818,180,0,0,0,3,0.3
1819,180,20,34,54,3,0.3
1820,180,1,20,21,3,0.3
1821,180,19,62,81,3,0.3
1822,180,27,96,123,3,0.3
1823,180,22,91,113,3,0.3
1824,180,22,48,70,3,0.3
1825,180,23,98,121,3,0.3
1826,180,12,46,58,3,0.3
1827,180,28,42,70,3,0.3
1828,180,13,41,54,3,0.3
1829,180,12,6,18,3,0.3
1830,180,6,18,24,3,0.3
1831,180,3,10,13,3,0.3
1832,180,4,5,9,3,0.3
1833,180,20,43,63,3,0.3
1834,180,27,74,101,3,0.3
1835,180,46,99,145,3,0.3
1836,180,41,91,132,3,0.3
1837,180,31,39,70,3,0.3
1838,180,26,65,91,3,0.3
1839,180,27,58,85,3,0.3
1840,180,22,79,101,3,0.3
1841,180,19,56,75,3,0.3
1842,180,19,18,37,3,0.3
1843,180,10,9,19,3,0.3
1844,180,3,2,5,3,0.3
1845,180,4,7,11,3,0.3
1846,180,0,0,0,3,0.3
1847,180,6,32,38,3,0.3
1848,180,16,35,51,3,0.3
1849,180,34,55,89,3,0.3
1850,180,19,35,54,3,0.3
1851,180,22,116,138,3,0.3
1852,180,14,28,42,3,0.3
1853,180,25,38,63,3,0.3
1854,180,22,76,98,3,0.3
1855,180,10,35,45,3,0.3
1856,180,29,48,77,3,0.3
1857,180,30,64,94,3,0.3
1858,180,6,15,21,3,0.3
1859,180,10,17,27,3,0.3
1860,180,19,19,38,3,0.3
1861,180,21,17,38,3,0.3
1862,180,15,5,20,3,0.3
1863,180,0,5,5,3,0.3
1864,180,31,38,69,3,0.3
1865,180,11,33,44,3,0.3
1866,180,9,58,67,3,0.3
1867,180,24,34,58,3,0.3
1868,180,29,128,157,3,0.3
1869,180,30,87,117,3,0.3
1870,180,12,21,33,3,0.3
1871,180,48,85,133,3,0.3
1872,180,4,7,11,3,0.3
1873,180,12,28,40,3,0.3
1874,180,12,14,26,3,0.3
1875,180,12,39,51,3,0.3
1876,180,4,8,12,3,0.3
1877,180,7,14,21,3,0.3
1878,180,2,5,7,3,0.3
1879,180,0,25,25,3,0.3
1880,180,46,83,129,3,0.3
1881,180,21,83,104,3,0.3
1882,180,13,28,41,3,0.3
1883,180,129,223,352,3,0.3
1884,180,29,64,93,3,0.3
1885,180,10,22,32,3,0.3
1886,180,10,25,35,3,0.3
1887,180,31,33,64,3,0.3
1888,180,28,107,135,3,0.3
1889,180,8,26,34,3,0.3
1890,180,22,42,64,3,0.3
1891,180,16,39,55,3,0.3
1892,180,2,18,20,3,0.3
1893,180,6,6,12,3,0.3
1894,180,1,1,2,3,0.3
1895,180,0,2,2,3,0.3
1896,180,10,54,64,3,0.3
1897,180,9,58,67,3,0.3
1898,180,2,14,16,3,0.3
1899,180,23,38,61,3,0.3
1900,180,14,73,87,3,0.3
1901,180,25,120,145,3,0.3
1902,180,68,162,230,3,0.3
1903,180,12,30,42,3,0.3
1904,180,7,19,26,3,0.3
1905,180,36,77,113,3,0.3
1906,180,1,7,8,3,0.3
1907,180,7,7,14,3,0.3
1908,180,14,23,37,3,0.3
1909,180,1,8,9,3,0.3
1910,180,20,174,194,3,0.3
1911,180,4,15,19,3,0.3
1912,180,11,59,70,3,0.3
1913,180,19,86,105,3,0.3
1914,180,20,87,107,3,0.3
1915,180,51,135,186,3,0.3
1916,180,9,78,87,3,0.3
1917,180,7,13,20,3,0.3
1918,180,20,66,86,3,0.3
1919,180,11,48,59,3,0.3
1920,180,13,39,52,3,0.3
1921,180,7,17,24,3,0.3
1922,180,14,50,64,3,0.3
1923,180,4,4,8,3,0.3
1924,180,0,0,0,3,0.3
1925,180,6,22,28,3,0.3
1926,180,29,46,75,3,0.3
1927,180,24,42,66,3,0.3
1928,180,2,12,14,3,0.3
1929,180,18,79,97,3,0.3
1930,180,22,54,76,3,0.3
1931,180,20,49,69,3,0.3
1932,180,18,53,71,3,0.3
1933,180,15,83,98,3,0.3
1934,180,35,95,130,3,0.3
1935,180,7,18,25,3,0.3
1936,180,4,12,16,3,0.3
1937,180,3,8,11,3,0.3
1938,180,18,43,61,3,0.3
1939,180,11,14,25,3,0.3
1940,180,10,10,20,3,0.3
1941,180,1,4,5,3,0.3
1942,180,2,6,8,3,0.3
1943,180,7,20,27,3,0.3
1944,180,8,12,20,3,0.3
1945,180,26,67,93,3,0.3
1946,180,17,48,65,3,0.3
1947,180,16,90,106,3,0.3
1948,180,12,24,36,3,0.3
1949,180,30,37,67,3,0.3
1950,180,19,53,72,3,0.3
1951,180,27,62,89,3,0.3
1952,180,28,43,71,3,0.3
1953,180,14,88,102,3,0.3
1954,180,0,4,4,3,0.3
1955,180,5,7,12,3,0.3
1956,180,58,84,142,3,0.3
1957,180,17,26,43,3,0.3
1958,180,5,4,9,3,0.3
1959,180,0,8,8,3,0.3
1960,180,33,79,112,3,0.3
1961,180,9,12,21,3,0.3
1962,180,7,27,34,3,0.3
1963,180,16,36,52,3,0.3
1964,180,38,94,132,3,0.3
1965,180,21,91,112,3,0.3
1966,180,34,75,109,3,0.3
1967,180,33,62,95,3,0.3
1968,180,55,74,129,3,0.3
1969,180,33,101,134,3,0.3
1970,180,10,18,28,3,0.3
1971,180,3,20,23,3,0.3
1972,180,6,8,14,3,0.3
1973,180,2,7,9,3,0.3
1974,180,2,6,8,3,0.3
1975,180,0,0,0,3,0.3
1976,30,20,56,76,3,1.0
1977,30,11,53,64,3,1.0
1978,30,14,48,62,3,1.0
1979,30,37,82,119,3,1.0
1980,30,49,80,129,3,1.0
1981,30,29,67,96,3,1.0
1982,30,9,51,60,3,1.0
1983,30,29,82,111,3,1.0
1984,30,5,7,12,3,1.0
1985,30,7,13,20,3,1.0
1986,30,7,17,24,3,1.0
1987,30,32,66,98,3,1.0
1988,30,11,38,49,3,1.0
1989,30,35,91,126,3,1.0
1990,30,10,57,67,3,1.0
1991,30,20,27,47,3,1.0
1992,30,67,183,250,3,1.0
1993,30,10,22,32,3,1.0
1994,30,23,51,74,3,1.0
1995,30,30,21,51,3,1.0
1996,30,16,22,38,3,1.0
1997,30,12,23,35,3,1.0
1998,30,1,3,4,3,1.0
1999,30,4,14,18,3,1.0
2000,30,9,20,29,3,1.0
2001,30,11,18,29,3,1.0
2002,30,22,36,58,3,1.0
2003,30,39,137,176,3,1.0
2004,30,20,22,42,3,1.0
2005,30,13,45,58,3,1.0
2006,30,18,29,47,3,1.0
2007,30,14,25,39,3,1.0
2008,30,26,28,54,3,1.0
2009,30,26,43,69,3,1.0
2010,30,10,9,19,3,1.0
2011,30,8,18,26,3,1.0
2012,30,6,17,23,3,1.0
2013,30,10,23,33,3,1.0
2014,30,8,23,31,3,1.0
2015,30,6,3,9,3,1.0
2016,30,8,21,29,3,1.0
2017,30,1,5,6,3,1.0
2018,30,4,6,10,3,1.0
2019,30,2,1,3,3,1.0
2020,30,27,81,108,3,1.0
2021,30,25,73,98,3,1.0
2022,30,25,56,81,3,1.0
2023,30,36,113,149,3,1.0
2024,30,63,184,247,3,1.0
2025,30,35,46,81,3,1.0
2026,30,20,80,100,3,1.0
2027,30,43,28,71,3,1.0
2028,30,12,27,39,3,1.0
2029,30,18,20,38,3,1.0
2030,30,14,39,53,3,1.0
2031,30,10,46,56,3,1.0
2032,30,6,16,22,3,1.0
2033,30,25,30,55,3,1.0
2034,30,8,18,26,3,1.0
2035,30,18,26,44,3,1.0
2036,30,8,16,24,3,1.0
2037,30,12,15,27,3,1.0
2038,30,15,11,26,3,1.0
2039,30,6,17,23,3,1.0
2040,30,40,104,144,3,1.0
2041,30,4,24,28,3,1.0
2042,30,59,166,225,3,1.0
2043,30,22,38,60,3,1.0
2044,30,26,89,115,3,1.0
2045,30,51,131,182,3,1.0
2046,30,34,37,71,3,1.0
2047,30,16,34,50,3,1.0
2048,30,8,11,19,3,1.0
2049,30,5,9,14,3,1.0
2050,30,10,34,44,3,1.0
2051,30,1,8,9,3,1.0
2052,30,2,8,10,3,1.0
2053,30,4,6,10,3,1.0
2054,30,3,6,9,3,1.0
2055,30,3,3,6,3,1.0
2056,30,48,83,131,3,1.0
2057,30,24,54,78,3,1.0
2058,30,97,131,228,3,1.0
2059,30,23,38,61,3,1.0
2060,30,45,153,198,3,1.0
2061,30,48,103,151,3,1.0
2062,30,20,63,83,3,1.0
2063,30,36,108,144,3,1.0
2064,30,12,36,48,3,1.0
2065,30,19,30,49,3,1.0
2066,30,19,48,67,3,1.0
2067,30,1,8,9,3,1.0
2068,30,7,5,12,3,1.0
2069,30,5,3,8,3,1.0
2070,30,87,134,221,3,1.0
2071,30,114,259,373,3,1.0
2072,30,116,202,318,3,1.0
2073,30,106,114,220,3,1.0
2074,30,50,61,111,3,1.0
2075,30,48,43,91,3,1.0
2076,30,78,141,219,3,1.0
2077,30,23,81,104,3,1.0
2078,30,49,80,129,3,1.0
2079,30,28,36,64,3,1.0
2080,30,52,111,163,3,1.0
2081,30,33,61,94,3,1.0
2082,30,38,43,81,3,1.0
2083,30,101,118,219,3,1.0
2084,30,39,53,92,3,1.0
2085,30,26,82,108,3,1.0
2086,30,53,65,118,3,1.0
2087,30,48,170,218,3,1.0
2088,30,64,65,129,3,1.0
2089,30,61,134,195,3,1.0
2090,30,125,208,333,3,1.0
2091,30,60,46,106,3,1.0
2092,30,66,121,187,3,1.0
2093,30,27,39,66,3,1.0
2094,30,31,33,64,3,1.0
2095,30,30,48,78,3,1.0
2096,30,6,13,19,3,1.0
2097,30,22,9,31,3,1.0
2098,30,14,26,40,3,1.0
2099,30,15,48,63,3,1.0
2100,30,4,5,9,3,1.0
2101,30,15,18,33,3,1.0
2102,30,7,20,27,3,1.0
2103,30,19,74,93,3,1.0
2104,30,113,161,274,3,1.0
2105,30,107,110,217,3,1.0
2106,30,27,25,52,3,1.0
2107,30,63,82,145,3,1.0
2108,30,31,36,67,3,1.0
2109,30,91,48,139,3,1.0
2110,30,18,38,56,3,1.0
2111,30,26,31,57,3,1.0
2112,30,15,31,46,3,1.0
2113,30,31,54,85,3,1.0
2114,30,16,14,30,3,1.0
2115,30,13,34,47,3,1.0
2116,30,21,24,45,3,1.0
2117,30,3,9,12,3,1.0
2118,30,37,87,124,3,1.0
2119,30,17,123,140,3,1.0
2120,30,50,88,138,3,1.0
2121,30,55,86,141,3,1.0
2122,30,10,39,49,3,1.0
2123,30,12,50,62,3,1.0
2124,30,46,64,110,3,1.0
2125,30,46,48,94,3,1.0
2126,30,7,15,22,3,1.0
2127,30,59,72,131,3,1.0
2128,30,5,11,16,3,1.0
2129,30,25,71,96,3,1.0
2130,30,15,38,53,3,1.0
2131,30,13,37,50,3,1.0
2132,30,1,3,4,3,1.0
2133,30,11,39,50,3,1.0
2134,30,6,18,24,3,1.0
2135,30,12,19,31,3,1.0
2136,30,44,75,119,3,1.0
2137,30,24,59,83,3,1.0
2138,30,52,88,140,3,1.0
2139,30,27,51,78,3,1.0
2140,30,27,37,64,3,1.0
2141,30,7,16,23,3,1.0
2142,30,8,20,28,3,1.0
2143,30,45,53,98,3,1.0
2144,30,18,24,42,3,1.0
2145,30,14,27,41,3,1.0
2146,30,11,35,46,3,1.0
2147,30,0,0,0,3,1.0
2148,30,5,7,12,3,1.0
2149,30,2,4,6,3,1.0
2150,30,22,33,55,3,1.0
2151,30,28,60,88,3,1.0
2152,30,0,10,10,3,1.0
2153,30,2,14,16,3,1.0
2154,30,18,48,66,3,1.0
2155,30,5,10,15,3,1.0
2156,30,19,34,53,3,1.0
2157,30,9,39,48,3,1.0
2158,30,21,53,74,3,1.0
2159,30,21,34,55,3,1.0
2160,30,18,36,54,3,1.0
2161,30,21,34,55,3,1.0
2162,30,7,32,39,3,1.0
2163,30,6,5,11,3,1.0
2164,30,6,7,13,3,1.0
2165,30,3,5,8,3,1.0
2166,30,15,72,87,3,1.0
2167,30,31,103,134,3,1.0
2168,30,6,11,17,3,1.0
2169,30,35,105,140,3,1.0
2170,30,47,22,69,3,1.0
2171,30,60,202,262,3,1.0
2172,30,79,174,253,3,1.0
2173,30,32,59,91,3,1.0
2174,30,39,75,114,3,1.0
2175,30,6,23,29,3,1.0
2176,30,2,3,5,3,1.0
2177,30,21,29,50,3,1.0
2178,30,4,12,16,3,1.0
2179,30,12,28,40,3,1.0
2180,30,2,12,14,3,1.0
2181,30,16,39,55,3,1.0
2182,30,60,122,182,3,1.0
2183,30,2,10,12,3,1.0
2184,30,28,49,77,3,1.0
2185,30,35,110,145,3,1.0
2186,30,42,74,116,3,1.0
2187,30,6,34,40,3,1.0
2188,30,81,84,165,3,1.0
2189,30,53,103,156,3,1.0
2190,30,10,16,26,3,1.0
2191,30,13,20,33,3,1.0
2192,30,58,106,164,3,1.0
2193,30,8,20,28,3,1.0
2194,30,9,16,25,3,1.0
2195,30,10,41,51,3,1.0
2196,30,4,5,9,3,1.0
2197,30,3,9,12,3,1.0
2198,30,2,2,4,3,1.0
2199,30,23,61,84,3,1.0
2200,30,9,33,42,3,1.0
2201,30,34,81,115,3,1.0
2202,30,34,36,70,3,1.0
2203,30,41,119,160,3,1.0
2204,30,15,30,45,3,1.0
2205,30,21,31,52,3,1.0
2206,30,6,40,46,3,1.0
2207,30,24,27,51,3,1.0
2208,30,4,21,25,3,1.0
2209,30,16,29,45,3,1.0
2210,30,1,7,8,3,1.0
2211,30,0,4,4,3,1.0
2212,30,14,13,27,3,1.0
2213,30,13,15,28,3,1.0
2214,30,19,64,83,3,1.0
2215,30,43,98,141,3,1.0
2216,30,25,58,83,3,1.0
2217,30,85,125,210,3,1.0
2218,30,32,89,121,3,1.0
2219,30,26,53,79,3,1.0
2220,30,12,37,49,3,1.0
2221,30,20,67,87,3,1.0
2222,30,15,19,34,3,1.0
2223,30,10,18,28,3,1.0
2224,30,22,47,69,3,1.0
2225,30,24,67,91,3,1.0
2226,30,2,5,7,3,1.0
2227,30,10,34,44,3,1.0
2228,30,19,48,67,3,1.0
2229,30,29,57,86,3,1.0
2230,30,28,21,49,3,1.0
2231,30,10,28,38,3,1.0
2232,30,31,47,78,3,1.0
2233,30,31,89,120,3,1.0
2234,30,11,15,26,3,1.0
2235,30,37,57,94,3,1.0
2236,30,9,41,50,3,1.0
2237,30,9,25,34,3,1.0
2238,30,25,25,50,3,1.0
2239,30,21,25,46,3,1.0
2240,30,8,44,52,3,1.0
2241,30,0,2,2,3,1.0
2242,30,19,25,44,3,1.0
2243,30,45,72,117,3,1.0
2244,30,36,59,95,3,1.0
2245,30,15,4,19,3,1.0
2246,30,20,79,99,3,1.0
2247,30,58,59,117,3,1.0
2248,30,17,11,28,3,1.0
2249,30,33,55,88,3,1.0
2250,30,4,31,35,3,1.0
2251,30,40,63,103,3,1.0
2252,30,21,24,45,3,1.0
2253,30,19,32,51,3,1.0
2254,30,23,14,37,3,1.0
2255,30,26,35,61,3,1.0
2256,30,36,42,78,3,1.0
2257,30,7,12,19,3,1.0
2258,30,10,21,31,3,1.0
2259,30,14,20,34,3,1.0
2260,30,8,20,28,3,1.0
2261,30,3,20,23,3,1.0
2262,30,31,45,76,3,1.0
2263,30,24,23,47,3,1.0
2264,30,18,30,48,3,1.0
2265,30,20,42,62,3,1.0
2266,30,8,13,21,3,1.0
2267,30,19,53,72,3,1.0
2268,30,17,38,55,3,1.0
2269,30,20,89,109,3,1.0
2270,30,7,8,15,3,1.0
2271,30,35,42,77,3,1.0
2272,30,33,68,101,3,1.0
2273,30,22,30,52,3,1.0
2274,30,7,25,32,3,1.0
2275,30,5,15,20,3,1.0
2276,30,17,36,53,3,1.0
2277,30,6,22,28,3,1.0
2278,30,2,2,4,3,1.0
2279,30,1,5,6,3,1.0
2280,50,0,0,0,3,1.0
2281,50,27,72,99,3,1.0
2282,50,24,49,73,3,1.0
2283,50,6,24,30,3,1.0
2284,50,38,68,106,3,1.0
2285,50,17,46,63,3,1.0
2286,50,44,60,104,3,1.0
2287,50,6,32,38,3,1.0
2288,50,29,76,105,3,1.0
2289,50,40,55,95,3,1.0
2290,50,3,32,35,3,1.0
2291,50,32,66,98,3,1.0
2292,50,19,25,44,3,1.0
2293,50,6,21,27,3,1.0
2294,50,14,36,50,3,1.0
2295,50,3,5,8,3,1.0
2296,50,41,99,140,3,1.0
2297,50,26,62,88,3,1.0
2298,50,46,104,150,3,1.0
2299,50,47,153,200,3,1.0
2300,50,36,27,63,3,1.0
2301,50,10,18,28,3,1.0
2302,50,39,143,182,3,1.0
2303,50,68,187,255,3,1.0
2304,50,16,41,57,3,1.0
2305,50,114,190,304,3,1.0
2306,50,28,78,106,3,1.0
2307,50,24,48,72,3,1.0
2308,50,10,13,23,3,1.0
2309,50,2,4,6,3,1.0
2310,50,9,14,23,3,1.0
2311,50,3,6,9,3,1.0
2312,50,2,14,16,3,1.0
2313,50,61,130,191,3,1.0
2314,50,31,161,192,3,1.0
2315,50,57,184,241,3,1.0
2316,50,81,101,182,3,1.0
2317,50,72,152,224,3,1.0
2318,50,50,75,125,3,1.0
2319,50,64,240,304,3,1.0
2320,50,28,79,107,3,1.0
2321,50,147,182,329,3,1.0
2322,50,44,68,112,3,1.0
2323,50,35,105,140,3,1.0
2324,50,72,112,184,3,1.0
2325,50,36,51,87,3,1.0
2326,50,12,16,28,3,1.0
2327,50,4,4,8,3,1.0
2328,50,20,31,51,3,1.0
2329,50,20,46,66,3,1.0
2330,50,3,4,7,3,1.0
2331,50,59,66,125,3,1.0
2332,50,43,75,118,3,1.0
2333,50,22,57,79,3,1.0
2334,50,21,33,54,3,1.0
2335,50,29,69,98,3,1.0
2336,50,26,47,73,3,1.0
2337,50,9,44,53,3,1.0
2338,50,19,42,61,3,1.0
2339,50,52,66,118,3,1.0
2340,50,20,30,50,3,1.0
2341,50,4,12,16,3,1.0
2342,50,12,14,26,3,1.0
2343,50,9,24,33,3,1.0
2344,50,8,12,20,3,1.0
2345,50,9,7,16,3,1.0
2346,50,16,42,58,3,1.0
2347,50,34,73,107,3,1.0
2348,50,19,40,59,3,1.0
2349,50,29,55,84,3,1.0
2350,50,17,28,45,3,1.0
2351,50,41,67,108,3,1.0
2352,50,60,107,167,3,1.0
2353,50,13,33,46,3,1.0
2354,50,16,38,54,3,1.0
2355,50,12,23,35,3,1.0
2356,50,17,51,68,3,1.0
2357,50,59,85,144,3,1.0
2358,50,41,48,89,3,1.0
2359,50,16,13,29,3,1.0
2360,50,20,55,75,3,1.0
2361,50,19,96,115,3,1.0
2362,50,1,1,2,3,1.0
2363,50,7,2,9,3,1.0
2364,50,21,37,58,3,1.0
2365,50,7,54,61,3,1.0
2366,50,52,47,99,3,1.0
2367,50,96,124,220,3,1.0
2368,50,27,27,54,3,1.0
2369,50,25,48,73,3,1.0
2370,50,13,39,52,3,1.0
2371,50,60,139,199,3,1.0
2372,50,14,39,53,3,1.0
2373,50,11,25,36,3,1.0
2374,50,26,32,58,3,1.0
2375,50,28,20,48,3,1.0
2376,50,15,8,23,3,1.0
2377,50,9,8,17,3,1.0
2378,50,14,14,28,3,1.0
2379,50,7,14,21,3,1.0
2380,50,23,52,75,3,1.0
2381,50,47,72,119,3,1.0
2382,50,50,126,176,3,1.0
2383,50,14,56,70,3,1.0
2384,50,33,87,120,3,1.0
2385,50,22,29,51,3,1.0
2386,50,73,102,175,3,1.0
2387,50,65,164,229,3,1.0
2388,50,44,133,177,3,1.0
2389,50,162,298,460,3,1.0
2390,50,8,16,24,3,1.0
2391,50,44,84,128,3,1.0
2392,50,25,47,72,3,1.0
2393,50,25,53,78,3,1.0
2394,50,20,51,71,3,1.0
2395,50,30,108,138,3,1.0
2396,50,51,87,138,3,1.0
2397,50,48,65,113,3,1.0
2398,50,22,71,93,3,1.0
2399,50,23,45,68,3,1.0
2400,50,8,15,23,3,1.0
2401,50,29,98,127,3,1.0
2402,50,49,108,157,3,1.0
2403,50,2,10,12,3,1.0
2404,50,14,21,35,3,1.0
2405,50,4,14,18,3,1.0
2406,50,84,149,233,3,1.0
2407,50,54,202,256,3,1.0
2408,50,20,48,68,3,1.0
2409,50,73,130,203,3,1.0
2410,50,39,135,174,3,1.0
2411,50,29,47,76,3,1.0
2412,50,16,54,70,3,1.0
2413,50,42,97,139,3,1.0
2414,50,40,93,133,3,1.0
2415,50,64,188,252,3,1.0
2416,50,15,16,31,3,1.0
2417,50,75,89,164,3,1.0
2418,50,1,12,13,3,1.0
2419,50,32,35,67,3,1.0
2420,50,4,3,7,3,1.0
2421,50,5,12,17,3,1.0
2422,50,9,12,21,3,1.0
2423,50,39,23,62,3,1.0
2424,50,6,13,19,3,1.0
2425,50,15,35,50,3,1.0
2426,50,39,25,64,3,1.0
2427,50,88,114,202,3,1.0
2428,50,31,23,54,3,1.0
2429,50,21,27,48,3,1.0
2430,50,22,22,44,3,1.0
2431,50,56,67,123,3,1.0
2432,50,28,18,46,3,1.0
2433,50,10,14,24,3,1.0
2434,50,7,10,17,3,1.0
2435,50,2,1,3,3,1.0
2436,50,9,11,20,3,1.0
2437,50,13,36,49,3,1.0
2438,50,32,36,68,3,1.0
2439,50,22,26,48,3,1.0
2440,50,26,34,60,3,1.0
2441,50,18,34,52,3,1.0
2442,50,52,54,106,3,1.0
2443,50,36,52,88,3,1.0
2444,50,65,71,136,3,1.0
2445,50,47,52,99,3,1.0
2446,50,48,67,115,3,1.0
2447,50,79,99,178,3,1.0
2448,50,99,171,270,3,1.0
2449,50,40,81,121,3,1.0
2450,50,3,19,22,3,1.0
2451,50,45,384,429,3,1.0
2452,50,11,20,31,3,1.0
2453,50,23,42,65,3,1.0
2454,50,2,7,9,3,1.0
2455,50,6,23,29,3,1.0
2456,50,18,83,101,3,1.0
2457,50,23,69,92,3,1.0
2458,50,38,64,102,3,1.0
2459,50,18,47,65,3,1.0
2460,50,26,88,114,3,1.0
2461,50,11,41,52,3,1.0
2462,50,73,62,135,3,1.0
2463,50,11,21,32,3,1.0
2464,50,26,34,60,3,1.0
2465,50,24,45,69,3,1.0
2466,50,1,9,10,3,1.0
2467,50,5,22,27,3,1.0
2468,50,9,12,21,3,1.0
2469,50,37,127,164,3,1.0
2470,50,43,46,89,3,1.0
2471,50,83,199,282,3,1.0
2472,50,23,45,68,3,1.0
2473,50,37,72,109,3,1.0
2474,50,28,34,62,3,1.0
2475,50,29,49,78,3,1.0
2476,50,31,78,109,3,1.0
2477,50,47,79,126,3,1.0
2478,50,13,62,75,3,1.0
2479,50,10,46,56,3,1.0
2480,50,4,21,25,3,1.0
2481,50,15,14,29,3,1.0
2482,50,11,48,59,3,1.0
2483,50,15,33,48,3,1.0
2484,50,55,122,177,3,1.0
2485,50,51,90,141,3,1.0
2486,50,38,78,116,3,1.0
2487,50,42,60,102,3,1.0
2488,50,79,114,193,3,1.0
2489,50,39,65,104,3,1.0
2490,50,9,10,19,3,1.0
2491,50,32,60,92,3,1.0
2492,50,15,13,28,3,1.0
2493,50,9,26,35,3,1.0
2494,50,1,1,2,3,1.0
2495,50,12,5,17,3,1.0
2496,50,71,100,171,3,1.0
2497,50,102,184,286,3,1.0
2498,50,42,103,145,3,1.0
2499,50,96,145,241,3,1.0
2500,50,33,37,70,3,1.0
2501,50,43,60,103,3,1.0
2502,50,8,27,35,3,1.0
2503,50,13,20,33,3,1.0
2504,50,15,16,31,3,1.0
2505,50,2,12,14,3,1.0
2506,50,28,82,110,3,1.0
2507,50,20,46,66,3,1.0
2508,50,26,81,107,3,1.0
2509,50,31,56,87,3,1.0
2510,50,52,114,166,3,1.0
2511,50,26,63,89,3,1.0
2512,50,46,70,116,3,1.0
2513,50,7,26,33,3,1.0
2514,50,31,50,81,3,1.0
2515,50,43,116,159,3,1.0
2516,50,36,55,91,3,1.0
2517,50,46,66,112,3,1.0
2518,50,9,11,20,3,1.0
2519,50,5,9,14,3,1.0
2520,50,4,4,8,3,1.0
2521,50,81,105,186,3,1.0
2522,50,27,92,119,3,1.0
2523,50,88,134,222,3,1.0
2524,50,54,89,143,3,1.0
2525,50,57,104,161,3,1.0
2526,50,22,28,50,3,1.0
2527,50,32,78,110,3,1.0
2528,50,28,22,50,3,1.0
2529,50,12,40,52,3,1.0
2530,50,19,65,84,3,1.0
2531,50,3,4,7,3,1.0
2532,50,8,19,27,3,1.0
2533,50,17,20,37,3,1.0
2534,50,15,26,41,3,1.0
2535,50,10,11,21,3,1.0
2536,50,96,117,213,3,1.0
2537,50,8,45,53,3,1.0
2538,50,58,64,122,3,1.0
2539,50,13,30,43,3,1.0
2540,50,110,196,306,3,1.0
2541,50,57,112,169,3,1.0
2542,50,73,126,199,3,1.0
2543,50,36,54,90,3,1.0
2544,50,24,18,42,3,1.0
2545,50,6,6,12,3,1.0
2546,50,33,38,71,3,1.0
2547,50,4,9,13,3,1.0
2548,50,1,12,13,3,1.0
2549,50,14,19,33,3,1.0
2550,50,28,84,112,3,1.0
2551,50,16,25,41,3,1.0
2552,50,25,99,124,3,1.0
2553,50,15,68,83,3,1.0
2554,50,19,26,45,3,1.0
2555,50,13,41,54,3,1.0
2556,50,32,54,86,3,1.0
2557,50,21,35,56,3,1.0
2558,50,53,50,103,3,1.0
2559,50,46,99,145,3,1.0
2560,50,7,17,24,3,1.0
2561,50,15,36,51,3,1.0
2562,50,3,20,23,3,1.0
2563,90,39,14,53,3,1.0
2564,90,57,241,298,3,1.0
2565,90,60,231,291,3,1.0
2566,90,107,205,312,3,1.0
2567,90,39,100,139,3,1.0
2568,90,70,260,330,3,1.0
2569,90,23,66,89,3,1.0
2570,90,15,42,57,3,1.0
2571,90,8,31,39,3,1.0
2572,90,32,53,85,3,1.0
2573,90,7,16,23,3,1.0
2574,90,5,23,28,3,1.0
2575,90,5,17,22,3,1.0
2576,90,18,79,97,3,1.0
2577,90,15,85,100,3,1.0
2578,90,56,153,209,3,1.0
2579,90,35,228,263,3,1.0
2580,90,77,187,264,3,1.0
2581,90,57,100,157,3,1.0
2582,90,53,172,225,3,1.0
2583,90,44,76,120,3,1.0
2584,90,20,18,38,3,1.0
2585,90,37,47,84,3,1.0
2586,90,10,90,100,3,1.0
2587,90,3,8,11,3,1.0
2588,90,2,8,10,3,1.0
2589,90,0,2,2,3,1.0
2590,90,34,105,139,3,1.0
2591,90,74,169,243,3,1.0
2592,90,15,31,46,3,1.0
2593,90,36,134,170,3,1.0
2594,90,42,132,174,3,1.0
2595,90,70,106,176,3,1.0
2596,90,34,74,108,3,1.0
2597,90,26,74,100,3,1.0
2598,90,10,83,93,3,1.0
2599,90,28,40,68,3,1.0
2600,90,27,58,85,3,1.0
2601,90,20,46,66,3,1.0
2602,90,3,12,15,3,1.0
2603,90,4,7,11,3,1.0
2604,90,12,19,31,3,1.0
2605,90,76,162,238,3,1.0
2606,90,63,85,148,3,1.0
2607,90,63,157,220,3,1.0
2608,90,18,45,63,3,1.0
2609,90,37,48,85,3,1.0
2610,90,52,79,131,3,1.0
2611,90,50,59,109,3,1.0
2612,90,11,31,42,3,1.0
2613,90,18,38,56,3,1.0
2614,90,27,35,62,3,1.0
2615,90,72,124,196,3,1.0
2616,90,45,45,90,3,1.0
2617,90,66,52,118,3,1.0
2618,90,76,123,199,3,1.0
2619,90,47,170,217,3,1.0
2620,90,13,34,47,3,1.0
2621,90,116,217,333,3,1.0
2622,90,4,10,14,3,1.0
2623,90,96,128,224,3,1.0
2624,90,16,33,49,3,1.0
2625,90,6,11,17,3,1.0
2626,90,61,84,145,3,1.0
2627,90,24,20,44,3,1.0
2628,90,1,1,2,3,1.0
2629,90,2,19,21,3,1.0
2630,90,35,43,78,3,1.0
2631,90,6,5,11,3,1.0
2632,90,39,133,172,3,1.0
2633,90,70,197,267,3,1.0
2634,90,32,78,110,3,1.0
2635,90,43,25,68,3,1.0
2636,90,12,58,70,3,1.0
2637,90,19,74,93,3,1.0
2638,90,29,81,110,3,1.0
2639,90,16,27,43,3,1.0
2640,90,24,53,77,3,1.0
2641,90,30,52,82,3,1.0
2642,90,11,32,43,3,1.0
2643,90,2,14,16,3,1.0
2644,90,4,12,16,3,1.0
2645,90,0,0,0,3,1.0
2646,90,3,2,5,3,1.0
2647,90,4,9,13,3,1.0
2648,90,60,77,137,3,1.0
2649,90,35,57,92,3,1.0
2650,90,10,7,17,3,1.0
2651,90,28,50,78,3,1.0
2652,90,42,49,91,3,1.0
2653,90,95,159,254,3,1.0
2654,90,21,26,47,3,1.0
2655,90,74,98,172,3,1.0
2656,90,23,45,68,3,1.0
2657,90,13,20,33,3,1.0
2658,90,14,19,33,3,1.0
2659,90,9,11,20,3,1.0
2660,90,2,5,7,3,1.0
2661,90,19,28,47,3,1.0
2662,90,16,39,55,3,1.0
2663,90,58,251,309,3,1.0
2664,90,18,25,43,3,1.0
2665,90,28,24,52,3,1.0
2666,90,19,8,27,3,1.0
2667,90,26,47,73,3,1.0
2668,90,85,161,246,3,1.0
2669,90,2,18,20,3,1.0
2670,90,17,17,34,3,1.0
2671,90,17,35,52,3,1.0
2672,90,13,33,46,3,1.0
2673,90,3,2,5,3,1.0
2674,90,12,30,42,3,1.0
2675,90,20,13,33,3,1.0
2676,90,3,4,7,3,1.0
2677,90,4,5,9,3,1.0
2678,90,41,97,138,3,1.0
2679,90,4,6,10,3,1.0
2680,90,6,25,31,3,1.0
2681,90,47,102,149,3,1.0
2682,90,46,45,91,3,1.0
2683,90,33,18,51,3,1.0
2684,90,9,25,34,3,1.0
2685,90,50,101,151,3,1.0
2686,90,44,68,112,3,1.0
2687,90,13,29,42,3,1.0
2688,90,3,11,14,3,1.0
2689,90,23,29,52,3,1.0
2690,90,11,22,33,3,1.0
2691,90,5,5,10,3,1.0
2692,90,4,9,13,3,1.0
2693,90,0,0,0,3,1.0
2694,90,14,37,51,3,1.0
2695,90,21,62,83,3,1.0
2696,90,24,64,88,3,1.0
2697,90,47,70,117,3,1.0
2698,90,45,49,94,3,1.0
2699,90,28,91,119,3,1.0
2700,90,22,42,64,3,1.0
2701,90,19,40,59,3,1.0
2702,90,13,29,42,3,1.0
2703,90,41,44,85,3,1.0
2704,90,64,107,171,3,1.0
2705,90,6,24,30,3,1.0
2706,90,9,12,21,3,1.0
2707,90,23,32,55,3,1.0
2708,90,7,3,10,3,1.0
2709,90,8,29,37,3,1.0
2710,90,9,57,66,3,1.0
2711,90,20,70,90,3,1.0
2712,90,32,52,84,3,1.0
2713,90,41,56,97,3,1.0
2714,90,23,77,100,3,1.0
2715,90,26,84,110,3,1.0
2716,90,57,61,118,3,1.0
2717,90,39,107,146,3,1.0
2718,90,38,70,108,3,1.0
2719,90,10,26,36,3,1.0
2720,90,18,21,39,3,1.0
2721,90,27,54,81,3,1.0
2722,90,21,38,59,3,1.0
2723,90,6,18,24,3,1.0
2724,90,13,22,35,3,1.0
2725,90,0,3,3,3,1.0
2726,90,24,67,91,3,1.0
2727,90,30,106,136,3,1.0
2728,90,17,44,61,3,1.0
2729,90,23,51,74,3,1.0
2730,90,20,57,77,3,1.0
2731,90,20,44,64,3,1.0
2732,90,22,44,66,3,1.0
2733,90,34,52,86,3,1.0
2734,90,87,199,286,3,1.0
2735,90,10,31,41,3,1.0
2736,90,30,77,107,3,1.0
2737,90,38,56,94,3,1.0
2738,90,41,137,178,3,1.0
2739,90,42,59,101,3,1.0
2740,90,22,105,127,3,1.0
2741,90,71,198,269,3,1.0
2742,90,12,32,44,3,1.0
2743,90,11,28,39,3,1.0
2744,90,24,30,54,3,1.0
2745,90,16,31,47,3,1.0
2746,90,33,30,63,3,1.0
2747,90,12,16,28,3,1.0
2748,90,15,18,33,3,1.0
2749,90,1,4,5,3,1.0
2750,90,3,7,10,3,1.0
2751,90,6,12,18,3,1.0
2752,90,2,5,7,3,1.0
2753,90,12,55,67,3,1.0
2754,90,35,26,61,3,1.0
2755,90,40,113,153,3,1.0
2756,90,49,101,150,3,1.0
2757,90,47,140,187,3,1.0
2758,90,29,80,109,3,1.0
2759,90,28,35,63,3,1.0
2760,90,19,49,68,3,1.0
2761,90,14,44,58,3,1.0
2762,90,42,49,91,3,1.0
2763,90,5,22,27,3,1.0
2764,90,4,16,20,3,1.0
2765,90,12,12,24,3,1.0
2766,90,6,12,18,3,1.0
2767,90,41,47,88,3,1.0
2768,90,75,207,282,3,1.0
2769,90,16,70,86,3,1.0
2770,90,13,36,49,3,1.0
2771,90,28,32,60,3,1.0
2772,90,19,76,95,3,1.0
2773,90,14,58,72,3,1.0
2774,90,34,57,91,3,1.0
2775,90,10,17,27,3,1.0
2776,90,57,73,130,3,1.0
2777,90,31,25,56,3,1.0
2778,90,23,57,80,3,1.0
2779,90,14,26,40,3,1.0
2780,90,8,16,24,3,1.0
2781,90,15,27,42,3,1.0
2782,90,2,11,13,3,1.0
2783,90,46,43,89,3,1.0
2784,90,23,51,74,3,1.0
2785,90,11,18,29,3,1.0
2786,90,25,76,101,3,1.0
2787,90,26,45,71,3,1.0
2788,90,42,72,114,3,1.0
2789,90,33,54,87,3,1.0
2790,90,29,12,41,3,1.0
2791,90,26,86,112,3,1.0
2792,90,25,39,64,3,1.0
2793,90,11,28,39,3,1.0
2794,90,16,39,55,3,1.0
2795,90,9,14,23,3,1.0
2796,90,8,22,30,3,1.0
2797,90,11,6,17,3,1.0
2798,90,11,21,32,3,1.0
2799,90,4,13,17,3,1.0
2800,90,6,18,24,3,1.0
2801,90,28,64,92,3,1.0
2802,90,23,45,68,3,1.0
2803,90,7,6,13,3,1.0
2804,90,33,58,91,3,1.0
2805,90,45,57,102,3,1.0
2806,90,25,73,98,3,1.0
2807,90,47,143,190,3,1.0
2808,90,62,71,133,3,1.0
2809,90,21,45,66,3,1.0
2810,90,10,15,25,3,1.0
2811,90,9,16,25,3,1.0
2812,90,5,16,21,3,1.0
2813,90,2,9,11,3,1.0
2814,90,30,49,79,3,1.0
2815,90,42,95,137,3,1.0
2816,90,3,5,8,3,1.0
2817,90,26,37,63,3,1.0
2818,90,6,36,42,3,1.0
2819,90,62,95,157,3,1.0
2820,90,55,117,172,3,1.0
2821,90,11,7,18,3,1.0
2822,90,31,54,85,3,1.0
2823,90,25,54,79,3,1.0
2824,90,29,30,59,3,1.0
2825,90,26,43,69,3,1.0
2826,90,31,71,102,3,1.0
2827,90,46,22,68,3,1.0
2828,90,80,142,222,3,1.0
2829,90,9,12,21,3,1.0
2830,90,11,22,33,3,1.0
2831,90,3,4,7,3,1.0
2832,90,9,12,21,3,1.0
2833,90,30,92,122,3,1.0
2834,90,17,40,57,3,1.0
2835,90,16,8,24,3,1.0
2836,90,21,66,87,3,1.0
2837,90,13,55,68,3,1.0
2838,90,76,94,170,3,1.0
2839,90,9,23,32,3,1.0
2840,90,31,68,99,3,1.0
2841,90,57,101,158,3,1.0
2842,90,25,30,55,3,1.0
2843,90,20,32,52,3,1.0
2844,90,19,31,50,3,1.0
2845,90,21,32,53,3,1.0
2846,90,2,5,7,3,1.0
2847,90,26,27,53,3,1.0
2848,90,28,36,64,3,1.0
2849,90,18,23,41,3,1.0
2850,90,19,38,57,3,1.0
2851,90,18,16,34,3,1.0
2852,90,36,49,85,3,1.0
2853,90,16,18,34,3,1.0
2854,90,16,26,42,3,1.0
2855,90,13,13,26,3,1.0
2856,90,22,13,35,3,1.0
2857,90,4,12,16,3,1.0
2858,90,27,32,59,3,1.0
2859,120,24,114,138,3,1.0
2860,120,6,17,23,3,1.0
2861,120,82,97,179,3,1.0
2862,120,44,64,108,3,1.0
2863,120,39,69,108,3,1.0
2864,120,30,86,116,3,1.0
2865,120,31,40,71,3,1.0
2866,120,75,147,222,3,1.0
2867,120,6,16,22,3,1.0
2868,120,11,15,26,3,1.0
2869,120,13,20,33,3,1.0
2870,120,10,12,22,3,1.0
2871,120,49,39,88,3,1.0
2872,120,26,82,108,3,1.0
2873,120,33,52,85,3,1.0
2874,120,39,79,118,3,1.0
2875,120,37,63,100,3,1.0
2876,120,17,37,54,3,1.0
2877,120,49,69,118,3,1.0
2878,120,24,34,58,3,1.0
2879,120,66,115,181,3,1.0
2880,120,12,34,46,3,1.0
2881,120,29,53,82,3,1.0
2882,120,2,13,15,3,1.0
2883,120,42,38,80,3,1.0
2884,120,15,23,38,3,1.0
2885,120,7,19,26,3,1.0
2886,120,12,25,37,3,1.0
2887,120,6,7,13,3,1.0
2888,120,24,34,58,3,1.0
2889,120,16,54,70,3,1.0
2890,120,38,63,101,3,1.0
2891,120,10,30,40,3,1.0
2892,120,33,116,149,3,1.0
2893,120,31,104,135,3,1.0
2894,120,13,14,27,3,1.0
2895,120,27,64,91,3,1.0
2896,120,48,50,98,3,1.0
2897,120,52,49,101,3,1.0
2898,120,24,43,67,3,1.0
2899,120,4,14,18,3,1.0
2900,120,18,21,39,3,1.0
2901,120,32,65,97,3,1.0
2902,120,8,22,30,3,1.0
2903,120,7,8,15,3,1.0
2904,120,18,19,37,3,1.0
2905,120,25,25,50,3,1.0
2906,120,1,3,4,3,1.0
2907,120,4,4,8,3,1.0
2908,120,5,8,13,3,1.0
2909,120,48,82,130,3,1.0
2910,120,1,7,8,3,1.0
2911,120,6,21,27,3,1.0
2912,120,24,59,83,3,1.0
2913,120,43,84,127,3,1.0
2914,120,41,52,93,3,1.0
2915,120,19,35,54,3,1.0
2916,120,21,72,93,3,1.0
2917,120,17,33,50,3,1.0
2918,120,7,31,38,3,1.0
2919,120,16,62,78,3,1.0
2920,120,2,12,14,3,1.0
2921,120,20,14,34,3,1.0
2922,120,17,22,39,3,1.0
2923,120,15,40,55,3,1.0
2924,120,8,2,10,3,1.0
2925,120,5,9,14,3,1.0
2926,120,0,4,4,3,1.0
2927,120,32,39,71,3,1.0
2928,120,9,16,25,3,1.0
2929,120,17,36,53,3,1.0
2930,120,27,51,78,3,1.0
2931,120,47,145,192,3,1.0
2932,120,62,74,136,3,1.0
2933,120,26,43,69,3,1.0
2934,120,39,63,102,3,1.0
2935,120,24,18,42,3,1.0
2936,120,32,90,122,3,1.0
2937,120,49,73,122,3,1.0
2938,120,29,25,54,3,1.0
2939,120,12,13,25,3,1.0
2940,120,12,13,25,3,1.0
2941,120,10,19,29,3,1.0
2942,120,22,47,69,3,1.0
2943,120,5,5,10,3,1.0
2944,120,40,98,138,3,1.0
2945,120,37,94,131,3,1.0
2946,120,72,205,277,3,1.0
2947,120,28,58,86,3,1.0
2948,120,57,127,184,3,1.0
2949,120,12,32,44,3,1.0
2950,120,13,38,51,3,1.0
2951,120,26,57,83,3,1.0
2952,120,54,67,121,3,1.0
2953,120,8,25,33,3,1.0
2954,120,15,17,32,3,1.0
2955,120,3,14,17,3,1.0
2956,120,4,12,16,3,1.0
2957,120,78,143,221,3,1.0
2958,120,24,60,84,3,1.0
2959,120,32,101,133,3,1.0
2960,120,62,87,149,3,1.0
2961,120,16,88,104,3,1.0
2962,120,79,97,176,3,1.0
2963,120,13,4,17,3,1.0
2964,120,10,43,53,3,1.0
2965,120,118,152,270,3,1.0
2966,120,4,10,14,3,1.0
2967,120,79,137,216,3,1.0
2968,120,79,124,203,3,1.0
2969,120,32,20,52,3,1.0
2970,120,17,30,47,3,1.0
2971,120,4,18,22,3,1.0
2972,120,24,40,64,3,1.0
2973,120,0,0,0,3,1.0
2974,120,25,53,78,3,1.0
2975,120,30,48,78,3,1.0
2976,120,67,179,246,3,1.0
2977,120,23,44,67,3,1.0
2978,120,42,79,121,3,1.0
2979,120,140,219,359,3,1.0
2980,120,35,112,147,3,1.0
2981,120,22,70,92,3,1.0
2982,120,50,107,157,3,1.0
2983,120,54,87,141,3,1.0
2984,120,67,110,177,3,1.0
2985,120,43,46,89,3,1.0
2986,120,18,33,51,3,1.0
2987,120,24,73,97,3,1.0
2988,120,32,61,93,3,1.0
2989,120,25,20,45,3,1.0
2990,120,19,22,41,3,1.0
2991,120,4,2,6,3,1.0
2992,120,40,60,100,3,1.0
2993,120,43,142,185,3,1.0
2994,120,16,17,33,3,1.0
2995,120,11,45,56,3,1.0
2996,120,8,31,39,3,1.0
2997,120,34,100,134,3,1.0
2998,120,25,81,106,3,1.0
2999,120,36,69,105,3,1.0
3000,120,19,76,95,3,1.0
3001,120,8,15,23,3,1.0
3002,120,44,30,74,3,1.0
3003,120,24,28,52,3,1.0
3004,120,16,38,54,3,1.0
3005,120,5,13,18,3,1.0
3006,120,1,2,3,3,1.0
3007,120,37,42,79,3,1.0
3008,120,11,13,24,3,1.0
3009,120,5,8,13,3,1.0
3010,120,3,3,6,3,1.0
3011,120,34,81,115,3,1.0
3012,120,16,38,54,3,1.0
3013,120,10,5,15,3,1.0
3014,120,48,143,191,3,1.0
3015,120,85,184,269,3,1.0
3016,120,31,49,80,3,1.0
3017,120,44,167,211,3,1.0
3018,120,27,113,140,3,1.0
3019,120,3,10,13,3,1.0
3020,120,24,113,137,3,1.0
3021,120,19,76,95,3,1.0
3022,120,40,105,145,3,1.0
3023,120,33,109,142,3,1.0
3024,120,14,24,38,3,1.0
3025,120,15,41,56,3,1.0
3026,120,3,5,8,3,1.0
3027,120,96,173,269,3,1.0
3028,120,73,78,151,3,1.0
3029,120,33,68,101,3,1.0
3030,120,51,81,132,3,1.0
3031,120,23,47,70,3,1.0
3032,120,27,36,63,3,1.0
3033,120,65,63,128,3,1.0
3034,120,18,79,97,3,1.0
3035,120,10,19,29,3,1.0
3036,120,19,26,45,3,1.0
3037,120,25,69,94,3,1.0
3038,120,10,32,42,3,1.0
3039,120,7,10,17,3,1.0
3040,120,18,29,47,3,1.0
3041,120,58,76,134,3,1.0
3042,120,70,162,232,3,1.0
3043,120,8,20,28,3,1.0
3044,120,28,61,89,3,1.0
3045,120,56,117,173,3,1.0
3046,120,53,117,170,3,1.0
3047,120,36,93,129,3,1.0
3048,120,27,73,100,3,1.0
3049,120,34,93,127,3,1.0
3050,120,31,69,100,3,1.0
3051,120,6,18,24,3,1.0
3052,120,12,17,29,3,1.0
3053,120,0,7,7,3,1.0
3054,120,2,3,5,3,1.0
3055,120,81,62,143,3,1.0
3056,120,16,49,65,3,1.0
3057,120,59,84,143,3,1.0
3058,120,82,73,155,3,1.0
3059,120,56,89,145,3,1.0
3060,120,53,103,156,3,1.0
3061,120,25,69,94,3,1.0
3062,120,12,26,38,3,1.0
3063,120,1,7,8,3,1.0
3064,120,16,36,52,3,1.0
3065,120,12,32,44,3,1.0
3066,120,1,8,9,3,1.0
3067,120,63,102,165,3,1.0
3068,120,30,68,98,3,1.0
3069,120,45,102,147,3,1.0
3070,120,28,108,136,3,1.0
3071,120,38,93,131,3,1.0
3072,120,5,21,26,3,1.0
3073,120,11,39,50,3,1.0
3074,120,18,38,56,3,1.0
3075,120,27,106,133,3,1.0
3076,120,2,12,14,3,1.0
3077,120,13,65,78,3,1.0
3078,120,5,9,14,3,1.0
3079,120,17,31,48,3,1.0
3080,120,5,11,16,3,1.0
3081,120,14,37,51,3,1.0
3082,120,34,50,84,3,1.0
3083,120,41,74,115,3,1.0
3084,120,6,33,39,3,1.0
3085,120,33,44,77,3,1.0
3086,120,70,114,184,3,1.0
3087,120,7,14,21,3,1.0
3088,120,8,27,35,3,1.0
3089,120,48,85,133,3,1.0
3090,120,10,10,20,3,1.0
3091,120,20,35,55,3,1.0
3092,120,6,1,7,3,1.0
3093,120,3,1,4,3,1.0
3094,120,0,0,0,3,1.0
3095,120,40,41,81,3,1.0
3096,120,18,31,49,3,1.0
3097,120,26,62,88,3,1.0
3098,120,15,33,48,3,1.0
3099,120,13,10,23,3,1.0
3100,120,9,10,19,3,1.0
3101,120,4,7,11,3,1.0
3102,120,15,15,30,3,1.0
3103,120,0,0,0,3,1.0
3104,120,5,5,10,3,1.0
3105,120,36,26,62,3,1.0
3106,120,2,20,22,3,1.0
3107,120,36,115,151,3,1.0
3108,120,74,138,212,3,1.0
3109,120,13,20,33,3,1.0
3110,120,19,78,97,3,1.0
3111,120,42,105,147,3,1.0
3112,120,28,107,135,3,1.0
3113,120,50,75,125,3,1.0
3114,120,4,17,21,3,1.0
3115,120,11,31,42,3,1.0
3116,120,12,42,54,3,1.0
3117,120,17,39,56,3,1.0
3118,120,17,32,49,3,1.0
3119,120,9,15,24,3,1.0
3120,120,1,6,7,3,1.0
3121,120,6,10,16,3,1.0
3122,120,30,56,86,3,1.0
3123,120,24,61,85,3,1.0
3124,120,47,62,109,3,1.0
3125,120,61,159,220,3,1.0
3126,120,22,95,117,3,1.0
3127,120,22,52,74,3,1.0
3128,120,83,114,197,3,1.0
3129,120,27,80,107,3,1.0
3130,120,13,39,52,3,1.0
3131,120,12,33,45,3,1.0
3132,120,5,14,19,3,1.0
3133,120,9,24,33,3,1.0
3134,120,0,5,5,3,1.0
3135,120,62,123,185,3,1.0
3136,120,8,32,40,3,1.0
3137,120,3,7,10,3,1.0
3138,120,4,19,23,3,1.0
3139,120,78,98,176,3,1.0
3140,120,3,13,16,3,1.0
3141,120,17,46,63,3,1.0
3142,120,25,48,73,3,1.0
3143,120,87,126,213,3,1.0
3144,120,21,78,99,3,1.0
3145,120,55,78,133,3,1.0
3146,120,40,76,116,3,1.0
3147,120,31,37,68,3,1.0
3148,120,8,18,26,3,1.0
3149,120,7,19,26,3,1.0
3150,120,7,15,22,3,1.0
3151,120,19,24,43,3,1.0
3152,180,20,32,52,3,1.0
3153,180,45,83,128,3,1.0
3154,180,69,87,156,3,1.0
3155,180,40,109,149,3,1.0
3156,180,23,93,116,3,1.0
3157,180,32,77,109,3,1.0
3158,180,99,219,318,3,1.0
3159,180,116,232,348,3,1.0
3160,180,73,86,159,3,1.0
3161,180,153,132,285,3,1.0
3162,180,101,101,202,3,1.0
3163,180,4,10,14,3,1.0
3164,180,32,24,56,3,1.0
3165,180,16,29,45,3,1.0
3166,180,12,24,36,3,1.0
3167,180,10,13,23,3,1.0
3168,180,2,21,23,3,1.0
3169,180,3,7,10,3,1.0
3170,180,2,6,8,3,1.0
3171,180,40,79,119,3,1.0
3172,180,38,29,67,3,1.0
3173,180,55,94,149,3,1.0
3174,180,48,38,86,3,1.0
3175,180,49,110,159,3,1.0
3176,180,57,150,207,3,1.0
3177,180,18,46,64,3,1.0
3178,180,27,94,121,3,1.0
3179,180,30,63,93,3,1.0
3180,180,7,7,14,3,1.0
3181,180,24,48,72,3,1.0
3182,180,31,40,71,3,1.0
3183,180,71,57,128,3,1.0
3184,180,11,37,48,3,1.0
3185,180,23,15,38,3,1.0
3186,180,24,21,45,3,1.0
3187,180,8,18,26,3,1.0
3188,180,11,10,21,3,1.0
3189,180,5,0,5,3,1.0
3190,180,17,22,39,3,1.0
3191,180,4,2,6,3,1.0
3192,180,36,109,145,3,1.0
3193,180,20,64,84,3,1.0
3194,180,66,135,201,3,1.0
3195,180,47,101,148,3,1.0
3196,180,49,53,102,3,1.0
3197,180,29,103,132,3,1.0
3198,180,22,51,73,3,1.0
3199,180,25,84,109,3,1.0
3200,180,103,268,371,3,1.0
3201,180,5,44,49,3,1.0
3202,180,19,53,72,3,1.0
3203,180,3,9,12,3,1.0
3204,180,16,27,43,3,1.0
3205,180,6,12,18,3,1.0
3206,180,5,16,21,3,1.0
3207,180,4,4,8,3,1.0
3208,180,11,39,50,3,1.0
3209,180,56,110,166,3,1.0
3210,180,41,22,63,3,1.0
3211,180,35,107,142,3,1.0
3212,180,34,95,129,3,1.0
3213,180,16,63,79,3,1.0
3214,180,52,114,166,3,1.0
3215,180,11,28,39,3,1.0
3216,180,17,54,71,3,1.0
3217,180,55,123,178,3,1.0
3218,180,22,37,59,3,1.0
3219,180,44,59,103,3,1.0
3220,180,16,30,46,3,1.0
3221,180,13,23,36,3,1.0
3222,180,9,31,40,3,1.0
3223,180,23,21,44,3,1.0
3224,180,10,12,22,3,1.0
3225,180,51,140,191,3,1.0
3226,180,29,104,133,3,1.0
3227,180,36,118,154,3,1.0
3228,180,128,211,339,3,1.0
3229,180,34,115,149,3,1.0
3230,180,14,50,64,3,1.0
3231,180,32,69,101,3,1.0
3232,180,39,79,118,3,1.0
3233,180,4,6,10,3,1.0
3234,180,15,23,38,3,1.0
3235,180,6,27,33,3,1.0
3236,180,7,8,15,3,1.0
3237,180,24,81,105,3,1.0
3238,180,55,173,228,3,1.0
3239,180,23,87,110,3,1.0
3240,180,33,143,176,3,1.0
3241,180,43,87,130,3,1.0
3242,180,65,100,165,3,1.0
3243,180,40,68,108,3,1.0
3244,180,16,59,75,3,1.0
3245,180,25,50,75,3,1.0
3246,180,25,30,55,3,1.0
3247,180,7,16,23,3,1.0
3248,180,20,14,34,3,1.0
3249,180,1,2,3,3,1.0
3250,180,23,74,97,3,1.0
3251,180,44,176,220,3,1.0
3252,180,97,143,240,3,1.0
3253,180,43,98,141,3,1.0
3254,180,16,58,74,3,1.0
3255,180,14,17,31,3,1.0
3256,180,38,114,152,3,1.0
3257,180,9,50,59,3,1.0
3258,180,9,30,39,3,1.0
3259,180,7,13,20,3,1.0
3260,180,22,47,69,3,1.0
3261,180,40,95,135,3,1.0
3262,180,25,51,76,3,1.0
3263,180,53,131,184,3,1.0
3264,180,34,86,120,3,1.0
3265,180,35,63,98,3,1.0
3266,180,36,125,161,3,1.0
3267,180,5,18,23,3,1.0
3268,180,91,121,212,3,1.0
3269,180,65,108,173,3,1.0
3270,180,10,40,50,3,1.0
3271,180,10,14,24,3,1.0
3272,180,8,11,19,3,1.0
3273,180,19,60,79,3,1.0
3274,180,20,63,83,3,1.0
3275,180,28,51,79,3,1.0
3276,180,52,96,148,3,1.0
3277,180,26,56,82,3,1.0
3278,180,73,147,220,3,1.0
3279,180,47,59,106,3,1.0
3280,180,36,46,82,3,1.0
3281,180,65,80,145,3,1.0
3282,180,8,12,20,3,1.0
3283,180,12,24,36,3,1.0
3284,180,7,15,22,3,1.0
3285,180,3,15,18,3,1.0
3286,180,31,109,140,3,1.0
3287,180,29,45,74,3,1.0
3288,180,12,28,40,3,1.0
3289,180,16,46,62,3,1.0
3290,180,158,275,433,3,1.0
3291,180,51,76,127,3,1.0
3292,180,21,41,62,3,1.0
3293,180,26,34,60,3,1.0
3294,180,82,104,186,3,1.0
3295,180,32,52,84,3,1.0
3296,180,3,8,11,3,1.0
3297,180,26,30,56,3,1.0
3298,180,5,8,13,3,1.0
3299,180,9,9,18,3,1.0
3300,180,0,0,0,3,1.0
3301,180,0,3,3,3,1.0
3302,180,49,56,105,3,1.0
3303,180,124,125,249,3,1.0
3304,180,11,16,27,3,1.0
3305,180,25,106,131,3,1.0
3306,180,70,59,129,3,1.0
3307,180,56,123,179,3,1.0
3308,180,34,54,88,3,1.0
3309,180,5,5,10,3,1.0
3310,180,74,144,218,3,1.0
3311,180,28,40,68,3,1.0
3312,180,30,27,57,3,1.0
3313,180,30,25,55,3,1.0
3314,180,21,34,55,3,1.0
3315,180,29,56,85,3,1.0
3316,180,19,31,50,3,1.0
3317,180,19,45,64,3,1.0
3318,180,0,0,0,3,1.0
3319,180,2,6,8,3,1.0
3320,180,31,8,39,3,1.0
3321,180,12,49,61,3,1.0
3322,180,64,191,255,3,1.0
3323,180,16,71,87,3,1.0
3324,180,24,40,64,3,1.0
3325,180,29,120,149,3,1.0
3326,180,68,139,207,3,1.0
3327,180,44,126,170,3,1.0
3328,180,43,82,125,3,1.0
3329,180,41,66,107,3,1.0
3330,180,52,53,105,3,1.0
3331,180,68,104,172,3,1.0
3332,180,6,23,29,3,1.0
3333,180,27,38,65,3,1.0
3334,180,10,20,30,3,1.0
3335,180,5,11,16,3,1.0
3336,180,12,33,45,3,1.0
3337,180,24,111,135,3,1.0
3338,180,34,74,108,3,1.0
3339,180,53,129,182,3,1.0
3340,180,49,113,162,3,1.0
3341,180,44,85,129,3,1.0
3342,180,33,63,96,3,1.0
3343,180,51,135,186,3,1.0
3344,180,24,29,53,3,1.0
3345,180,31,75,106,3,1.0
3346,180,11,18,29,3,1.0
3347,180,50,62,112,3,1.0
3348,180,13,26,39,3,1.0
3349,180,8,4,12,3,1.0
3350,180,26,37,63,3,1.0
3351,180,62,141,203,3,1.0
3352,180,63,97,160,3,1.0
3353,180,7,11,18,3,1.0
3354,180,43,100,143,3,1.0
3355,180,42,67,109,3,1.0
3356,180,46,70,116,3,1.0
3357,180,15,30,45,3,1.0
3358,180,87,161,248,3,1.0
3359,180,5,17,22,3,1.0
3360,180,42,92,134,3,1.0
3361,180,20,14,34,3,1.0
3362,180,20,62,82,3,1.0
3363,180,15,25,40,3,1.0
3364,180,19,35,54,3,1.0
3365,180,12,9,21,3,1.0
3366,180,3,2,5,3,1.0
3367,180,16,36,52,3,1.0
3368,180,31,78,109,3,1.0
3369,180,19,39,58,3,1.0
3370,180,33,115,148,3,1.0
3371,180,30,64,94,3,1.0
3372,180,66,131,197,3,1.0
3373,180,68,92,160,3,1.0
3374,180,15,46,61,3,1.0
3375,180,32,105,137,3,1.0
3376,180,26,80,106,3,1.0
3377,180,52,86,138,3,1.0
3378,180,13,18,31,3,1.0
3379,180,37,67,104,3,1.0
3380,180,5,7,12,3,1.0
3381,180,31,84,115,3,1.0
3382,180,14,8,22,3,1.0
3383,180,30,47,77,3,1.0
3384,180,18,43,61,3,1.0
3385,180,17,41,58,3,1.0
3386,180,62,129,191,3,1.0
3387,180,53,49,102,3,1.0
3388,180,13,59,72,3,1.0
3389,180,17,46,63,3,1.0
3390,180,33,71,104,3,1.0
3391,180,49,37,86,3,1.0
3392,180,12,22,34,3,1.0
3393,180,11,54,65,3,1.0
3394,180,7,21,28,3,1.0
3395,180,11,13,24,3,1.0
3396,180,49,122,171,3,1.0
3397,180,27,51,78,3,1.0
3398,180,34,41,75,3,1.0
3399,180,23,55,78,3,1.0
3400,180,2,14,16,3,1.0
3401,180,61,106,167,3,1.0
3402,180,48,108,156,3,1.0
3403,180,38,90,128,3,1.0
3404,180,64,95,159,3,1.0
3405,180,16,38,54,3,1.0
3406,180,32,75,107,3,1.0
3407,180,9,41,50,3,1.0
3408,180,64,117,181,3,1.0
3409,180,10,24,34,3,1.0
3410,180,68,72,140,3,1.0
3411,180,25,27,52,3,1.0
3412,180,74,157,231,3,1.0
3413,180,21,50,71,3,1.0
3414,180,45,132,177,3,1.0
3415,180,96,115,211,3,1.0
3416,180,25,85,110,3,1.0
3417,180,57,131,188,3,1.0
3418,180,22,78,100,3,1.0
3419,180,21,32,53,3,1.0
3420,180,22,59,81,3,1.0
3421,180,55,83,138,3,1.0
3422,180,48,96,144,3,1.0
3423,180,13,28,41,3,1.0
3424,180,67,81,148,3,1.0
3425,180,18,35,53,3,1.0
3426,180,14,37,51,3,1.0
3427,180,63,116,179,3,1.0
3428,180,23,51,74,3,1.0
3429,180,23,78,101,3,1.0
3430,180,33,71,104,3,1.0
3431,180,24,54,78,3,1.0
3432,180,54,161,215,3,1.0
3433,180,23,69,92,3,1.0
3434,180,17,28,45,3,1.0
3435,180,31,56,87,3,1.0
3436,180,8,18,26,3,1.0
3437,180,9,18,27,3,1.0
3438,180,2,7,9,3,1.0
3439,180,17,22,39,3,1.0
3440,180,24,70,94,3,1.0
3441,180,43,157,200,3,1.0
3442,180,23,40,63,3,1.0
3443,180,62,166,228,3,1.0
3444,180,35,93,128,3,1.0
3445,180,20,59,79,3,1.0
3446,180,60,209,269,3,1.0
3447,180,47,97,144,3,1.0
3448,180,28,62,90,3,1.0
3449,180,28,23,51,3,1.0
3450,180,36,79,115,3,1.0
3451,180,22,54,76,3,1.0
3452,180,23,49,72,3,1.0
3453,180,8,4,12,3,1.0
3454,180,34,58,92,3,1.0
3455,180,0,5,5,3,1.0
3456,30,30,71,101,3,10.0
3457,30,54,57,111,3,10.0
3458,30,46,23,69,3,10.0
3459,30,56,49,105,3,10.0
3460,30,49,43,92,3,10.0
3461,30,17,35,52,3,10.0
3462,30,39,85,124,3,10.0
3463,30,8,13,21,3,10.0
3464,30,10,24,34,3,10.0
3465,30,12,39,51,3,10.0
3466,30,20,12,32,3,10.0
3467,30,69,102,171,3,10.0
3468,30,34,20,54,3,10.0
3469,30,28,59,87,3,10.0
3470,30,53,74,127,3,10.0
3471,30,21,9,30,3,10.0
3472,30,10,21,31,3,10.0
3473,30,95,188,283,3,10.0
3474,30,42,86,128,3,10.0
3475,30,28,41,69,3,10.0
3476,30,0,6,6,3,10.0
3477,30,69,112,181,3,10.0
3478,30,26,22,48,3,10.0
3479,30,28,52,80,3,10.0
3480,30,0,4,4,3,10.0
3481,30,28,17,45,3,10.0
3482,30,19,12,31,3,10.0
3483,30,32,43,75,3,10.0
3484,30,30,56,86,3,10.0
3485,30,28,91,119,3,10.0
3486,30,33,63,96,3,10.0
3487,30,35,106,141,3,10.0
3488,30,8,20,28,3,10.0
3489,30,17,36,53,3,10.0
3490,30,3,6,9,3,10.0
3491,30,38,35,73,3,10.0
3492,30,28,59,87,3,10.0
3493,30,55,50,105,3,10.0
3494,30,99,131,230,3,10.0
3495,30,6,19,25,3,10.0
3496,30,37,64,101,3,10.0
3497,30,32,46,78,3,10.0
3498,30,12,31,43,3,10.0
3499,30,35,56,91,3,10.0
3500,30,5,23,28,3,10.0
3501,30,19,24,43,3,10.0
3502,30,8,25,33,3,10.0
3503,30,43,34,77,3,10.0
3504,30,21,10,31,3,10.0
3505,30,36,37,73,3,10.0
3506,30,34,126,160,3,10.0
3507,30,22,92,114,3,10.0
3508,30,68,112,180,3,10.0
3509,30,77,112,189,3,10.0
3510,30,46,64,110,3,10.0
3511,30,98,138,236,3,10.0
3512,30,33,65,98,3,10.0
3513,30,34,65,99,3,10.0
3514,30,46,37,83,3,10.0
3515,30,10,2,12,3,10.0
3516,30,19,76,95,3,10.0
3517,30,18,24,42,3,10.0
3518,30,1,1,2,3,10.0
3519,30,37,56,93,3,10.0
3520,30,36,101,137,3,10.0
3521,30,65,181,246,3,10.0
3522,30,47,116,163,3,10.0
3523,30,19,23,42,3,10.0
3524,30,27,65,92,3,10.0
3525,30,100,133,233,3,10.0
3526,30,111,196,307,3,10.0
3527,30,32,73,105,3,10.0
3528,30,75,62,137,3,10.0
3529,30,3,19,22,3,10.0
3530,30,36,64,100,3,10.0
3531,30,3,7,10,3,10.0
3532,30,9,8,17,3,10.0
3533,30,36,48,84,3,10.0
3534,30,15,29,44,3,10.0
3535,30,36,56,92,3,10.0
3536,30,24,63,87,3,10.0
3537,30,43,88,131,3,10.0
3538,30,32,92,124,3,10.0
3539,30,30,55,85,3,10.0
3540,30,33,45,78,3,10.0
3541,30,30,55,85,3,10.0
3542,30,81,128,209,3,10.0
3543,30,8,21,29,3,10.0
3544,30,20,42,62,3,10.0
3545,30,54,114,168,3,10.0
3546,30,63,76,139,3,10.0
3547,30,19,33,52,3,10.0
3548,30,21,28,49,3,10.0
3549,30,23,32,55,3,10.0
3550,30,9,12,21,3,10.0
3551,30,8,7,15,3,10.0
3552,30,15,22,37,3,10.0
3553,30,15,17,32,3,10.0
3554,30,67,113,180,3,10.0
3555,30,40,66,106,3,10.0
3556,30,57,72,129,3,10.0
3557,30,13,35,48,3,10.0
3558,30,28,57,85,3,10.0
3559,30,11,23,34,3,10.0
3560,30,29,64,93,3,10.0
3561,30,44,54,98,3,10.0
3562,30,18,25,43,3,10.0
3563,30,21,39,60,3,10.0
3564,30,57,85,142,3,10.0
3565,30,36,58,94,3,10.0
3566,30,14,21,35,3,10.0
3567,30,14,23,37,3,10.0
3568,30,0,2,2,3,10.0
3569,30,13,3,16,3,10.0
3570,30,59,70,129,3,10.0
3571,30,51,81,132,3,10.0
3572,30,34,26,60,3,10.0
3573,30,50,62,112,3,10.0
3574,30,16,19,35,3,10.0
3575,30,41,72,113,3,10.0
3576,30,30,60,90,3,10.0
3577,30,17,5,22,3,10.0
3578,30,4,2,6,3,10.0
3579,30,34,24,58,3,10.0
3580,30,9,11,20,3,10.0
3581,30,19,18,37,3,10.0
3582,30,6,5,11,3,10.0
3583,30,2,10,12,3,10.0
3584,30,93,227,320,3,10.0
3585,30,15,47,62,3,10.0
3586,30,49,92,141,3,10.0
3587,30,63,64,127,3,10.0
3588,30,43,100,143,3,10.0
3589,30,29,67,96,3,10.0
3590,30,35,67,102,3,10.0
3591,30,24,67,91,3,10.0
3592,30,7,9,16,3,10.0
3593,30,14,84,98,3,10.0
3594,30,34,63,97,3,10.0
3595,30,25,24,49,3,10.0
3596,30,16,34,50,3,10.0
3597,30,20,24,44,3,10.0
3598,30,18,18,36,3,10.0
3599,30,23,67,90,3,10.0
3600,30,27,8,35,3,10.0
3601,30,18,28,46,3,10.0
3602,30,16,69,85,3,10.0
3603,30,15,38,53,3,10.0
3604,30,42,41,83,3,10.0
3605,30,33,72,105,3,10.0
3606,30,22,39,61,3,10.0
3607,30,14,42,56,3,10.0
3608,30,6,6,12,3,10.0
3609,30,21,50,71,3,10.0
3610,30,18,49,67,3,10.0
3611,30,9,29,38,3,10.0
3612,30,38,47,85,3,10.0
3613,30,33,95,128,3,10.0
3614,30,59,138,197,3,10.0
3615,30,30,83,113,3,10.0
3616,30,10,13,23,3,10.0
3617,30,19,26,45,3,10.0
3618,30,70,86,156,3,10.0
3619,30,60,106,166,3,10.0
3620,30,18,37,55,3,10.0
3621,30,33,30,63,3,10.0
3622,30,2,6,8,3,10.0
3623,30,33,47,80,3,10.0
3624,30,48,60,108,3,10.0
3625,30,47,91,138,3,10.0
3626,30,56,77,133,3,10.0
3627,30,62,102,164,3,10.0
3628,30,35,26,61,3,10.0
3629,30,23,31,54,3,10.0
3630,30,56,72,128,3,10.0
3631,30,4,0,4,3,10.0
3632,30,20,36,56,3,10.0
3633,30,26,30,56,3,10.0
3634,30,7,8,15,3,10.0
3635,30,10,25,35,3,10.0
3636,30,1,2,3,3,10.0
3637,30,4,5,9,3,10.0
3638,30,1,1,2,3,10.0
3639,30,71,110,181,3,10.0
3640,30,25,59,84,3,10.0
3641,30,21,47,68,3,10.0
3642,30,33,47,80,3,10.0
3643,30,17,23,40,3,10.0
3644,30,20,21,41,3,10.0
3645,30,28,41,69,3,10.0
3646,30,26,60,86,3,10.0
3647,30,22,33,55,3,10.0
3648,30,7,5,12,3,10.0
3649,30,14,13,27,3,10.0
3650,30,4,1,5,3,10.0
3651,30,44,65,109,3,10.0
3652,30,49,66,115,3,10.0
3653,30,33,68,101,3,10.0
3654,30,38,94,132,3,10.0
3655,30,46,93,139,3,10.0
3656,30,72,83,155,3,10.0
3657,30,15,31,46,3,10.0
3658,30,17,31,48,3,10.0
3659,30,15,15,30,3,10.0
3660,30,15,13,28,3,10.0
3661,30,36,63,99,3,10.0
3662,30,58,79,137,3,10.0
3663,30,109,197,306,3,10.0
3664,30,45,57,102,3,10.0
3665,30,30,29,59,3,10.0
3666,30,62,73,135,3,10.0
3667,30,32,29,61,3,10.0
3668,30,15,6,21,3,10.0
3669,30,19,16,35,3,10.0
3670,30,9,9,18,3,10.0
3671,30,0,2,2,3,10.0
3672,30,2,1,3,3,10.0
3673,30,27,83,110,3,10.0
3674,30,62,77,139,3,10.0
3675,30,42,39,81,3,10.0
3676,30,27,64,91,3,10.0
3677,30,21,38,59,3,10.0
3678,30,11,31,42,3,10.0
3679,30,43,30,73,3,10.0
3680,30,13,33,46,3,10.0
3681,30,29,58,87,3,10.0
3682,30,14,24,38,3,10.0
3683,30,22,28,50,3,10.0
3684,30,2,9,11,3,10.0
3685,30,16,23,39,3,10.0
3686,30,18,18,36,3,10.0
3687,30,42,83,125,3,10.0
3688,30,6,9,15,3,10.0
3689,30,33,68,101,3,10.0
3690,30,19,33,52,3,10.0
3691,30,33,39,72,3,10.0
3692,30,33,47,80,3,10.0
3693,30,51,96,147,3,10.0
3694,30,51,114,165,3,10.0
3695,30,45,77,122,3,10.0
3696,30,40,98,138,3,10.0
3697,30,56,46,102,3,10.0
3698,30,43,48,91,3,10.0
3699,30,13,16,29,3,10.0
3700,30,11,17,28,3,10.0
3701,30,8,17,25,3,10.0
3702,30,16,22,38,3,10.0
3703,30,32,58,90,3,10.0
3704,30,12,15,27,3,10.0
3705,30,16,31,47,3,10.0
3706,30,15,47,62,3,10.0
3707,30,42,47,89,3,10.0
3708,30,65,97,162,3,10.0
3709,30,20,21,41,3,10.0
3710,30,67,126,193,3,10.0
3711,30,33,51,84,3,10.0
3712,30,12,30,42,3,10.0
3713,30,17,53,70,3,10.0
3714,30,18,30,48,3,10.0
3715,30,5,5,10,3,10.0
3716,30,36,87,123,3,10.0
3717,30,25,37,62,3,10.0
3718,30,37,69,106,3,10.0
3719,30,27,44,71,3,10.0
3720,30,45,34,79,3,10.0
3721,30,14,23,37,3,10.0
3722,30,30,92,122,3,10.0
3723,30,9,46,55,3,10.0
3724,30,8,20,28,3,10.0
3725,30,10,6,16,3,10.0
3726,30,14,10,24,3,10.0
3727,30,24,29,53,3,10.0
3728,30,10,14,24,3,10.0
3729,30,1,3,4,3,10.0
3730,30,5,10,15,3,10.0
3731,50,77,207,284,3,10.0
3732,50,47,116,163,3,10.0
3733,50,41,219,260,3,10.0
3734,50,77,344,421,3,10.0
3735,50,66,302,368,3,10.0
3736,50,54,103,157,3,10.0
3737,50,86,146,232,3,10.0
3738,50,31,35,66,3,10.0
3739,50,66,135,201,3,10.0
3740,50,21,65,86,3,10.0
3741,50,26,105,131,3,10.0
3742,50,74,345,419,3,10.0
3743,50,111,223,334,3,10.0
3744,50,72,241,313,3,10.0
3745,50,119,312,431,3,10.0
3746,50,103,378,481,3,10.0
3747,50,101,280,381,3,10.0
3748,50,36,136,172,3,10.0
3749,50,50,160,210,3,10.0
3750,50,54,155,209,3,10.0
3751,50,114,194,308,3,10.0
3752,50,42,110,152,3,10.0
3753,50,11,25,36,3,10.0
3754,50,102,176,278,3,10.0
3755,50,134,288,422,3,10.0
3756,50,54,109,163,3,10.0
3757,50,22,40,62,3,10.0
3758,50,13,63,76,3,10.0
3759,50,26,98,124,3,10.0
3760,50,20,42,62,3,10.0
3761,50,27,84,111,3,10.0
3762,50,63,81,144,3,10.0
3763,50,17,40,57,3,10.0
3764,50,10,26,36,3,10.0
3765,50,3,3,6,3,10.0
3766,50,15,105,120,3,10.0
3767,50,22,48,70,3,10.0
3768,50,23,74,97,3,10.0
3769,50,33,97,130,3,10.0
3770,50,22,62,84,3,10.0
3771,50,72,151,223,3,10.0
3772,50,23,69,92,3,10.0
3773,50,46,64,110,3,10.0
3774,50,25,63,88,3,10.0
3775,50,7,25,32,3,10.0
3776,50,11,33,44,3,10.0
3777,50,24,36,60,3,10.0
3778,50,3,14,17,3,10.0
3779,50,2,1,3,3,10.0
3780,50,0,5,5,3,10.0
3781,50,53,96,149,3,10.0
3782,50,56,259,315,3,10.0
3783,50,45,185,230,3,10.0
3784,50,101,273,374,3,10.0
3785,50,47,172,219,3,10.0
3786,50,195,331,526,3,10.0
3787,50,36,80,116,3,10.0
3788,50,33,91,124,3,10.0
3789,50,49,83,132,3,10.0
3790,50,21,27,48,3,10.0
3791,50,4,10,14,3,10.0
3792,50,22,46,68,3,10.0
3793,50,55,105,160,3,10.0
3794,50,71,116,187,3,10.0
3795,50,50,75,125,3,10.0
3796,50,38,75,113,3,10.0
3797,50,62,147,209,3,10.0
3798,50,71,125,196,3,10.0
3799,50,31,40,71,3,10.0
3800,50,43,94,137,3,10.0
3801,50,31,75,106,3,10.0
3802,50,10,34,44,3,10.0
3803,50,10,10,20,3,10.0
3804,50,15,20,35,3,10.0
3805,50,14,11,25,3,10.0
3806,50,40,84,124,3,10.0
3807,50,53,119,172,3,10.0
3808,50,42,79,121,3,10.0
3809,50,24,85,109,3,10.0
3810,50,51,125,176,3,10.0
3811,50,92,116,208,3,10.0
3812,50,57,99,156,3,10.0
3813,50,44,147,191,3,10.0
3814,50,66,146,212,3,10.0
3815,50,37,111,148,3,10.0
3816,50,68,145,213,3,10.0
3817,50,81,123,204,3,10.0
3818,50,42,31,73,3,10.0
3819,50,11,22,33,3,10.0
3820,50,53,97,150,3,10.0
3821,50,0,5,5,3,10.0
3822,50,81,122,203,3,10.0
3823,50,11,19,30,3,10.0
3824,50,85,129,214,3,10.0
3825,50,47,93,140,3,10.0
3826,50,49,80,129,3,10.0
3827,50,15,20,35,3,10.0
3828,50,45,102,147,3,10.0
3829,50,20,18,38,3,10.0
3830,50,29,54,83,3,10.0
3831,50,121,167,288,3,10.0
3832,50,86,154,240,3,10.0
3833,50,75,117,192,3,10.0
3834,50,66,161,227,3,10.0
3835,50,47,89,136,3,10.0
3836,50,63,82,145,3,10.0
3837,50,9,18,27,3,10.0
3838,50,12,15,27,3,10.0
3839,50,0,3,3,3,10.0
3840,50,114,224,338,3,10.0
3841,50,30,78,108,3,10.0
3842,50,35,102,137,3,10.0
3843,50,86,143,229,3,10.0
3844,50,48,67,115,3,10.0
3845,50,28,80,108,3,10.0
3846,50,29,104,133,3,10.0
3847,50,44,69,113,3,10.0
3848,50,38,79,117,3,10.0
3849,50,28,37,65,3,10.0
3850,50,19,24,43,3,10.0
3851,50,27,41,68,3,10.0
3852,50,12,12,24,3,10.0
3853,50,3,13,16,3,10.0
3854,50,160,264,424,3,10.0
3855,50,16,38,54,3,10.0
3856,50,95,253,348,3,10.0
3857,50,30,91,121,3,10.0
3858,50,41,87,128,3,10.0
3859,50,33,66,99,3,10.0
3860,50,121,210,331,3,10.0
3861,50,74,93,167,3,10.0
3862,50,54,94,148,3,10.0
3863,50,25,48,73,3,10.0
3864,50,25,47,72,3,10.0
3865,50,20,35,55,3,10.0
3866,50,18,33,51,3,10.0
3867,50,88,174,262,3,10.0
3868,50,43,65,108,3,10.0
3869,50,18,49,67,3,10.0
3870,50,89,173,262,3,10.0
3871,50,36,78,114,3,10.0
3872,50,51,93,144,3,10.0
3873,50,93,156,249,3,10.0
3874,50,69,175,244,3,10.0
3875,50,44,97,141,3,10.0
3876,50,39,37,76,3,10.0
3877,50,35,63,98,3,10.0
3878,50,9,23,32,3,10.0
3879,50,4,13,17,3,10.0
3880,50,42,17,59,3,10.0
3881,50,26,22,48,3,10.0
3882,50,9,30,39,3,10.0
3883,50,93,105,198,3,10.0
3884,50,74,132,206,3,10.0
3885,50,64,97,161,3,10.0
3886,50,33,93,126,3,10.0
3887,50,76,96,172,3,10.0
3888,50,78,103,181,3,10.0
3889,50,39,64,103,3,10.0
3890,50,54,85,139,3,10.0
3891,50,74,115,189,3,10.0
3892,50,38,46,84,3,10.0
3893,50,17,28,45,3,10.0
3894,50,33,31,64,3,10.0
3895,50,43,41,84,3,10.0
3896,50,86,103,189,3,10.0
3897,50,29,66,95,3,10.0
3898,50,5,3,8,3,10.0
3899,50,4,9,13,3,10.0
3900,50,96,136,232,3,10.0
3901,50,91,167,258,3,10.0
3902,50,49,98,147,3,10.0
3903,50,55,100,155,3,10.0
3904,50,57,86,143,3,10.0
3905,50,194,295,489,3,10.0
3906,50,25,63,88,3,10.0
3907,50,104,128,232,3,10.0
3908,50,119,125,244,3,10.0
3909,50,33,57,90,3,10.0
3910,50,28,62,90,3,10.0
3911,50,4,2,6,3,10.0
3912,50,27,55,82,3,10.0
3913,50,47,73,120,3,10.0
3914,50,56,60,116,3,10.0
3915,50,46,85,131,3,10.0
3916,50,139,144,283,3,10.0
3917,50,41,98,139,3,10.0
3918,50,48,52,100,3,10.0
3919,50,14,44,58,3,10.0
3920,50,66,111,177,3,10.0
3921,50,58,85,143,3,10.0
3922,50,5,27,32,3,10.0
3923,50,34,89,123,3,10.0
3924,50,18,33,51,3,10.0
3925,50,4,15,19,3,10.0
3926,50,2,16,18,3,10.0
3927,50,12,60,72,3,10.0
3928,50,106,132,238,3,10.0
3929,50,44,77,121,3,10.0
3930,50,65,57,122,3,10.0
3931,50,56,67,123,3,10.0
3932,50,36,58,94,3,10.0
3933,50,73,106,179,3,10.0
3934,50,21,30,51,3,10.0
3935,50,65,72,137,3,10.0
3936,50,60,115,175,3,10.0
3937,50,23,72,95,3,10.0
3938,50,33,57,90,3,10.0
3939,50,36,64,100,3,10.0
3940,50,41,59,100,3,10.0
3941,50,13,20,33,3,10.0
3942,50,16,31,47,3,10.0
3943,50,8,4,12,3,10.0
3944,50,40,109,149,3,10.0
3945,50,40,51,91,3,10.0
3946,50,46,63,109,3,10.0
3947,50,54,51,105,3,10.0
3948,50,85,88,173,3,10.0
3949,50,53,72,125,3,10.0
3950,50,83,94,177,3,10.0
3951,50,64,139,203,3,10.0
3952,50,41,102,143,3,10.0
3953,50,11,19,30,3,10.0
3954,50,39,44,83,3,10.0
3955,50,13,23,36,3,10.0
3956,50,12,31,43,3,10.0
3957,50,13,29,42,3,10.0
3958,50,28,54,82,3,10.0
3959,50,13,57,70,3,10.0
3960,50,62,90,152,3,10.0
3961,50,43,97,140,3,10.0
3962,50,21,60,81,3,10.0
3963,50,60,67,127,3,10.0
3964,50,96,109,205,3,10.0
3965,50,151,136,287,3,10.0
3966,50,67,79,146,3,10.0
3967,50,47,69,116,3,10.0
3968,50,88,117,205,3,10.0
3969,50,74,123,197,3,10.0
3970,50,40,90,130,3,10.0
3971,50,52,93,145,3,10.0
3972,50,35,47,82,3,10.0
3973,50,15,17,32,3,10.0
3974,50,48,91,139,3,10.0
3975,50,26,42,68,3,10.0
3976,50,25,32,57,3,10.0
3977,50,72,113,185,3,10.0
3978,50,66,134,200,3,10.0
3979,50,113,232,345,3,10.0
3980,50,30,67,97,3,10.0
3981,50,137,104,241,3,10.0
3982,50,70,116,186,3,10.0
3983,50,73,94,167,3,10.0
3984,50,18,48,66,3,10.0
3985,50,53,119,172,3,10.0
3986,50,32,63,95,3,10.0
3987,50,40,67,107,3,10.0
3988,50,2,20,22,3,10.0
3989,50,29,25,54,3,10.0
3990,50,50,96,146,3,10.0
3991,50,99,115,214,3,10.0
3992,50,28,13,41,3,10.0
3993,50,64,165,229,3,10.0
3994,50,78,178,256,3,10.0
3995,50,86,117,203,3,10.0
3996,50,61,100,161,3,10.0
3997,50,108,116,224,3,10.0
3998,50,56,87,143,3,10.0
3999,50,28,64,92,3,10.0
4000,50,45,98,143,3,10.0
4001,50,21,38,59,3,10.0
4002,50,33,55,88,3,10.0
4003,50,50,35,85,3,10.0
4004,50,72,124,196,3,10.0
4005,50,89,136,225,3,10.0
4006,50,70,113,183,3,10.0
4007,50,28,74,102,3,10.0
4008,50,39,103,142,3,10.0
4009,50,89,162,251,3,10.0
4010,50,43,55,98,3,10.0
4011,50,62,75,137,3,10.0
4012,50,63,122,185,3,10.0
4013,50,104,218,322,3,10.0
4014,50,55,105,160,3,10.0
4015,50,19,77,96,3,10.0
4016,50,31,71,102,3,10.0
4017,50,64,67,131,3,10.0
4018,50,30,55,85,3,10.0
4019,50,39,139,178,3,10.0
4020,50,18,12,30,3,10.0
4021,75,10,9,19,3,10.0
4022,75,37,92,129,3,10.0
4023,75,47,96,143,3,10.0
4024,75,38,88,126,3,10.0
4025,75,31,67,98,3,10.0
4026,75,45,68,113,3,10.0
4027,75,51,74,125,3,10.0
4028,75,88,170,258,3,10.0
4029,75,40,53,93,3,10.0
4030,75,25,59,84,3,10.0
4031,75,14,40,54,3,10.0
4032,75,16,24,40,3,10.0
4033,75,10,11,21,3,10.0
4034,75,27,49,76,3,10.0
4035,75,40,43,83,3,10.0
4036,75,41,82,123,3,10.0
4037,75,44,78,122,3,10.0
4038,75,47,80,127,3,10.0
4039,75,58,103,161,3,10.0
4040,75,98,132,230,3,10.0
4041,75,48,55,103,3,10.0
4042,75,8,24,32,3,10.0
4043,75,56,115,171,3,10.0
4044,75,19,111,130,3,10.0
4045,75,18,12,30,3,10.0
4046,75,21,45,66,3,10.0
4047,75,29,67,96,3,10.0
4048,75,2,25,27,3,10.0
4049,75,8,18,26,3,10.0
4050,75,4,11,15,3,10.0
4051,75,1,1,2,3,10.0
4052,75,37,77,114,3,10.0
4053,75,36,20,56,3,10.0
4054,75,79,101,180,3,10.0
4055,75,137,177,314,3,10.0
4056,75,30,60,90,3,10.0
4057,75,27,50,77,3,10.0
4058,75,27,42,69,3,10.0
4059,75,81,141,222,3,10.0
4060,75,60,51,111,3,10.0
4061,75,69,91,160,3,10.0
4062,75,12,19,31,3,10.0
4063,75,7,22,29,3,10.0
4064,75,24,51,75,3,10.0
4065,75,4,9,13,3,10.0
4066,75,5,12,17,3,10.0
4067,75,11,8,19,3,10.0
4068,75,6,4,10,3,10.0
4069,75,3,0,3,3,10.0
4070,75,5,1,6,3,10.0
4071,75,43,93,136,3,10.0
4072,75,19,37,56,3,10.0
4073,75,17,52,69,3,10.0
4074,75,46,55,101,3,10.0
4075,75,13,19,32,3,10.0
4076,75,33,77,110,3,10.0
4077,75,76,128,204,3,10.0
4078,75,47,95,142,3,10.0
4079,75,48,91,139,3,10.0
4080,75,39,90,129,3,10.0
4081,75,22,28,50,3,10.0
4082,75,10,11,21,3,10.0
4083,75,2,2,4,3,10.0
4084,75,3,3,6,3,10.0
4085,75,60,98,158,3,10.0
4086,75,38,67,105,3,10.0
4087,75,40,95,135,3,10.0
4088,75,94,155,249,3,10.0
4089,75,80,161,241,3,10.0
4090,75,61,148,209,3,10.0
4091,75,96,130,226,3,10.0
4092,75,52,48,100,3,10.0
4093,75,79,162,241,3,10.0
4094,75,88,146,234,3,10.0
4095,75,41,73,114,3,10.0
4096,75,38,55,93,3,10.0
4097,75,26,56,82,3,10.0
4098,75,9,52,61,3,10.0
4099,75,92,166,258,3,10.0
4100,75,23,50,73,3,10.0
4101,75,33,57,90,3,10.0
4102,75,45,98,143,3,10.0
4103,75,49,113,162,3,10.0
4104,75,56,140,196,3,10.0
4105,75,58,80,138,3,10.0
4106,75,39,118,157,3,10.0
4107,75,25,71,96,3,10.0
4108,75,49,72,121,3,10.0
4109,75,14,23,37,3,10.0
4110,75,47,54,101,3,10.0
4111,75,6,0,6,3,10.0
4112,75,31,46,77,3,10.0
4113,75,17,29,46,3,10.0
4114,75,33,81,114,3,10.0
4115,75,40,49,89,3,10.0
4116,75,97,163,260,3,10.0
4117,75,34,69,103,3,10.0
4118,75,69,123,192,3,10.0
4119,75,28,52,80,3,10.0
4120,75,50,74,124,3,10.0
4121,75,29,58,87,3,10.0
4122,75,42,97,139,3,10.0
4123,75,18,22,40,3,10.0
4124,75,20,19,39,3,10.0
4125,75,7,16,23,3,10.0
4126,75,6,5,11,3,10.0
4127,75,6,8,14,3,10.0
4128,75,2,2,4,3,10.0
4129,75,36,104,140,3,10.0
4130,75,55,96,151,3,10.0
4131,75,43,55,98,3,10.0
4132,75,54,130,184,3,10.0
4133,75,66,124,190,3,10.0
4134,75,29,81,110,3,10.0
4135,75,52,109,161,3,10.0
4136,75,90,179,269,3,10.0
4137,75,42,75,117,3,10.0
4138,75,62,87,149,3,10.0
4139,75,58,134,192,3,10.0
4140,75,6,12,18,3,10.0
4141,75,52,133,185,3,10.0
4142,75,17,51,68,3,10.0
4143,75,16,32,48,3,10.0
4144,75,94,162,256,3,10.0
4145,75,46,59,105,3,10.0
4146,75,41,80,121,3,10.0
4147,75,81,102,183,3,10.0
4148,75,51,87,138,3,10.0
4149,75,59,57,116,3,10.0
4150,75,45,69,114,3,10.0
4151,75,81,159,240,3,10.0
4152,75,27,56,83,3,10.0
4153,75,28,57,85,3,10.0
4154,75,27,56,83,3,10.0
4155,75,27,43,70,3,10.0
4156,75,68,126,194,3,10.0
4157,75,34,92,126,3,10.0
4158,75,19,27,46,3,10.0
4159,75,42,175,217,3,10.0
4160,75,68,144,212,3,10.0
4161,75,8,7,15,3,10.0
4162,75,62,60,122,3,10.0
4163,75,45,40,85,3,10.0
4164,75,93,166,259,3,10.0
4165,75,118,205,323,3,10.0
4166,75,12,20,32,3,10.0
4167,75,43,97,140,3,10.0
4168,75,21,24,45,3,10.0
4169,75,7,14,21,3,10.0
4170,75,5,2,7,3,10.0
4171,75,101,172,273,3,10.0
4172,75,49,109,158,3,10.0
4173,75,11,42,53,3,10.0
4174,75,47,83,130,3,10.0
4175,75,81,193,274,3,10.0
4176,75,108,185,293,3,10.0
4177,75,43,25,68,3,10.0
4178,75,43,56,99,3,10.0
4179,75,75,110,185,3,10.0
4180,75,51,137,188,3,10.0
4181,75,78,122,200,3,10.0
4182,75,54,64,118,3,10.0
4183,75,26,55,81,3,10.0
4184,75,94,128,222,3,10.0
4185,75,20,28,48,3,10.0
4186,75,23,50,73,3,10.0
4187,75,15,18,33,3,10.0
4188,75,25,57,82,3,10.0
4189,75,42,41,83,3,10.0
4190,75,90,145,235,3,10.0
4191,75,11,32,43,3,10.0
4192,75,58,97,155,3,10.0
4193,75,40,56,96,3,10.0
4194,75,26,47,73,3,10.0
4195,75,103,179,282,3,10.0
4196,75,18,41,59,3,10.0
4197,75,7,15,22,3,10.0
4198,75,55,92,147,3,10.0
4199,75,10,24,34,3,10.0
4200,75,6,14,20,3,10.0
4201,75,8,22,30,3,10.0
4202,75,5,13,18,3,10.0
4203,75,11,7,18,3,10.0
4204,75,0,14,14,3,10.0
4205,75,35,70,105,3,10.0
4206,75,21,124,145,3,10.0
4207,75,75,131,206,3,10.0
4208,75,23,48,71,3,10.0
4209,75,123,234,357,3,10.0
4210,75,17,23,40,3,10.0
4211,75,26,39,65,3,10.0
4212,75,46,85,131,3,10.0
4213,75,6,28,34,3,10.0
4214,75,14,37,51,3,10.0
4215,75,19,26,45,3,10.0
4216,75,25,15,40,3,10.0
4217,75,13,22,35,3,10.0
4218,75,3,5,8,3,10.0
4219,75,22,47,69,3,10.0
4220,75,77,105,182,3,10.0
4221,75,31,35,66,3,10.0
4222,75,41,93,134,3,10.0
4223,75,60,94,154,3,10.0
4224,75,29,82,111,3,10.0
4225,75,80,107,187,3,10.0
4226,75,45,108,153,3,10.0
4227,75,8,13,21,3,10.0
4228,75,31,81,112,3,10.0
4229,75,63,88,151,3,10.0
4230,75,9,22,31,3,10.0
4231,75,56,85,141,3,10.0
4232,75,5,16,21,3,10.0
4233,75,1,7,8,3,10.0
4234,75,2,15,17,3,10.0
4235,75,39,76,115,3,10.0
4236,75,29,47,76,3,10.0
4237,75,41,39,80,3,10.0
4238,75,42,43,85,3,10.0
4239,75,22,22,44,3,10.0
4240,75,21,40,61,3,10.0
4241,75,25,52,77,3,10.0
4242,75,17,37,54,3,10.0
4243,75,9,13,22,3,10.0
4244,75,3,0,3,3,10.0
4245,75,5,8,13,3,10.0
4246,75,4,0,4,3,10.0
4247,75,4,2,6,3,10.0
4248,75,4,2,6,3,10.0
4249,75,0,0,0,3,10.0
4250,75,1,3,4,3,10.0
4251,75,0,0,0,3,10.0
4252,75,54,154,208,3,10.0
4253,75,35,55,90,3,10.0
4254,75,16,46,62,3,10.0
4255,75,21,28,49,3,10.0
4256,75,26,64,90,3,10.0
4257,75,51,67,118,3,10.0
4258,75,41,194,235,3,10.0
4259,75,47,84,131,3,10.0
4260,75,64,37,101,3,10.0
4261,75,78,126,204,3,10.0
4262,75,35,47,82,3,10.0
4263,75,21,34,55,3,10.0
4264,75,9,18,27,3,10.0
4265,75,7,15,22,3,10.0
4266,75,6,9,15,3,10.0
4267,75,52,120,172,3,10.0
4268,75,13,19,32,3,10.0
4269,75,31,60,91,3,10.0
4270,75,25,64,89,3,10.0
4271,75,33,69,102,3,10.0
4272,75,34,99,133,3,10.0
4273,75,27,65,92,3,10.0
4274,75,39,97,136,3,10.0
4275,75,12,35,47,3,10.0
4276,75,14,25,39,3,10.0
4277,75,19,23,42,3,10.0
4278,75,8,13,21,3,10.0
4279,75,6,8,14,3,10.0
4280,75,12,28,40,3,10.0
4281,75,8,24,32,3,10.0
4282,75,47,109,156,3,10.0
4283,75,24,12,36,3,10.0
4284,75,29,39,68,3,10.0
4285,75,49,158,207,3,10.0
4286,75,37,44,81,3,10.0
4287,75,46,105,151,3,10.0
4288,75,26,61,87,3,10.0
4289,75,56,110,166,3,10.0
4290,75,22,9,31,3,10.0
4291,75,15,16,31,3,10.0
4292,75,8,34,42,3,10.0
4293,75,5,19,24,3,10.0
4294,75,7,11,18,3,10.0
4295,75,0,2,2,3,10.0
4296,75,2,2,4,3,10.0
4297,75,15,53,68,3,10.0
4298,75,52,146,198,3,10.0
4299,75,53,124,177,3,10.0
4300,75,59,198,257,3,10.0
4301,75,17,22,39,3,10.0
4302,75,95,173,268,3,10.0
4303,75,91,194,285,3,10.0
4304,75,26,20,46,3,10.0
4305,75,27,64,91,3,10.0
4306,75,53,99,152,3,10.0
4307,75,26,52,78,3,10.0
4308,75,14,41,55,3,10.0
4309,75,2,9,11,3,10.0
4310,75,14,26,40,3,10.0
4311,75,54,46,100,3,10.0
4312,75,10,43,53,3,10.0
4313,75,22,12,34,3,10.0
4314,75,25,53,78,3,10.0
4315,75,8,26,34,3,10.0
4316,75,58,62,120,3,10.0
4317,75,103,214,317,3,10.0
4318,75,26,40,66,3,10.0
4319,75,11,5,16,3,10.0
4320,75,18,25,43,3,10.0
4321,75,19,64,83,3,10.0
4322,75,88,102,190,3,10.0
4323,75,51,96,147,3,10.0
4324,75,4,8,12,3,10.0
4325,75,11,17,28,3,10.0
4326,75,3,2,5,3,10.0
4327,90,84,172,256,3,10.0
4328,90,128,237,365,3,10.0
4329,90,49,75,124,3,10.0
4330,90,8,23,31,3,10.0
4331,90,46,80,126,3,10.0
4332,90,74,110,184,3,10.0
4333,90,75,222,297,3,10.0
4334,90,32,56,88,3,10.0
4335,90,62,153,215,3,10.0
4336,90,94,192,286,3,10.0
4337,90,24,33,57,3,10.0
4338,90,50,107,157,3,10.0
4339,90,18,50,68,3,10.0
4340,90,29,58,87,3,10.0
4341,90,24,32,56,3,10.0
4342,90,4,5,9,3,10.0
4343,90,37,40,77,3,10.0
4344,90,37,84,121,3,10.0
4345,90,32,99,131,3,10.0
4346,90,22,81,103,3,10.0
4347,90,33,108,141,3,10.0
4348,90,40,89,129,3,10.0
4349,90,66,95,161,3,10.0
4350,90,35,83,118,3,10.0
4351,90,68,105,173,3,10.0
4352,90,68,107,175,3,10.0
4353,90,33,80,113,3,10.0
4354,90,52,126,178,3,10.0
4355,90,16,23,39,3,10.0
4356,90,28,42,70,3,10.0
4357,90,6,22,28,3,10.0
4358,90,11,20,31,3,10.0
4359,90,29,55,84,3,10.0
4360,90,52,78,130,3,10.0
4361,90,48,44,92,3,10.0
4362,90,49,135,184,3,10.0
4363,90,15,42,57,3,10.0
4364,90,130,175,305,3,10.0
4365,90,25,59,84,3,10.0
4366,90,50,141,191,3,10.0
4367,90,95,108,203,3,10.0
4368,90,39,91,130,3,10.0
4369,90,67,111,178,3,10.0
4370,90,16,23,39,3,10.0
4371,90,11,16,27,3,10.0
4372,90,2,2,4,3,10.0
4373,90,34,81,115,3,10.0
4374,90,91,69,160,3,10.0
4375,90,39,97,136,3,10.0
4376,90,108,225,333,3,10.0
4377,90,26,75,101,3,10.0
4378,90,59,48,107,3,10.0
4379,90,73,180,253,3,10.0
4380,90,101,175,276,3,10.0
4381,90,20,46,66,3,10.0
4382,90,96,136,232,3,10.0
4383,90,10,22,32,3,10.0
4384,90,58,32,90,3,10.0
4385,90,37,43,80,3,10.0
4386,90,9,16,25,3,10.0
4387,90,42,76,118,3,10.0
4388,90,39,55,94,3,10.0
4389,90,61,96,157,3,10.0
4390,90,32,92,124,3,10.0
4391,90,57,147,204,3,10.0
4392,90,48,66,114,3,10.0
4393,90,67,163,230,3,10.0
4394,90,43,58,101,3,10.0
4395,90,59,57,116,3,10.0
4396,90,29,51,80,3,10.0
4397,90,26,42,68,3,10.0
4398,90,17,26,43,3,10.0
4399,90,22,15,37,3,10.0
4400,90,21,36,57,3,10.0
4401,90,27,45,72,3,10.0
4402,90,69,112,181,3,10.0
4403,90,68,84,152,3,10.0
4404,90,77,113,190,3,10.0
4405,90,51,133,184,3,10.0
4406,90,60,140,200,3,10.0
4407,90,107,167,274,3,10.0
4408,90,54,88,142,3,10.0
4409,90,41,105,146,3,10.0
4410,90,26,53,79,3,10.0
4411,90,72,142,214,3,10.0
4412,90,46,46,92,3,10.0
4413,90,29,71,100,3,10.0
4414,90,14,10,24,3,10.0
4415,90,29,71,100,3,10.0
4416,90,22,52,74,3,10.0
4417,90,71,185,256,3,10.0
4418,90,21,43,64,3,10.0
4419,90,32,66,98,3,10.0
4420,90,17,49,66,3,10.0
4421,90,21,76,97,3,10.0
4422,90,78,123,201,3,10.0
4423,90,74,192,266,3,10.0
4424,90,48,117,165,3,10.0
4425,90,68,94,162,3,10.0
4426,90,11,26,37,3,10.0
4427,90,10,41,51,3,10.0
4428,90,7,3,10,3,10.0
4429,90,76,179,255,3,10.0
4430,90,102,123,225,3,10.0
4431,90,44,165,209,3,10.0
4432,90,48,107,155,3,10.0
4433,90,57,63,120,3,10.0
4434,90,27,79,106,3,10.0
4435,90,43,86,129,3,10.0
4436,90,33,67,100,3,10.0
4437,90,26,55,81,3,10.0
4438,90,10,54,64,3,10.0
4439,90,50,76,126,3,10.0
4440,90,30,91,121,3,10.0
4441,90,79,126,205,3,10.0
4442,90,46,91,137,3,10.0
4443,90,60,123,183,3,10.0
4444,90,31,38,69,3,10.0
4445,90,28,103,131,3,10.0
4446,90,72,144,216,3,10.0
4447,90,48,64,112,3,10.0
4448,90,75,118,193,3,10.0
4449,90,25,55,80,3,10.0
4450,90,24,39,63,3,10.0
4451,90,20,54,74,3,10.0
4452,90,33,88,121,3,10.0
4453,90,3,32,35,3,10.0
4454,90,27,68,95,3,10.0
4455,90,18,31,49,3,10.0
4456,90,5,19,24,3,10.0
4457,90,40,42,82,3,10.0
4458,90,70,73,143,3,10.0
4459,90,32,99,131,3,10.0
4460,90,25,66,91,3,10.0
4461,90,49,126,175,3,10.0
4462,90,122,204,326,3,10.0
4463,90,37,134,171,3,10.0
4464,90,54,98,152,3,10.0
4465,90,42,143,185,3,10.0
4466,90,44,90,134,3,10.0
4467,90,17,30,47,3,10.0
4468,90,66,107,173,3,10.0
4469,90,13,53,66,3,10.0
4470,90,25,59,84,3,10.0
4471,90,19,36,55,3,10.0
4472,90,5,11,16,3,10.0
4473,90,34,115,149,3,10.0
4474,90,16,73,89,3,10.0
4475,90,39,64,103,3,10.0
4476,90,53,95,148,3,10.0
4477,90,83,202,285,3,10.0
4478,90,58,58,116,3,10.0
4479,90,29,90,119,3,10.0
4480,90,24,61,85,3,10.0
4481,90,59,82,141,3,10.0
4482,90,29,57,86,3,10.0
4483,90,34,46,80,3,10.0
4484,90,7,29,36,3,10.0
4485,90,43,53,96,3,10.0
4486,90,76,64,140,3,10.0
4487,90,39,28,67,3,10.0
4488,90,104,142,246,3,10.0
4489,90,37,56,93,3,10.0
4490,90,95,107,202,3,10.0
4491,90,68,119,187,3,10.0
4492,90,55,134,189,3,10.0
4493,90,114,174,288,3,10.0
4494,90,175,277,452,3,10.0
4495,90,48,73,121,3,10.0
4496,90,143,209,352,3,10.0
4497,90,151,159,310,3,10.0
4498,90,97,145,242,3,10.0
4499,90,18,20,38,3,10.0
4500,90,9,32,41,3,10.0
4501,90,10,10,20,3,10.0
4502,90,52,154,206,3,10.0
4503,90,62,74,136,3,10.0
4504,90,111,194,305,3,10.0
4505,90,75,177,252,3,10.0
4506,90,52,104,156,3,10.0
4507,90,89,156,245,3,10.0
4508,90,53,137,190,3,10.0
4509,90,30,85,115,3,10.0
4510,90,45,139,184,3,10.0
4511,90,57,114,171,3,10.0
4512,90,6,18,24,3,10.0
4513,90,28,97,125,3,10.0
4514,90,74,149,223,3,10.0
4515,90,85,146,231,3,10.0
4516,90,18,51,69,3,10.0
4517,90,39,81,120,3,10.0
4518,90,71,188,259,3,10.0
4519,90,40,123,163,3,10.0
4520,90,63,128,191,3,10.0
4521,90,116,242,358,3,10.0
4522,90,20,29,49,3,10.0
4523,90,53,57,110,3,10.0
4524,90,106,85,191,3,10.0
4525,90,69,212,281,3,10.0
4526,90,39,34,73,3,10.0
4527,90,44,113,157,3,10.0
4528,90,13,18,31,3,10.0
4529,90,10,26,36,3,10.0
4530,90,103,237,340,3,10.0
4531,90,71,81,152,3,10.0
4532,90,135,225,360,3,10.0
4533,90,70,221,291,3,10.0
4534,90,76,122,198,3,10.0
4535,90,80,78,158,3,10.0
4536,90,61,185,246,3,10.0
4537,90,26,73,99,3,10.0
4538,90,27,52,79,3,10.0
4539,90,86,94,180,3,10.0
4540,90,23,60,83,3,10.0
4541,90,12,21,33,3,10.0
4542,90,26,32,58,3,10.0
4543,90,29,35,64,3,10.0
4544,90,4,12,16,3,10.0
4545,90,58,102,160,3,10.0
4546,90,56,118,174,3,10.0
4547,90,11,41,52,3,10.0
4548,90,70,108,178,3,10.0
4549,90,90,157,247,3,10.0
4550,90,91,234,325,3,10.0
4551,90,49,88,137,3,10.0
4552,90,112,175,287,3,10.0
4553,90,79,156,235,3,10.0
4554,90,83,107,190,3,10.0
4555,90,73,131,204,3,10.0
4556,90,55,70,125,3,10.0
4557,90,5,14,19,3,10.0
4558,90,1,2,3,3,10.0
4559,90,73,64,137,3,10.0
4560,90,69,40,109,3,10.0
4561,90,67,51,118,3,10.0
4562,90,34,79,113,3,10.0
4563,90,95,86,181,3,10.0
4564,90,19,10,29,3,10.0
4565,90,40,96,136,3,10.0
4566,90,15,13,28,3,10.0
4567,90,85,145,230,3,10.0
4568,90,22,27,49,3,10.0
4569,90,83,176,259,3,10.0
4570,90,48,96,144,3,10.0
4571,90,53,108,161,3,10.0
4572,90,46,49,95,3,10.0
4573,90,53,75,128,3,10.0
4574,90,58,68,126,3,10.0
4575,90,73,135,208,3,10.0
4576,90,37,74,111,3,10.0
4577,90,11,17,28,3,10.0
4578,90,2,4,6,3,10.0
4579,90,14,20,34,3,10.0
4580,90,26,43,69,3,10.0
4581,90,15,15,30,3,10.0
4582,90,44,69,113,3,10.0
4583,90,83,122,205,3,10.0
4584,90,71,83,154,3,10.0
4585,90,55,103,158,3,10.0
4586,90,45,165,210,3,10.0
4587,90,67,151,218,3,10.0
4588,90,10,41,51,3,10.0
4589,90,41,67,108,3,10.0
4590,90,31,31,62,3,10.0
4591,90,10,24,34,3,10.0
4592,90,17,47,64,3,10.0
4593,120,36,32,68,3,10.0
4594,120,40,53,93,3,10.0
4595,120,59,97,156,3,10.0
4596,120,64,94,158,3,10.0
4597,120,35,78,113,3,10.0
4598,120,89,150,239,3,10.0
4599,120,66,82,148,3,10.0
4600,120,94,132,226,3,10.0
4601,120,24,36,60,3,10.0
4602,120,50,80,130,3,10.0
4603,120,62,83,145,3,10.0
4604,120,20,54,74,3,10.0
4605,120,66,74,140,3,10.0
4606,120,11,32,43,3,10.0
4607,120,6,22,28,3,10.0
4608,120,14,24,38,3,10.0
4609,120,35,84,119,3,10.0
4610,120,11,47,58,3,10.0
4611,120,30,48,78,3,10.0
4612,120,70,126,196,3,10.0
4613,120,58,66,124,3,10.0
4614,120,68,78,146,3,10.0
4615,120,42,56,98,3,10.0
4616,120,36,54,90,3,10.0
4617,120,41,59,100,3,10.0
4618,120,92,98,190,3,10.0
4619,120,17,39,56,3,10.0
4620,120,42,86,128,3,10.0
4621,120,19,91,110,3,10.0
4622,120,36,63,99,3,10.0
4623,120,3,3,6,3,10.0
4624,120,30,81,111,3,10.0
4625,120,102,129,231,3,10.0
4626,120,39,77,116,3,10.0
4627,120,36,70,106,3,10.0
4628,120,106,129,235,3,10.0
4629,120,102,147,249,3,10.0
4630,120,157,224,381,3,10.0
4631,120,31,33,64,3,10.0
4632,120,27,66,93,3,10.0
4633,120,40,116,156,3,10.0
4634,120,207,238,445,3,10.0
4635,120,42,95,137,3,10.0
4636,120,4,31,35,3,10.0
4637,120,55,119,174,3,10.0
4638,120,22,49,71,3,10.0
4639,120,24,21,45,3,10.0
4640,120,9,15,24,3,10.0
4641,120,44,44,88,3,10.0
4642,120,22,45,67,3,10.0
4643,120,12,18,30,3,10.0
4644,120,83,125,208,3,10.0
4645,120,10,35,45,3,10.0
4646,120,60,32,92,3,10.0
4647,120,74,77,151,3,10.0
4648,120,30,43,73,3,10.0
4649,120,119,181,300,3,10.0
4650,120,44,108,152,3,10.0
4651,120,128,236,364,3,10.0
4652,120,29,53,82,3,10.0
4653,120,41,68,109,3,10.0
4654,120,36,64,100,3,10.0
4655,120,52,108,160,3,10.0
4656,120,26,73,99,3,10.0
4657,120,20,60,80,3,10.0
4658,120,39,126,165,3,10.0
4659,120,49,63,112,3,10.0
4660,120,10,30,40,3,10.0
4661,120,12,23,35,3,10.0
4662,120,19,32,51,3,10.0
4663,120,7,48,55,3,10.0
4664,120,34,67,101,3,10.0
4665,120,63,50,113,3,10.0
4666,120,97,153,250,3,10.0
4667,120,95,192,287,3,10.0
4668,120,102,148,250,3,10.0
4669,120,54,50,104,3,10.0
4670,120,99,163,262,3,10.0
4671,120,78,81,159,3,10.0
4672,120,124,63,187,3,10.0
4673,120,85,111,196,3,10.0
4674,120,75,131,206,3,10.0
4675,120,30,67,97,3,10.0
4676,120,56,56,112,3,10.0
4677,120,86,129,215,3,10.0
4678,120,11,32,43,3,10.0
4679,120,9,27,36,3,10.0
4680,120,25,23,48,3,10.0
4681,120,14,8,22,3,10.0
4682,120,34,99,133,3,10.0
4683,120,127,146,273,3,10.0
4684,120,76,79,155,3,10.0
4685,120,117,94,211,3,10.0
4686,120,12,11,23,3,10.0
4687,120,41,29,70,3,10.0
4688,120,64,56,120,3,10.0
4689,120,25,29,54,3,10.0
4690,120,14,25,39,3,10.0
4691,120,29,37,66,3,10.0
4692,120,8,31,39,3,10.0
4693,120,31,54,85,3,10.0
4694,120,77,154,231,3,10.0
4695,120,32,68,100,3,10.0
4696,120,92,122,214,3,10.0
4697,120,46,86,132,3,10.0
4698,120,112,181,293,3,10.0
4699,120,73,117,190,3,10.0
4700,120,70,97,167,3,10.0
4701,120,73,94,167,3,10.0
4702,120,37,45,82,3,10.0
4703,120,11,33,44,3,10.0
4704,120,90,90,180,3,10.0
4705,120,29,32,61,3,10.0
4706,120,42,71,113,3,10.0
4707,120,5,12,17,3,10.0
4708,120,5,3,8,3,10.0
4709,120,68,81,149,3,10.0
4710,120,17,29,46,3,10.0
4711,120,77,174,251,3,10.0
4712,120,70,104,174,3,10.0
4713,120,66,110,176,3,10.0
4714,120,39,73,112,3,10.0
4715,120,39,62,101,3,10.0
4716,120,22,37,59,3,10.0
4717,120,15,17,32,3,10.0
4718,120,16,5,21,3,10.0
4719,120,102,137,239,3,10.0
4720,120,72,97,169,3,10.0
4721,120,45,19,64,3,10.0
4722,120,17,54,71,3,10.0
4723,120,12,6,18,3,10.0
4724,120,7,9,16,3,10.0
4725,120,41,87,128,3,10.0
4726,120,44,64,108,3,10.0
4727,120,32,72,104,3,10.0
4728,120,48,148,196,3,10.0
4729,120,25,56,81,3,10.0
4730,120,128,254,382,3,10.0
4731,120,109,174,283,3,10.0
4732,120,96,79,175,3,10.0
4733,120,45,93,138,3,10.0
4734,120,20,58,78,3,10.0
4735,120,44,87,131,3,10.0
4736,120,47,90,137,3,10.0
4737,120,32,51,83,3,10.0
4738,120,23,29,52,3,10.0
4739,120,119,219,338,3,10.0
4740,120,44,20,64,3,10.0
4741,120,106,197,303,3,10.0
4742,120,8,54,62,3,10.0
4743,120,35,66,101,3,10.0
4744,120,55,109,164,3,10.0
4745,120,57,155,212,3,10.0
4746,120,87,158,245,3,10.0
4747,120,55,103,158,3,10.0
4748,120,98,156,254,3,10.0
4749,120,32,100,132,3,10.0
4750,120,26,52,78,3,10.0
4751,120,53,92,145,3,10.0
4752,120,67,139,206,3,10.0
4753,120,20,57,77,3,10.0
4754,120,34,41,75,3,10.0
4755,120,12,14,26,3,10.0
4756,120,10,18,28,3,10.0
4757,120,6,14,20,3,10.0
4758,120,9,10,19,3,10.0
4759,120,47,21,68,3,10.0
4760,120,84,105,189,3,10.0
4761,120,95,93,188,3,10.0
4762,120,37,53,90,3,10.0
4763,120,61,70,131,3,10.0
4764,120,35,51,86,3,10.0
4765,120,201,246,447,3,10.0
4766,120,35,44,79,3,10.0
4767,120,140,152,292,3,10.0
4768,120,22,66,88,3,10.0
4769,120,39,77,116,3,10.0
4770,120,54,52,106,3,10.0
4771,120,42,80,122,3,10.0
4772,120,99,117,216,3,10.0
4773,120,17,43,60,3,10.0
4774,120,40,52,92,3,10.0
4775,120,27,110,137,3,10.0
4776,120,28,45,73,3,10.0
4777,120,49,97,146,3,10.0
4778,120,12,34,46,3,10.0
4779,120,0,4,4,3,10.0
4780,120,45,21,66,3,10.0
4781,120,25,36,61,3,10.0
4782,120,279,125,404,3,10.0
4783,120,118,101,219,3,10.0
4784,120,34,92,126,3,10.0
4785,120,69,112,181,3,10.0
4786,120,237,185,422,3,10.0
4787,120,115,153,268,3,10.0
4788,120,29,88,117,3,10.0
4789,120,50,93,143,3,10.0
4790,120,43,58,101,3,10.0
4791,120,15,15,30,3,10.0
4792,120,62,95,157,3,10.0
4793,120,9,20,29,3,10.0
4794,120,16,32,48,3,10.0
4795,120,0,10,10,3,10.0
4796,120,24,11,35,3,10.0
4797,120,52,111,163,3,10.0
4798,120,53,114,167,3,10.0
4799,120,77,188,265,3,10.0
4800,120,79,195,274,3,10.0
4801,120,133,236,369,3,10.0
4802,120,72,117,189,3,10.0
4803,120,139,180,319,3,10.0
4804,120,54,72,126,3,10.0
4805,120,25,50,75,3,10.0
4806,120,49,72,121,3,10.0
4807,120,37,35,72,3,10.0
4808,120,31,56,87,3,10.0
4809,120,40,71,111,3,10.0
4810,120,16,16,32,3,10.0
4811,120,38,92,130,3,10.0
4812,120,17,57,74,3,10.0
4813,120,70,150,220,3,10.0
4814,120,101,180,281,3,10.0
4815,120,45,65,110,3,10.0
4816,120,87,199,286,3,10.0
4817,120,52,161,213,3,10.0
4818,120,33,115,148,3,10.0
4819,120,30,60,90,3,10.0
4820,120,38,44,82,3,10.0
4821,120,33,69,102,3,10.0
4822,120,52,119,171,3,10.0
4823,120,38,26,64,3,10.0
4824,120,23,42,65,3,10.0
4825,120,12,37,49,3,10.0
4826,120,28,41,69,3,10.0
4827,120,27,24,51,3,10.0
4828,120,100,219,319,3,10.0
4829,120,41,107,148,3,10.0
4830,120,46,87,133,3,10.0
4831,120,72,195,267,3,10.0
4832,120,64,134,198,3,10.0
4833,120,79,139,218,3,10.0
4834,120,62,123,185,3,10.0
4835,120,112,210,322,3,10.0
4836,120,70,99,169,3,10.0
4837,120,31,102,133,3,10.0
4838,120,10,50,60,3,10.0
4839,120,76,86,162,3,10.0
4840,120,16,16,32,3,10.0
4841,120,7,14,21,3,10.0
4842,120,122,220,342,3,10.0
4843,120,20,64,84,3,10.0
4844,120,55,142,197,3,10.0
4845,120,148,281,429,3,10.0
4846,120,59,169,228,3,10.0
4847,120,73,172,245,3,10.0
4848,120,38,147,185,3,10.0
4849,120,87,142,229,3,10.0
4850,120,91,67,158,3,10.0
4851,120,27,81,108,3,10.0
4852,120,50,73,123,3,10.0
4853,120,17,34,51,3,10.0
4854,120,11,41,52,3,10.0
4855,120,25,33,58,3,10.0
4856,120,4,17,21,3,10.0
4857,120,7,13,20,3,10.0
4858,120,11,22,33,3,10.0
4859,120,6,6,12,3,10.0
4860,120,2,3,5,3,10.0
4861,120,95,172,267,3,10.0
4862,120,162,227,389,3,10.0
4863,120,45,87,132,3,10.0
4864,120,3,21,24,3,10.0
4865,120,74,148,222,3,10.0
4866,120,136,223,359,3,10.0
4867,120,76,141,217,3,10.0
4868,120,45,150,195,3,10.0
4869,120,31,105,136,3,10.0
4870,120,117,181,298,3,10.0
4871,120,41,91,132,3,10.0
4872,120,63,67,130,3,10.0
4873,120,20,75,95,3,10.0
4874,120,44,29,73,3,10.0
4875,120,33,44,77,3,10.0
4876,120,7,0,7,3,10.0
4877,180,108,267,375,3,10.0
4878,180,47,67,114,3,10.0
4879,180,122,343,465,3,10.0
4880,180,65,114,179,3,10.0
4881,180,25,45,70,3,10.0
4882,180,112,188,300,3,10.0
4883,180,30,102,132,3,10.0
4884,180,51,142,193,3,10.0
4885,180,70,163,233,3,10.0
4886,180,15,36,51,3,10.0
4887,180,68,173,241,3,10.0
4888,180,22,65,87,3,10.0
4889,180,2,1,3,3,10.0
4890,180,17,14,31,3,10.0
4891,180,87,249,336,3,10.0
4892,180,41,73,114,3,10.0
4893,180,121,224,345,3,10.0
4894,180,83,204,287,3,10.0
4895,180,30,79,109,3,10.0
4896,180,50,116,166,3,10.0
4897,180,61,103,164,3,10.0
4898,180,37,157,194,3,10.0
4899,180,31,60,91,3,10.0
4900,180,44,59,103,3,10.0
4901,180,53,82,135,3,10.0
4902,180,47,81,128,3,10.0
4903,180,57,104,161,3,10.0
4904,180,56,71,127,3,10.0
4905,180,52,118,170,3,10.0
4906,180,41,111,152,3,10.0
4907,180,67,134,201,3,10.0
4908,180,34,63,97,3,10.0
4909,180,25,29,54,3,10.0
4910,180,48,32,80,3,10.0
4911,180,64,102,166,3,10.0
4912,180,44,67,111,3,10.0
4913,180,38,116,154,3,10.0
4914,180,11,54,65,3,10.0
4915,180,18,29,47,3,10.0
4916,180,10,5,15,3,10.0
4917,180,5,9,14,3,10.0
4918,180,51,130,181,3,10.0
4919,180,81,180,261,3,10.0
4920,180,36,87,123,3,10.0
4921,180,104,206,310,3,10.0
4922,180,24,89,113,3,10.0
4923,180,80,161,241,3,10.0
4924,180,24,46,70,3,10.0
4925,180,74,182,256,3,10.0
4926,180,36,54,90,3,10.0
4927,180,24,70,94,3,10.0
4928,180,48,118,166,3,10.0
4929,180,16,32,48,3,10.0
4930,180,37,43,80,3,10.0
4931,180,43,70,113,3,10.0
4932,180,91,187,278,3,10.0
4933,180,101,87,188,3,10.0
4934,180,43,69,112,3,10.0
4935,180,57,123,180,3,10.0
4936,180,72,170,242,3,10.0
4937,180,42,109,151,3,10.0
4938,180,66,114,180,3,10.0
4939,180,38,103,141,3,10.0
4940,180,7,22,29,3,10.0
4941,180,32,71,103,3,10.0
4942,180,20,39,59,3,10.0
4943,180,2,13,15,3,10.0
4944,180,40,83,123,3,10.0
4945,180,55,44,99,3,10.0
4946,180,86,89,175,3,10.0
4947,180,56,113,169,3,10.0
4948,180,84,154,238,3,10.0
4949,180,72,66,138,3,10.0
4950,180,72,158,230,3,10.0
4951,180,64,130,194,3,10.0
4952,180,76,106,182,3,10.0
4953,180,39,82,121,3,10.0
4954,180,23,30,53,3,10.0
4955,180,24,51,75,3,10.0
4956,180,49,42,91,3,10.0
4957,180,13,17,30,3,10.0
4958,180,13,14,27,3,10.0
4959,180,28,48,76,3,10.0
4960,180,21,120,141,3,10.0
4961,180,78,121,199,3,10.0
4962,180,18,46,64,3,10.0
4963,180,35,82,117,3,10.0
4964,180,21,104,125,3,10.0
4965,180,67,157,224,3,10.0
4966,180,37,105,142,3,10.0
4967,180,126,115,241,3,10.0
4968,180,49,67,116,3,10.0
4969,180,38,79,117,3,10.0
4970,180,40,84,124,3,10.0
4971,180,35,61,96,3,10.0
4972,180,51,46,97,3,10.0
4973,180,79,158,237,3,10.0
4974,180,58,101,159,3,10.0
4975,180,23,48,71,3,10.0
4976,180,46,65,111,3,10.0
4977,180,73,178,251,3,10.0
4978,180,9,15,24,3,10.0
4979,180,78,98,176,3,10.0
4980,180,59,155,214,3,10.0
4981,180,84,221,305,3,10.0
4982,180,27,64,91,3,10.0
4983,180,49,120,169,3,10.0
4984,180,45,91,136,3,10.0
4985,180,125,142,267,3,10.0
4986,180,40,70,110,3,10.0
4987,180,39,64,103,3,10.0
4988,180,57,48,105,3,10.0
4989,180,35,43,78,3,10.0
4990,180,28,34,62,3,10.0
4991,180,32,23,55,3,10.0
4992,180,43,94,137,3,10.0
4993,180,39,104,143,3,10.0
4994,180,24,31,55,3,10.0
4995,180,53,96,149,3,10.0
4996,180,85,165,250,3,10.0
4997,180,14,47,61,3,10.0
4998,180,106,148,254,3,10.0
4999,180,47,73,120,3,10.0
5000,180,54,51,105,3,10.0
5001,180,28,80,108,3,10.0
5002,180,26,43,69,3,10.0
5003,180,35,72,107,3,10.0
5004,180,20,23,43,3,10.0
5005,180,12,24,36,3,10.0
5006,180,13,38,51,3,10.0
5007,180,14,36,50,3,10.0
5008,180,5,7,12,3,10.0
5009,180,5,8,13,3,10.0
5010,180,87,233,320,3,10.0
5011,180,77,95,172,3,10.0
5012,180,78,140,218,3,10.0
5013,180,107,173,280,3,10.0
5014,180,104,273,377,3,10.0
5015,180,98,238,336,3,10.0
5016,180,86,144,230,3,10.0
5017,180,25,56,81,3,10.0
5018,180,91,184,275,3,10.0
5019,180,77,59,136,3,10.0
5020,180,28,74,102,3,10.0
5021,180,22,30,52,3,10.0
5022,180,24,61,85,3,10.0
5023,180,22,30,52,3,10.0
5024,180,24,25,49,3,10.0
5025,180,25,53,78,3,10.0
5026,180,20,23,43,3,10.0
5027,180,91,177,268,3,10.0
5028,180,68,98,166,3,10.0
5029,180,56,72,128,3,10.0
5030,180,56,152,208,3,10.0
5031,180,47,206,253,3,10.0
5032,180,57,128,185,3,10.0
5033,180,12,33,45,3,10.0
5034,180,17,49,66,3,10.0
5035,180,13,36,49,3,10.0
5036,180,9,18,27,3,10.0
5037,180,8,14,22,3,10.0
5038,180,1,7,8,3,10.0
5039,180,117,121,238,3,10.0
5040,180,85,228,313,3,10.0
5041,180,27,31,58,3,10.0
5042,180,22,137,159,3,10.0
5043,180,66,180,246,3,10.0
5044,180,80,161,241,3,10.0
5045,180,79,182,261,3,10.0
5046,180,35,79,114,3,10.0
5047,180,32,90,122,3,10.0
5048,180,20,38,58,3,10.0
5049,180,28,59,87,3,10.0
5050,180,14,7,21,3,10.0
5051,180,15,30,45,3,10.0
5052,180,28,46,74,3,10.0
5053,180,16,22,38,3,10.0
5054,180,52,69,121,3,10.0
5055,180,70,165,235,3,10.0
5056,180,30,125,155,3,10.0
5057,180,6,8,14,3,10.0
5058,180,46,92,138,3,10.0
5059,180,60,172,232,3,10.0
5060,180,160,210,370,3,10.0
5061,180,24,34,58,3,10.0
5062,180,63,175,238,3,10.0
5063,180,122,165,287,3,10.0
5064,180,18,89,107,3,10.0
5065,180,43,105,148,3,10.0
5066,180,48,70,118,3,10.0
5067,180,24,42,66,3,10.0
5068,180,20,78,98,3,10.0
5069,180,15,62,77,3,10.0
5070,180,3,9,12,3,10.0
5071,180,9,38,47,3,10.0
5072,180,10,19,29,3,10.0
5073,180,3,4,7,3,10.0
5074,180,124,168,292,3,10.0
5075,180,133,237,370,3,10.0
5076,180,22,112,134,3,10.0
5077,180,142,163,305,3,10.0
5078,180,87,165,252,3,10.0
5079,180,68,119,187,3,10.0
5080,180,79,148,227,3,10.0
5081,180,78,149,227,3,10.0
5082,180,102,91,193,3,10.0
5083,180,31,57,88,3,10.0
5084,180,4,7,11,3,10.0
5085,180,23,40,63,3,10.0
5086,180,4,9,13,3,10.0
5087,180,82,124,206,3,10.0
5088,180,47,82,129,3,10.0
5089,180,106,209,315,3,10.0
5090,180,156,193,349,3,10.0
5091,180,88,74,162,3,10.0
5092,180,21,44,65,3,10.0
5093,180,113,188,301,3,10.0
5094,180,60,123,183,3,10.0
5095,180,33,41,74,3,10.0
5096,180,79,97,176,3,10.0
5097,180,15,20,35,3,10.0
5098,180,19,41,60,3,10.0
5099,180,32,66,98,3,10.0
5100,180,6,9,15,3,10.0
5101,180,22,26,48,3,10.0
5102,180,161,401,562,3,10.0
5103,180,30,134,164,3,10.0
5104,180,68,114,182,3,10.0
5105,180,105,137,242,3,10.0
5106,180,114,187,301,3,10.0
5107,180,23,30,53,3,10.0
5108,180,128,145,273,3,10.0
5109,180,101,167,268,3,10.0
5110,180,43,125,168,3,10.0
5111,180,128,161,289,3,10.0
5112,180,75,152,227,3,10.0
5113,180,93,129,222,3,10.0
5114,180,36,19,55,3,10.0
5115,180,20,25,45,3,10.0
5116,180,33,50,83,3,10.0
5117,180,59,115,174,3,10.0
5118,180,33,29,62,3,10.0
5119,180,42,73,115,3,10.0
5120,180,34,62,96,3,10.0
5121,180,48,84,132,3,10.0
5122,180,50,58,108,3,10.0
5123,180,39,68,107,3,10.0
5124,180,48,67,115,3,10.0
5125,180,28,34,62,3,10.0
5126,180,94,82,176,3,10.0
5127,180,36,82,118,3,10.0
5128,180,32,46,78,3,10.0
5129,180,29,28,57,3,10.0
5130,180,26,49,75,3,10.0
5131,180,27,121,148,3,10.0
5132,180,15,22,37,3,10.0
5133,180,18,44,62,3,10.0
5134,180,13,7,20,3,10.0
5135,180,21,11,32,3,10.0
5136,180,7,22,29,3,10.0
5137,180,14,33,47,3,10.0
5138,180,20,14,34,3,10.0
5139,180,101,138,239,3,10.0
5140,180,40,30,70,3,10.0
5141,180,46,70,116,3,10.0
5142,180,41,83,124,3,10.0
5143,180,151,137,288,3,10.0
5144,180,75,56,131,3,10.0
5145,180,70,137,207,3,10.0
5146,180,49,70,119,3,10.0
5147,180,51,114,165,3,10.0
5148,180,87,66,153,3,10.0
5149,180,21,17,38,3,10.0
5150,180,10,22,32,3,10.0
5151,180,26,32,58,3,10.0
5152,180,46,54,100,3,10.0
5153,180,29,50,79,3,10.0
5154,180,34,75,109,3,10.0
5155,180,11,23,34,3,10.0
5156,180,15,42,57,3,10.0
5157,180,23,44,67,3,10.0
5158,180,9,7,16,3,10.0
5159,180,62,108,170,3,10.0
5160,180,117,122,239,3,10.0
5161,180,158,247,405,3,10.0
5162,180,67,107,174,3,10.0
5163,180,42,60,102,3,10.0
5164,180,174,247,421,3,10.0
5165,180,53,59,112,3,10.0
5166,180,86,84,170,3,10.0
5167,180,126,166,292,3,10.0
5168,180,88,144,232,3,10.0
5169,180,93,106,199,3,10.0
5170,180,4,31,35,3,10.0
5171,180,16,40,56,3,10.0
5172,180,22,47,69,3,10.0
5173,180,34,93,127,3,10.0
5174,180,105,170,275,3,10.0
5175,180,31,35,66,3,10.0
5176,180,127,403,530,3,10.0
5177,180,107,330,437,3,10.0
5178,180,113,193,306,3,10.0
5179,180,73,285,358,3,10.0
5180,180,42,52,94,3,10.0
5181,180,74,107,181,3,10.0
5182,180,33,67,100,3,10.0
5183,180,32,117,149,3,10.0
5184,180,15,30,45,3,10.0
5185,180,39,62,101,3,10.0
5186,180,4,5,9,3,10.0
