Unnamed: 0,time_index,RNA_nuc,RNA_cyto,RNA_total,rep,conc
0,0,18,65,83,1,0
1,0,4,13,17,1,0
2,0,77,100,177,1,0
3,0,7,63,70,1,0
4,0,33,99,132,1,0
5,0,29,101,130,1,0
6,0,57,50,107,1,0
7,0,35,94,129,1,0
8,0,50,91,141,1,0
9,0,14,39,53,1,0
10,0,19,32,51,1,0
11,0,86,131,217,1,0
12,0,44,129,173,1,0
13,0,42,78,120,1,0
14,0,35,69,104,1,0
15,0,14,48,62,1,0
16,0,37,66,103,1,0
17,0,15,26,41,1,0
18,0,21,14,35,1,0
19,0,11,18,29,1,0
20,0,32,59,91,1,0
21,0,18,46,64,1,0
22,0,17,56,73,1,0
23,0,49,125,174,1,0
24,0,32,97,129,1,0
25,0,2,16,18,1,0
26,0,42,160,202,1,0
27,0,60,116,176,1,0
28,0,14,35,49,1,0
29,0,8,24,32,1,0
30,0,34,75,109,1,0
31,0,44,47,91,1,0
32,0,20,38,58,1,0
33,0,89,126,215,1,0
34,0,9,34,43,1,0
35,0,2,10,12,1,0
36,0,24,41,65,1,0
37,0,26,56,82,1,0
38,0,15,14,29,1,0
39,0,84,284,368,1,0
40,0,2,4,6,1,0
41,0,26,49,75,1,0
42,0,4,24,28,1,0
43,0,15,67,82,1,0
44,0,44,89,133,1,0
45,0,20,15,35,1,0
46,0,12,21,33,1,0
47,0,2,4,6,1,0
48,0,15,37,52,1,0
49,0,13,3,16,1,0
50,0,10,8,18,1,0
51,0,40,77,117,1,0
52,0,28,24,52,1,0
53,0,36,36,72,1,0
54,0,43,30,73,1,0
55,0,37,85,122,1,0
56,0,25,34,59,1,0
57,0,22,30,52,1,0
58,0,42,84,126,1,0
59,0,12,46,58,1,0
60,0,29,42,71,1,0
61,0,23,36,59,1,0
62,0,7,14,21,1,0
63,0,2,2,4,1,0
64,0,11,2,13,1,0
65,0,27,40,67,1,0
66,0,19,56,75,1,0
67,0,42,69,111,1,0
68,0,115,109,224,1,0
69,0,53,79,132,1,0
70,0,16,40,56,1,0
71,0,40,60,100,1,0
72,0,58,70,128,1,0
73,0,56,43,99,1,0
74,0,27,29,56,1,0
75,0,26,50,76,1,0
76,0,37,93,130,1,0
77,0,18,56,74,1,0
78,0,39,98,137,1,0
79,0,15,46,61,1,0
80,0,22,44,66,1,0
81,0,5,32,37,1,0
82,0,11,29,40,1,0
83,0,18,29,47,1,0
84,0,19,13,32,1,0
85,0,7,16,23,1,0
86,0,10,29,39,1,0
87,0,21,30,51,1,0
88,0,17,10,27,1,0
89,0,19,42,61,1,0
90,0,26,56,82,1,0
91,0,12,19,31,1,0
92,0,12,8,20,1,0
93,0,30,95,125,1,0
94,0,11,14,25,1,0
95,0,28,29,57,1,0
96,0,39,53,92,1,0
97,0,3,6,9,1,0
98,0,15,23,38,1,0
99,0,25,25,50,1,0
100,0,16,27,43,1,0
101,0,23,35,58,1,0
102,0,13,33,46,1,0
103,0,28,47,75,1,0
104,0,19,31,50,1,0
105,0,10,19,29,1,0
106,0,2,5,7,1,0
107,0,13,37,50,1,0
108,0,7,23,30,1,0
109,0,5,26,31,1,0
110,0,0,5,5,1,0
111,0,8,19,27,1,0
112,0,17,26,43,1,0
113,0,5,6,11,1,0
114,0,0,0,0,1,0
115,0,3,11,14,1,0
116,0,7,2,9,1,0
117,0,14,20,34,1,0
118,0,2,7,9,1,0
119,0,13,6,19,1,0
120,0,9,35,44,1,0
121,0,9,8,17,1,0
122,0,7,25,32,1,0
123,0,56,40,96,1,0
124,0,32,100,132,1,0
125,0,7,28,35,1,0
126,0,31,38,69,1,0
127,0,18,25,43,1,0
128,0,27,39,66,1,0
129,0,23,31,54,1,0
130,0,5,8,13,1,0
131,0,16,31,47,1,0
132,0,26,24,50,1,0
133,0,16,29,45,1,0
134,0,3,23,26,1,0
135,0,1,11,12,1,0
136,0,21,18,39,1,0
137,0,15,16,31,1,0
138,0,6,7,13,1,0
139,0,15,29,44,1,0
140,0,5,8,13,1,0
141,0,10,29,39,1,0
142,0,41,42,83,1,0
143,0,2,2,4,1,0
144,0,14,27,41,1,0
145,0,3,3,6,1,0
146,0,27,37,64,1,0
147,0,20,5,25,1,0
148,0,20,33,53,1,0
149,0,22,24,46,1,0
150,0,11,37,48,1,0
151,0,22,44,66,1,0
152,0,16,19,35,1,0
153,0,2,6,8,1,0
154,0,10,21,31,1,0
155,0,18,24,42,1,0
156,0,8,9,17,1,0
157,0,27,22,49,1,0
158,0,9,13,22,1,0
159,0,15,21,36,1,0
160,0,29,50,79,1,0
161,0,23,18,41,1,0
162,0,34,18,52,1,0
163,0,8,10,18,1,0
164,0,7,13,20,1,0
165,0,0,10,10,1,0
166,0,1,2,3,1,0
167,0,10,14,24,1,0
168,0,0,12,12,1,0
169,0,19,36,55,1,0
170,0,66,129,195,1,0
171,0,80,188,268,1,0
172,0,59,92,151,1,0
173,0,26,75,101,1,0
174,0,26,52,78,1,0
175,0,26,68,94,1,0
176,0,37,89,126,1,0
177,0,24,64,88,1,0
178,0,18,36,54,1,0
179,0,21,56,77,1,0
180,0,20,29,49,1,0
181,0,19,20,39,1,0
182,0,17,20,37,1,0
183,0,20,24,44,1,0
184,0,29,59,88,1,0
185,0,22,81,103,1,0
186,0,19,44,63,1,0
187,0,15,25,40,1,0
188,0,2,6,8,1,0
189,0,19,26,45,1,0
190,0,4,20,24,1,0
191,0,9,8,17,1,0
192,0,3,15,18,1,0
193,0,19,38,57,1,0
194,0,69,105,174,1,0
195,0,24,59,83,1,0
196,0,23,72,95,1,0
197,0,25,78,103,1,0
198,0,54,135,189,1,0
199,0,2,5,7,1,0
200,0,24,50,74,1,0
201,0,9,15,24,1,0
202,0,9,52,61,1,0
203,0,23,85,108,1,0
204,0,2,13,15,1,0
205,0,9,12,21,1,0
206,0,27,73,100,1,0
207,0,100,114,214,1,0
208,0,16,25,41,1,0
209,0,21,22,43,1,0
210,0,29,71,100,1,0
211,0,7,8,15,1,0
212,0,33,28,61,1,0
213,0,4,18,22,1,0
214,0,32,58,90,1,0
215,0,4,13,17,1,0
216,0,10,24,34,1,0
217,0,19,42,61,1,0
218,0,17,40,57,1,0
219,0,4,4,8,1,0
220,0,4,23,27,1,0
221,0,10,13,23,1,0
222,0,19,33,52,1,0
223,0,66,56,122,1,0
224,0,21,63,84,1,0
225,0,21,61,82,1,0
226,0,44,42,86,1,0
227,0,42,87,129,1,0
228,0,22,31,53,1,0
229,0,47,111,158,1,0
230,0,25,86,111,1,0
231,0,54,126,180,1,0
232,0,19,60,79,1,0
233,0,4,8,12,1,0
234,0,5,43,48,1,0
235,0,15,39,54,1,0
236,0,9,30,39,1,0
237,0,6,39,45,1,0
238,0,30,66,96,1,0
239,0,11,30,41,1,0
240,0,22,54,76,1,0
241,0,16,52,68,1,0
242,0,5,13,18,1,0
243,0,14,68,82,1,0
244,0,12,38,50,1,0
245,0,13,34,47,1,0
246,0,11,17,28,1,0
247,0,13,23,36,1,0
248,0,31,93,124,1,0
249,0,20,45,65,1,0
250,0,5,6,11,1,0
251,0,3,10,13,1,0
252,0,40,88,128,1,0
253,0,45,108,153,1,0
254,0,12,36,48,1,0
255,0,37,51,88,1,0
256,0,10,25,35,1,0
257,0,13,17,30,1,0
258,0,21,60,81,1,0
259,0,2,4,6,1,0
260,0,8,16,24,1,0
261,0,15,132,147,1,0
262,0,71,169,240,1,0
263,0,15,51,66,1,0
264,0,31,114,145,1,0
265,0,40,68,108,1,0
266,0,24,42,66,1,0
267,0,23,60,83,1,0
268,0,7,31,38,1,0
269,0,14,25,39,1,0
270,0,13,18,31,1,0
271,0,30,73,103,1,0
272,0,28,59,87,1,0
273,0,34,41,75,1,0
274,0,4,29,33,1,0
275,0,24,59,83,1,0
276,0,21,59,80,1,0
277,0,21,84,105,1,0
278,0,27,34,61,1,0
279,0,8,13,21,1,0
280,0,56,129,185,1,0
281,0,5,15,20,1,0
282,0,28,58,86,1,0
283,0,6,10,16,1,0
284,0,30,53,83,1,0
285,0,8,9,17,1,0
286,0,0,6,6,1,0
287,0,49,82,131,1,0
288,0,44,46,90,1,0
289,0,10,30,40,1,0
290,0,16,45,61,1,0
291,0,26,61,87,1,0
292,0,9,30,39,1,0
293,0,6,20,26,1,0
294,0,5,13,18,1,0
295,0,5,20,25,1,0
296,0,8,22,30,1,0
297,0,19,18,37,1,0
298,0,26,75,101,1,0
299,0,69,74,143,1,0
300,0,30,65,95,1,0
301,0,14,92,106,1,0
302,0,45,83,128,1,0
303,0,48,134,182,1,0
304,0,31,65,96,1,0
305,0,37,105,142,1,0
306,0,0,10,10,1,0
307,0,12,15,27,1,0
308,0,43,73,116,1,0
309,0,24,23,47,1,0
310,0,17,22,39,1,0
311,0,60,115,175,1,0
312,0,19,23,42,1,0
313,0,34,96,130,1,0
314,0,29,72,101,1,0
315,0,13,18,31,1,0
316,0,15,24,39,1,0
317,0,4,9,13,1,0
318,0,53,137,190,1,0
319,0,6,12,18,1,0
320,0,46,62,108,1,0
321,0,20,26,46,1,0
322,0,23,77,100,1,0
323,0,26,68,94,1,0
324,0,2,10,12,1,0
325,0,9,19,28,1,0
326,0,4,12,16,1,0
327,0,17,45,62,1,0
328,0,19,29,48,1,0
329,0,0,4,4,1,0
330,0,10,8,18,1,0
331,0,7,12,19,1,0
332,0,4,2,6,1,0
333,0,21,49,70,1,0
334,0,16,36,52,1,0
335,0,8,46,54,1,0
336,0,30,61,91,1,0
337,0,19,40,59,1,0
338,0,11,15,26,1,0
339,0,13,14,27,1,0
340,0,9,17,26,1,0
341,0,9,22,31,1,0
342,0,8,6,14,1,0
343,0,30,68,98,1,0
344,0,20,78,98,1,0
345,0,17,57,74,1,0
346,0,42,102,144,1,0
347,0,12,34,46,1,0
348,0,37,90,127,1,0
349,0,24,55,79,1,0
350,0,13,19,32,1,0
351,0,3,4,7,1,0
352,0,22,59,81,1,0
353,0,10,24,34,1,0
354,0,14,44,58,1,0
355,0,3,21,24,1,0
356,0,11,24,35,1,0
357,0,34,49,83,1,0
358,0,29,44,73,1,0
359,0,29,70,99,1,0
360,0,23,44,67,1,0
361,0,40,63,103,1,0
362,0,16,30,46,1,0
363,0,19,30,49,1,0
364,0,12,34,46,1,0
365,0,14,27,41,1,0
366,0,31,53,84,1,0
367,0,7,15,22,1,0
368,0,81,138,219,1,0
369,0,11,20,31,1,0
370,0,9,13,22,1,0
371,0,6,8,14,1,0
372,0,2,16,18,1,0
373,0,12,37,49,1,0
374,0,10,19,29,1,0
375,0,3,28,31,1,0
376,0,3,10,13,1,0
377,0,5,3,8,1,0
378,0,5,13,18,1,0
379,0,4,9,13,1,0
380,0,13,47,60,1,0
381,0,10,16,26,1,0
382,0,57,140,197,1,0
383,0,3,1,4,1,0
384,0,37,31,68,1,0
385,0,22,114,136,1,0
386,0,55,195,250,1,0
387,0,4,16,20,1,0
388,0,15,103,118,1,0
389,0,1,4,5,1,0
390,0,19,37,56,1,0
391,0,9,24,33,1,0
392,0,5,17,22,1,0
393,0,4,3,7,1,0
394,0,8,14,22,1,0
395,0,15,65,80,1,0
396,0,35,42,77,1,0
397,0,29,84,113,1,0
398,0,19,41,60,1,0
399,0,5,78,83,1,0
400,0,43,111,154,1,0
401,0,26,82,108,1,0
402,0,31,73,104,1,0
403,0,24,52,76,1,0
404,0,1,3,4,1,0
405,0,15,38,53,1,0
406,0,9,35,44,1,0
407,0,4,10,14,1,0
408,0,0,0,0,1,0
409,0,3,7,10,1,0
410,0,65,138,203,1,0
411,0,5,13,18,1,0
412,0,37,67,104,1,0
413,0,27,95,122,1,0
414,0,10,29,39,1,0
415,0,10,25,35,1,0
416,0,9,31,40,1,0
417,0,16,47,63,1,0
418,0,14,34,48,1,0
419,0,15,43,58,1,0
420,0,10,17,27,1,0
421,0,15,10,25,1,0
422,0,8,10,18,1,0
423,0,5,11,16,1,0
424,0,4,6,10,1,0
425,0,3,7,10,1,0
426,0,3,21,24,1,0
427,10,25,56,81,1,100
428,10,24,27,51,1,100
429,10,46,77,123,1,100
430,10,31,36,67,1,100
431,10,25,62,87,1,100
432,10,24,232,256,1,100
433,10,48,94,142,1,100
434,10,25,34,59,1,100
435,10,113,151,264,1,100
436,10,11,20,31,1,100
437,10,23,35,58,1,100
438,10,7,3,10,1,100
439,10,11,11,22,1,100
440,10,13,18,31,1,100
441,10,0,0,0,1,100
442,10,37,82,119,1,100
443,10,96,158,254,1,100
444,10,40,55,95,1,100
445,10,18,36,54,1,100
446,10,32,70,102,1,100
447,10,4,18,22,1,100
448,10,31,45,76,1,100
449,10,19,19,38,1,100
450,10,11,50,61,1,100
451,10,8,6,14,1,100
452,10,1,2,3,1,100
453,10,14,23,37,1,100
454,10,27,69,96,1,100
455,10,39,65,104,1,100
456,10,14,34,48,1,100
457,10,24,61,85,1,100
458,10,16,31,47,1,100
459,10,12,44,56,1,100
460,10,7,27,34,1,100
461,10,25,56,81,1,100
462,10,25,67,92,1,100
463,10,13,36,49,1,100
464,10,9,33,42,1,100
465,10,9,4,13,1,100
466,10,26,12,38,1,100
467,10,52,96,148,1,100
468,10,1,10,11,1,100
469,10,10,20,30,1,100
470,10,25,57,82,1,100
471,10,54,81,135,1,100
472,10,38,66,104,1,100
473,10,36,77,113,1,100
474,10,48,86,134,1,100
475,10,35,100,135,1,100
476,10,59,81,140,1,100
477,10,5,15,20,1,100
478,10,14,50,64,1,100
479,10,14,61,75,1,100
480,10,11,26,37,1,100
481,10,1,2,3,1,100
482,10,4,28,32,1,100
483,10,6,48,54,1,100
484,10,17,103,120,1,100
485,10,11,23,34,1,100
486,10,30,76,106,1,100
487,10,20,14,34,1,100
488,10,38,62,100,1,100
489,10,39,75,114,1,100
490,10,9,22,31,1,100
491,10,39,50,89,1,100
492,10,18,50,68,1,100
493,10,16,27,43,1,100
494,10,24,52,76,1,100
495,10,4,7,11,1,100
496,10,35,63,98,1,100
497,10,32,76,108,1,100
498,10,37,37,74,1,100
499,10,42,54,96,1,100
500,10,44,68,112,1,100
501,10,47,132,179,1,100
502,10,49,66,115,1,100
503,10,47,45,92,1,100
504,10,38,113,151,1,100
505,10,8,22,30,1,100
506,10,6,9,15,1,100
507,10,47,39,86,1,100
508,10,31,73,104,1,100
509,10,61,57,118,1,100
510,10,19,77,96,1,100
511,10,50,151,201,1,100
512,10,40,40,80,1,100
513,10,47,42,89,1,100
514,10,24,38,62,1,100
515,10,45,28,73,1,100
516,10,25,26,51,1,100
517,10,42,63,105,1,100
518,10,6,9,15,1,100
519,10,2,1,3,1,100
520,10,25,43,68,1,100
521,10,2,6,8,1,100
522,10,29,64,93,1,100
523,10,20,19,39,1,100
524,10,35,58,93,1,100
525,10,23,55,78,1,100
526,10,41,45,86,1,100
527,10,27,49,76,1,100
528,10,9,8,17,1,100
529,10,10,15,25,1,100
530,10,48,57,105,1,100
531,10,2,8,10,1,100
532,10,12,20,32,1,100
533,10,12,26,38,1,100
534,10,24,37,61,1,100
535,10,24,33,57,1,100
536,10,21,53,74,1,100
537,10,29,66,95,1,100
538,10,29,40,69,1,100
539,10,36,41,77,1,100
540,10,12,15,27,1,100
541,10,26,25,51,1,100
542,10,18,34,52,1,100
543,10,27,56,83,1,100
544,10,9,11,20,1,100
545,10,9,5,14,1,100
546,10,19,15,34,1,100
547,10,3,27,30,1,100
548,10,15,58,73,1,100
549,10,21,63,84,1,100
550,10,26,61,87,1,100
551,10,26,42,68,1,100
552,10,33,88,121,1,100
553,10,40,116,156,1,100
554,10,22,59,81,1,100
555,10,14,33,47,1,100
556,10,36,46,82,1,100
557,10,24,50,74,1,100
558,10,14,35,49,1,100
559,10,29,30,59,1,100
560,10,3,14,17,1,100
561,10,2,14,16,1,100
562,10,16,26,42,1,100
563,10,7,5,12,1,100
564,10,23,51,74,1,100
565,10,35,64,99,1,100
566,10,51,121,172,1,100
567,10,15,7,22,1,100
568,10,41,112,153,1,100
569,10,16,32,48,1,100
570,10,18,50,68,1,100
571,10,36,35,71,1,100
572,10,14,39,53,1,100
573,10,14,20,34,1,100
574,10,7,5,12,1,100
575,10,15,51,66,1,100
576,10,18,21,39,1,100
577,10,61,90,151,1,100
578,10,62,131,193,1,100
579,10,28,23,51,1,100
580,10,19,48,67,1,100
581,10,28,35,63,1,100
582,10,4,10,14,1,100
583,10,30,35,65,1,100
584,10,24,50,74,1,100
585,10,15,39,54,1,100
586,10,9,9,18,1,100
587,10,33,71,104,1,100
588,10,31,45,76,1,100
589,10,19,35,54,1,100
590,10,40,99,139,1,100
591,10,25,34,59,1,100
592,10,27,62,89,1,100
593,10,9,43,52,1,100
594,10,21,49,70,1,100
595,10,66,146,212,1,100
596,10,27,30,57,1,100
597,10,17,25,42,1,100
598,10,20,32,52,1,100
599,10,1,10,11,1,100
600,10,13,16,29,1,100
601,10,3,1,4,1,100
602,10,6,1,7,1,100
603,10,33,34,67,1,100
604,10,24,84,108,1,100
605,10,27,28,55,1,100
606,10,35,54,89,1,100
607,10,7,17,24,1,100
608,10,26,36,62,1,100
609,10,31,73,104,1,100
610,10,52,89,141,1,100
611,10,0,9,9,1,100
612,10,12,15,27,1,100
613,10,5,9,14,1,100
614,10,88,246,334,1,100
615,10,57,125,182,1,100
616,10,14,62,76,1,100
617,10,35,68,103,1,100
618,10,17,27,44,1,100
619,10,18,27,45,1,100
620,10,12,36,48,1,100
621,10,16,19,35,1,100
622,10,20,19,39,1,100
623,10,32,52,84,1,100
624,10,69,82,151,1,100
625,10,23,64,87,1,100
626,10,49,40,89,1,100
627,10,33,21,54,1,100
628,10,6,8,14,1,100
629,10,8,31,39,1,100
630,10,14,34,48,1,100
631,10,33,47,80,1,100
632,10,13,27,40,1,100
633,10,11,20,31,1,100
634,10,6,11,17,1,100
635,10,34,33,67,1,100
636,10,24,36,60,1,100
637,10,40,64,104,1,100
638,10,30,56,86,1,100
639,10,65,56,121,1,100
640,10,29,57,86,1,100
641,10,52,64,116,1,100
642,10,15,83,98,1,100
643,10,46,52,98,1,100
644,10,13,20,33,1,100
645,10,36,75,111,1,100
646,10,17,24,41,1,100
647,10,26,21,47,1,100
648,10,15,17,32,1,100
649,10,23,42,65,1,100
650,10,17,39,56,1,100
651,10,13,17,30,1,100
652,10,11,55,66,1,100
653,10,15,22,37,1,100
654,10,20,59,79,1,100
655,10,11,33,44,1,100
656,10,16,27,43,1,100
657,10,13,26,39,1,100
658,10,10,10,20,1,100
659,10,1,6,7,1,100
660,10,2,3,5,1,100
661,10,1,12,13,1,100
662,10,18,56,74,1,100
663,10,20,65,85,1,100
664,10,28,73,101,1,100
665,10,27,169,196,1,100
666,10,11,43,54,1,100
667,10,20,42,62,1,100
668,10,35,59,94,1,100
669,10,32,40,72,1,100
670,10,28,55,83,1,100
671,10,25,54,79,1,100
672,10,17,39,56,1,100
673,10,26,31,57,1,100
674,10,0,0,0,1,100
675,10,3,15,18,1,100
676,10,5,10,15,1,100
677,10,6,10,16,1,100
678,10,4,5,9,1,100
679,10,31,83,114,1,100
680,10,48,76,124,1,100
681,10,12,12,24,1,100
682,10,7,28,35,1,100
683,10,12,38,50,1,100
684,10,24,47,71,1,100
685,10,7,28,35,1,100
686,10,28,51,79,1,100
687,10,16,47,63,1,100
688,10,14,33,47,1,100
689,10,23,69,92,1,100
690,10,23,20,43,1,100
691,10,12,19,31,1,100
692,10,35,72,107,1,100
693,10,51,99,150,1,100
694,10,50,136,186,1,100
695,10,50,110,160,1,100
696,10,13,18,31,1,100
697,10,17,27,44,1,100
698,10,7,29,36,1,100
699,10,26,36,62,1,100
700,10,5,27,32,1,100
701,10,11,10,21,1,100
702,10,42,56,98,1,100
703,10,52,92,144,1,100
704,10,16,55,71,1,100
705,10,13,22,35,1,100
706,10,36,36,72,1,100
707,10,24,17,41,1,100
708,10,16,36,52,1,100
709,10,25,54,79,1,100
710,10,34,44,78,1,100
711,10,43,57,100,1,100
712,10,13,38,51,1,100
713,10,11,23,34,1,100
714,10,18,42,60,1,100
715,10,43,73,116,1,100
716,10,16,49,65,1,100
717,10,34,62,96,1,100
718,10,16,12,28,1,100
719,10,15,28,43,1,100
720,10,17,42,59,1,100
721,10,6,23,29,1,100
722,10,0,0,0,1,100
723,10,4,4,8,1,100
724,10,10,29,39,1,100
725,10,33,81,114,1,100
726,10,78,74,152,1,100
727,10,30,91,121,1,100
728,10,23,35,58,1,100
729,10,18,27,45,1,100
730,10,9,42,51,1,100
731,10,20,47,67,1,100
732,10,24,52,76,1,100
733,10,9,5,14,1,100
734,10,9,4,13,1,100
735,10,60,70,130,1,100
736,10,20,46,66,1,100
737,10,20,22,42,1,100
738,10,36,47,83,1,100
739,10,5,35,40,1,100
740,10,28,45,73,1,100
741,10,23,86,109,1,100
742,10,69,73,142,1,100
743,10,15,30,45,1,100
744,10,49,103,152,1,100
745,10,22,39,61,1,100
746,10,24,124,148,1,100
747,10,29,61,90,1,100
748,10,28,68,96,1,100
749,10,20,14,34,1,100
750,10,25,39,64,1,100
751,10,50,71,121,1,100
752,10,23,40,63,1,100
753,10,11,15,26,1,100
754,10,12,19,31,1,100
755,10,12,14,26,1,100
756,10,7,19,26,1,100
757,10,0,15,15,1,100
758,10,8,30,38,1,100
759,10,29,23,52,1,100
760,10,8,8,16,1,100
761,10,9,15,24,1,100
762,10,22,35,57,1,100
763,10,9,15,24,1,100
764,10,11,14,25,1,100
765,10,15,23,38,1,100
766,10,17,31,48,1,100
767,10,23,29,52,1,100
768,10,13,14,27,1,100
769,10,16,20,36,1,100
770,10,23,55,78,1,100
771,10,34,46,80,1,100
772,10,29,81,110,1,100
773,10,20,47,67,1,100
774,10,7,7,14,1,100
775,10,24,39,63,1,100
776,10,13,24,37,1,100
777,10,12,38,50,1,100
778,10,30,85,115,1,100
779,10,13,22,35,1,100
780,10,11,39,50,1,100
781,10,22,22,44,1,100
782,10,20,53,73,1,100
783,10,18,31,49,1,100
784,10,35,61,96,1,100
785,10,16,29,45,1,100
786,10,27,41,68,1,100
787,10,18,72,90,1,100
788,10,24,58,82,1,100
789,10,4,15,19,1,100
790,10,18,24,42,1,100
791,10,8,22,30,1,100
792,10,26,22,48,1,100
793,10,16,41,57,1,100
794,10,5,19,24,1,100
795,10,18,28,46,1,100
796,10,16,39,55,1,100
797,10,18,13,31,1,100
798,10,21,24,45,1,100
799,10,14,23,37,1,100
800,10,19,79,98,1,100
801,10,12,56,68,1,100
802,10,13,10,23,1,100
803,10,5,17,22,1,100
804,10,2,24,26,1,100
805,10,34,88,122,1,100
806,10,8,10,18,1,100
807,10,11,38,49,1,100
808,20,31,53,84,1,100
809,20,40,58,98,1,100
810,20,33,141,174,1,100
811,20,43,142,185,1,100
812,20,30,38,68,1,100
813,20,14,44,58,1,100
814,20,11,15,26,1,100
815,20,60,129,189,1,100
816,20,12,37,49,1,100
817,20,3,12,15,1,100
818,20,23,38,61,1,100
819,20,81,217,298,1,100
820,20,48,161,209,1,100
821,20,39,52,91,1,100
822,20,35,97,132,1,100
823,20,11,21,32,1,100
824,20,12,22,34,1,100
825,20,33,99,132,1,100
826,20,24,43,67,1,100
827,20,69,87,156,1,100
828,20,7,30,37,1,100
829,20,16,24,40,1,100
830,20,32,59,91,1,100
831,20,8,9,17,1,100
832,20,16,27,43,1,100
833,20,47,55,102,1,100
834,20,5,7,12,1,100
835,20,43,103,146,1,100
836,20,24,52,76,1,100
837,20,53,82,135,1,100
838,20,72,80,152,1,100
839,20,34,86,120,1,100
840,20,37,76,113,1,100
841,20,10,20,30,1,100
842,20,7,12,19,1,100
843,20,35,25,60,1,100
844,20,38,53,91,1,100
845,20,36,57,93,1,100
846,20,45,44,89,1,100
847,20,18,38,56,1,100
848,20,46,41,87,1,100
849,20,31,38,69,1,100
850,20,28,42,70,1,100
851,20,6,8,14,1,100
852,20,29,32,61,1,100
853,20,15,24,39,1,100
854,20,16,24,40,1,100
855,20,27,48,75,1,100
856,20,19,41,60,1,100
857,20,12,15,27,1,100
858,20,56,117,173,1,100
859,20,33,53,86,1,100
860,20,56,63,119,1,100
861,20,22,30,52,1,100
862,20,52,83,135,1,100
863,20,37,70,107,1,100
864,20,9,19,28,1,100
865,20,21,45,66,1,100
866,20,6,4,10,1,100
867,20,9,7,16,1,100
868,20,8,63,71,1,100
869,20,8,20,28,1,100
870,20,2,1,3,1,100
871,20,26,51,77,1,100
872,20,6,32,38,1,100
873,20,29,44,73,1,100
874,20,23,23,46,1,100
875,20,55,79,134,1,100
876,20,9,16,25,1,100
877,20,42,72,114,1,100
878,20,81,92,173,1,100
879,20,13,20,33,1,100
880,20,8,12,20,1,100
881,20,17,26,43,1,100
882,20,24,16,40,1,100
883,20,0,19,19,1,100
884,20,21,20,41,1,100
885,20,19,41,60,1,100
886,20,1,8,9,1,100
887,20,7,1,8,1,100
888,20,14,26,40,1,100
889,20,8,6,14,1,100
890,20,7,19,26,1,100
891,20,13,34,47,1,100
892,20,16,21,37,1,100
893,20,136,223,359,1,100
894,20,30,69,99,1,100
895,20,25,57,82,1,100
896,20,36,74,110,1,100
897,20,24,24,48,1,100
898,20,22,42,64,1,100
899,20,26,59,85,1,100
900,20,6,15,21,1,100
901,20,4,15,19,1,100
902,20,9,22,31,1,100
903,20,6,13,19,1,100
904,20,0,0,0,1,100
905,20,23,47,70,1,100
906,20,36,56,92,1,100
907,20,53,82,135,1,100
908,20,16,41,57,1,100
909,20,51,69,120,1,100
910,20,29,46,75,1,100
911,20,17,45,62,1,100
912,20,12,32,44,1,100
913,20,49,85,134,1,100
914,20,38,52,90,1,100
915,20,25,104,129,1,100
916,20,37,77,114,1,100
917,20,28,82,110,1,100
918,20,40,32,72,1,100
919,20,18,27,45,1,100
920,20,37,49,86,1,100
921,20,15,18,33,1,100
922,20,29,20,49,1,100
923,20,10,10,20,1,100
924,20,20,52,72,1,100
925,20,12,10,22,1,100
926,20,16,18,34,1,100
927,20,12,24,36,1,100
928,20,0,0,0,1,100
929,20,8,11,19,1,100
930,20,4,5,9,1,100
931,20,12,19,31,1,100
932,20,43,84,127,1,100
933,20,47,94,141,1,100
934,20,35,76,111,1,100
935,20,21,55,76,1,100
936,20,27,66,93,1,100
937,20,62,108,170,1,100
938,20,28,70,98,1,100
939,20,8,22,30,1,100
940,20,30,69,99,1,100
941,20,1,9,10,1,100
942,20,13,24,37,1,100
943,20,1,10,11,1,100
944,20,13,16,29,1,100
945,20,10,4,14,1,100
946,20,13,57,70,1,100
947,20,21,50,71,1,100
948,20,30,38,68,1,100
949,20,61,123,184,1,100
950,20,43,36,79,1,100
951,20,45,93,138,1,100
952,20,17,21,38,1,100
953,20,12,6,18,1,100
954,20,50,76,126,1,100
955,20,25,68,93,1,100
956,20,11,24,35,1,100
957,20,6,20,26,1,100
958,20,11,33,44,1,100
959,20,6,8,14,1,100
960,20,4,10,14,1,100
961,20,27,43,70,1,100
962,20,4,32,36,1,100
963,20,16,9,25,1,100
964,20,22,45,67,1,100
965,20,48,48,96,1,100
966,20,34,33,67,1,100
967,20,23,27,50,1,100
968,20,22,37,59,1,100
969,20,1,3,4,1,100
970,20,13,9,22,1,100
971,20,55,46,101,1,100
972,20,41,31,72,1,100
973,20,23,25,48,1,100
974,20,17,28,45,1,100
975,20,73,58,131,1,100
976,20,26,28,54,1,100
977,20,35,30,65,1,100
978,20,3,14,17,1,100
979,20,14,25,39,1,100
980,20,5,3,8,1,100
981,20,9,31,40,1,100
982,20,26,31,57,1,100
983,20,12,27,39,1,100
984,20,19,32,51,1,100
985,20,24,31,55,1,100
986,20,38,66,104,1,100
987,20,30,21,51,1,100
988,20,39,95,134,1,100
989,20,28,73,101,1,100
990,20,58,60,118,1,100
991,20,61,80,141,1,100
992,20,13,25,38,1,100
993,20,15,26,41,1,100
994,20,39,36,75,1,100
995,20,30,33,63,1,100
996,20,23,32,55,1,100
997,20,4,5,9,1,100
998,20,8,15,23,1,100
999,20,5,6,11,1,100
1000,20,57,73,130,1,100
1001,20,4,17,21,1,100
1002,20,36,71,107,1,100
1003,20,46,74,120,1,100
1004,20,16,42,58,1,100
1005,20,82,72,154,1,100
1006,20,71,86,157,1,100
1007,20,37,91,128,1,100
1008,20,75,85,160,1,100
1009,20,27,37,64,1,100
1010,20,36,53,89,1,100
1011,20,37,68,105,1,100
1012,20,27,29,56,1,100
1013,20,13,37,50,1,100
1014,20,13,42,55,1,100
1015,20,10,13,23,1,100
1016,20,37,45,82,1,100
1017,20,18,23,41,1,100
1018,20,47,59,106,1,100
1019,20,31,61,92,1,100
1020,20,13,39,52,1,100
1021,20,26,54,80,1,100
1022,20,25,58,83,1,100
1023,20,6,6,12,1,100
1024,20,40,65,105,1,100
1025,20,37,42,79,1,100
1026,20,4,10,14,1,100
1027,20,23,19,42,1,100
1028,20,70,55,125,1,100
1029,20,4,5,9,1,100
1030,20,50,151,201,1,100
1031,20,57,100,157,1,100
1032,20,29,41,70,1,100
1033,20,14,31,45,1,100
1034,20,18,9,27,1,100
1035,20,89,125,214,1,100
1036,20,17,18,35,1,100
1037,20,33,61,94,1,100
1038,20,11,33,44,1,100
1039,20,40,49,89,1,100
1040,20,33,48,81,1,100
1041,20,8,23,31,1,100
1042,20,4,2,6,1,100
1043,20,60,243,303,1,100
1044,20,88,207,295,1,100
1045,20,52,153,205,1,100
1046,20,44,170,214,1,100
1047,20,34,36,70,1,100
1048,20,81,195,276,1,100
1049,20,78,146,224,1,100
1050,20,92,188,280,1,100
1051,20,17,36,53,1,100
1052,20,78,315,393,1,100
1053,20,89,122,211,1,100
1054,20,75,54,129,1,100
1055,20,61,150,211,1,100
1056,20,37,63,100,1,100
1057,20,55,160,215,1,100
1058,20,52,124,176,1,100
1059,20,99,128,227,1,100
1060,20,25,33,58,1,100
1061,20,33,44,77,1,100
1062,20,77,145,222,1,100
1063,20,60,95,155,1,100
1064,20,11,21,32,1,100
1065,20,36,76,112,1,100
1066,20,8,29,37,1,100
1067,20,47,80,127,1,100
1068,20,53,25,78,1,100
1069,20,41,32,73,1,100
1070,20,34,47,81,1,100
1071,20,10,25,35,1,100
1072,20,45,97,142,1,100
1073,20,6,6,12,1,100
1074,20,39,60,99,1,100
1075,20,85,144,229,1,100
1076,20,76,239,315,1,100
1077,20,61,81,142,1,100
1078,20,17,75,92,1,100
1079,20,41,113,154,1,100
1080,20,96,162,258,1,100
1081,20,6,15,21,1,100
1082,20,54,107,161,1,100
1083,20,16,39,55,1,100
1084,20,4,9,13,1,100
1085,20,14,35,49,1,100
1086,20,9,13,22,1,100
1087,20,24,26,50,1,100
1088,20,34,55,89,1,100
1089,20,11,38,49,1,100
1090,20,54,81,135,1,100
1091,20,32,51,83,1,100
1092,20,34,65,99,1,100
1093,20,16,12,28,1,100
1094,20,24,61,85,1,100
1095,20,27,33,60,1,100
1096,20,3,13,16,1,100
1097,20,15,30,45,1,100
1098,20,7,20,27,1,100
1099,20,24,57,81,1,100
1100,20,37,38,75,1,100
1101,20,15,50,65,1,100
1102,20,9,15,24,1,100
1103,20,20,33,53,1,100
1104,20,26,62,88,1,100
1105,20,22,8,30,1,100
1106,20,15,30,45,1,100
1107,20,3,16,19,1,100
1108,20,15,21,36,1,100
1109,20,4,17,21,1,100
1110,20,20,45,65,1,100
1111,20,15,34,49,1,100
1112,20,12,15,27,1,100
1113,20,22,32,54,1,100
1114,20,23,49,72,1,100
1115,20,19,43,62,1,100
1116,20,71,32,103,1,100
1117,20,26,64,90,1,100
1118,20,27,9,36,1,100
1119,20,22,29,51,1,100
1120,20,31,57,88,1,100
1121,20,54,40,94,1,100
1122,20,18,22,40,1,100
1123,20,20,33,53,1,100
1124,20,15,23,38,1,100
1125,20,30,45,75,1,100
1126,20,14,7,21,1,100
1127,20,11,11,22,1,100
1128,20,22,32,54,1,100
1129,20,15,21,36,1,100
1130,20,14,10,24,1,100
1131,20,7,19,26,1,100
1132,20,0,0,0,1,100
1133,20,47,142,189,1,100
1134,20,5,22,27,1,100
1135,20,31,63,94,1,100
1136,20,21,23,44,1,100
1137,20,15,19,34,1,100
1138,20,20,17,37,1,100
1139,20,58,97,155,1,100
1140,20,51,70,121,1,100
1141,20,10,24,34,1,100
1142,20,30,30,60,1,100
1143,20,7,19,26,1,100
1144,20,1,4,5,1,100
1145,20,0,0,0,1,100
1146,20,9,13,22,1,100
1147,20,6,9,15,1,100
1148,20,23,45,68,1,100
1149,20,19,23,42,1,100
1150,20,14,18,32,1,100
1151,20,18,44,62,1,100
1152,20,50,131,181,1,100
1153,20,6,1,7,1,100
1154,20,15,12,27,1,100
1155,20,20,37,57,1,100
1156,20,8,32,40,1,100
1157,20,7,18,25,1,100
1158,20,10,16,26,1,100
1159,20,7,21,28,1,100
1160,20,26,25,51,1,100
1161,20,40,63,103,1,100
1162,20,6,7,13,1,100
1163,20,20,60,80,1,100
1164,20,18,30,48,1,100
1165,20,33,44,77,1,100
1166,20,6,2,8,1,100
1167,20,13,22,35,1,100
1168,20,16,37,53,1,100
1169,20,21,54,75,1,100
1170,20,32,47,79,1,100
1171,20,14,27,41,1,100
1172,20,0,3,3,1,100
1173,20,6,30,36,1,100
1174,20,13,22,35,1,100
1175,20,23,19,42,1,100
1176,20,10,20,30,1,100
1177,20,42,79,121,1,100
1178,20,21,35,56,1,100
1179,20,32,61,93,1,100
1180,20,15,27,42,1,100
1181,20,6,26,32,1,100
1182,20,15,27,42,1,100
1183,20,7,15,22,1,100
1184,20,2,5,7,1,100
1185,20,23,34,57,1,100
1186,20,60,96,156,1,100
1187,20,17,27,44,1,100
1188,20,35,43,78,1,100
1189,20,34,28,62,1,100
1190,20,11,35,46,1,100
1191,20,49,41,90,1,100
1192,20,11,12,23,1,100
1193,20,36,59,95,1,100
1194,20,14,10,24,1,100
1195,20,3,8,11,1,100
1196,20,13,31,44,1,100
1197,20,9,16,25,1,100
1198,20,25,42,67,1,100
1199,20,41,34,75,1,100
1200,20,19,37,56,1,100
1201,20,17,41,58,1,100
1202,20,10,15,25,1,100
1203,20,23,14,37,1,100
1204,20,18,41,59,1,100
1205,20,14,27,41,1,100
1206,20,5,19,24,1,100
1207,20,16,17,33,1,100
1208,20,4,3,7,1,100
1209,20,17,13,30,1,100
1210,20,16,40,56,1,100
1211,20,18,33,51,1,100
1212,20,19,23,42,1,100
1213,20,12,19,31,1,100
1214,20,14,23,37,1,100
1215,20,13,11,24,1,100
1216,20,30,46,76,1,100
1217,20,16,21,37,1,100
1218,20,16,36,52,1,100
1219,20,11,61,72,1,100
1220,20,4,18,22,1,100
1221,20,15,26,41,1,100
1222,20,17,29,46,1,100
1223,20,3,13,16,1,100
1224,20,32,57,89,1,100
1225,20,26,69,95,1,100
1226,20,26,82,108,1,100
1227,20,18,36,54,1,100
1228,20,22,38,60,1,100
1229,20,17,40,57,1,100
1230,20,20,36,56,1,100
1231,20,42,92,134,1,100
1232,20,23,21,44,1,100
1233,20,16,21,37,1,100
1234,20,14,17,31,1,100
1235,30,12,80,92,1,100
1236,30,30,88,118,1,100
1237,30,16,29,45,1,100
1238,30,108,117,225,1,100
1239,30,66,121,187,1,100
1240,30,7,8,15,1,100
1241,30,32,54,86,1,100
1242,30,33,55,88,1,100
1243,30,43,83,126,1,100
1244,30,50,66,116,1,100
1245,30,54,83,137,1,100
1246,30,2,8,10,1,100
1247,30,26,46,72,1,100
1248,30,9,15,24,1,100
1249,30,12,11,23,1,100
1250,30,37,57,94,1,100
1251,30,11,16,27,1,100
1252,30,50,79,129,1,100
1253,30,26,75,101,1,100
1254,30,34,83,117,1,100
1255,30,106,153,259,1,100
1256,30,30,63,93,1,100
1257,30,27,58,85,1,100
1258,30,34,27,61,1,100
1259,30,8,27,35,1,100
1260,30,36,40,76,1,100
1261,30,3,7,10,1,100
1262,30,26,50,76,1,100
1263,30,14,24,38,1,100
1264,30,0,0,0,1,100
1265,30,15,25,40,1,100
1266,30,17,47,64,1,100
1267,30,60,61,121,1,100
1268,30,22,58,80,1,100
1269,30,100,129,229,1,100
1270,30,52,57,109,1,100
1271,30,14,26,40,1,100
1272,30,65,46,111,1,100
1273,30,43,48,91,1,100
1274,30,21,35,56,1,100
1275,30,7,24,31,1,100
1276,30,13,34,47,1,100
1277,30,46,81,127,1,100
1278,30,17,13,30,1,100
1279,30,31,47,78,1,100
1280,30,13,13,26,1,100
1281,30,16,13,29,1,100
1282,30,31,36,67,1,100
1283,30,39,46,85,1,100
1284,30,11,9,20,1,100
1285,30,65,76,141,1,100
1286,30,36,50,86,1,100
1287,30,40,72,112,1,100
1288,30,37,49,86,1,100
1289,30,35,31,66,1,100
1290,30,27,39,66,1,100
1291,30,41,75,116,1,100
1292,30,52,63,115,1,100
1293,30,26,53,79,1,100
1294,30,5,7,12,1,100
1295,30,8,8,16,1,100
1296,30,3,1,4,1,100
1297,30,33,46,79,1,100
1298,30,63,81,144,1,100
1299,30,4,24,28,1,100
1300,30,51,129,180,1,100
1301,30,33,40,73,1,100
1302,30,70,58,128,1,100
1303,30,52,154,206,1,100
1304,30,5,15,20,1,100
1305,30,30,40,70,1,100
1306,30,19,38,57,1,100
1307,30,3,7,10,1,100
1308,30,43,49,92,1,100
1309,30,50,87,137,1,100
1310,30,68,96,164,1,100
1311,30,47,101,148,1,100
1312,30,48,77,125,1,100
1313,30,43,89,132,1,100
1314,30,34,34,68,1,100
1315,30,66,161,227,1,100
1316,30,18,32,50,1,100
1317,30,8,13,21,1,100
1318,30,18,26,44,1,100
1319,30,41,27,68,1,100
1320,30,50,94,144,1,100
1321,30,36,56,92,1,100
1322,30,12,34,46,1,100
1323,30,6,10,16,1,100
1324,30,7,28,35,1,100
1325,30,28,73,101,1,100
1326,30,21,61,82,1,100
1327,30,40,64,104,1,100
1328,30,25,39,64,1,100
1329,30,23,26,49,1,100
1330,30,27,38,65,1,100
1331,30,20,50,70,1,100
1332,30,19,39,58,1,100
1333,30,21,22,43,1,100
1334,30,11,26,37,1,100
1335,30,16,16,32,1,100
1336,30,11,21,32,1,100
1337,30,25,86,111,1,100
1338,30,19,23,42,1,100
1339,30,34,81,115,1,100
1340,30,116,175,291,1,100
1341,30,22,33,55,1,100
1342,30,28,57,85,1,100
1343,30,36,34,70,1,100
1344,30,23,46,69,1,100
1345,30,34,41,75,1,100
1346,30,7,9,16,1,100
1347,30,32,54,86,1,100
1348,30,68,152,220,1,100
1349,30,66,122,188,1,100
1350,30,51,89,140,1,100
1351,30,35,77,112,1,100
1352,30,74,82,156,1,100
1353,30,116,96,212,1,100
1354,30,39,71,110,1,100
1355,30,41,68,109,1,100
1356,30,9,8,17,1,100
1357,30,15,34,49,1,100
1358,30,39,43,82,1,100
1359,30,21,26,47,1,100
1360,30,62,89,151,1,100
1361,30,111,179,290,1,100
1362,30,46,45,91,1,100
1363,30,33,34,67,1,100
1364,30,33,77,110,1,100
1365,30,34,33,67,1,100
1366,30,33,42,75,1,100
1367,30,19,28,47,1,100
1368,30,6,22,28,1,100
1369,30,17,17,34,1,100
1370,30,8,15,23,1,100
1371,30,55,62,117,1,100
1372,30,47,93,140,1,100
1373,30,20,28,48,1,100
1374,30,68,50,118,1,100
1375,30,32,84,116,1,100
1376,30,25,19,44,1,100
1377,30,57,86,143,1,100
1378,30,32,82,114,1,100
1379,30,40,57,97,1,100
1380,30,44,35,79,1,100
1381,30,32,25,57,1,100
1382,30,70,81,151,1,100
1383,30,19,20,39,1,100
1384,30,26,59,85,1,100
1385,30,36,55,91,1,100
1386,30,20,26,46,1,100
1387,30,55,99,154,1,100
1388,30,42,54,96,1,100
1389,30,60,89,149,1,100
1390,30,5,13,18,1,100
1391,30,57,106,163,1,100
1392,30,33,53,86,1,100
1393,30,32,31,63,1,100
1394,30,53,74,127,1,100
1395,30,3,9,12,1,100
1396,30,30,38,68,1,100
1397,30,46,64,110,1,100
1398,30,19,33,52,1,100
1399,30,6,8,14,1,100
1400,30,1,6,7,1,100
1401,30,2,8,10,1,100
1402,30,21,26,47,1,100
1403,30,37,21,58,1,100
1404,30,66,95,161,1,100
1405,30,13,29,42,1,100
1406,30,9,44,53,1,100
1407,30,32,45,77,1,100
1408,30,61,90,151,1,100
1409,30,37,51,88,1,100
1410,30,100,98,198,1,100
1411,30,16,16,32,1,100
1412,30,42,39,81,1,100
1413,30,57,94,151,1,100
1414,30,21,36,57,1,100
1415,30,46,65,111,1,100
1416,30,15,11,26,1,100
1417,30,72,107,179,1,100
1418,30,14,22,36,1,100
1419,30,26,43,69,1,100
1420,30,14,23,37,1,100
1421,30,5,13,18,1,100
1422,30,0,0,0,1,100
1423,30,9,4,13,1,100
1424,30,63,87,150,1,100
1425,30,52,77,129,1,100
1426,30,51,28,79,1,100
1427,30,52,90,142,1,100
1428,30,179,125,304,1,100
1429,30,128,164,292,1,100
1430,30,28,38,66,1,100
1431,30,86,25,111,1,100
1432,30,31,57,88,1,100
1433,30,24,27,51,1,100
1434,30,75,64,139,1,100
1435,30,85,106,191,1,100
1436,30,47,38,85,1,100
1437,30,5,8,13,1,100
1438,30,52,44,96,1,100
1439,30,23,28,51,1,100
1440,30,34,56,90,1,100
1441,30,2,3,5,1,100
1442,30,34,57,91,1,100
1443,30,71,92,163,1,100
1444,30,20,35,55,1,100
1445,30,66,90,156,1,100
1446,30,49,54,103,1,100
1447,30,28,50,78,1,100
1448,30,17,13,30,1,100
1449,30,59,40,99,1,100
1450,30,41,51,92,1,100
1451,30,22,48,70,1,100
1452,30,11,10,21,1,100
1453,30,20,26,46,1,100
1454,30,13,44,57,1,100
1455,30,18,38,56,1,100
1456,30,4,18,22,1,100
1457,30,19,7,26,1,100
1458,30,32,56,88,1,100
1459,30,46,82,128,1,100
1460,30,28,45,73,1,100
1461,30,38,79,117,1,100
1462,30,60,91,151,1,100
1463,30,62,78,140,1,100
1464,30,82,60,142,1,100
1465,30,39,37,76,1,100
1466,30,8,6,14,1,100
1467,30,18,50,68,1,100
1468,30,17,19,36,1,100
1469,30,39,61,100,1,100
1470,30,11,39,50,1,100
1471,30,46,38,84,1,100
1472,30,48,97,145,1,100
1473,30,22,36,58,1,100
1474,30,10,33,43,1,100
1475,30,9,28,37,1,100
1476,30,10,18,28,1,100
1477,30,40,96,136,1,100
1478,30,46,49,95,1,100
1479,30,47,76,123,1,100
1480,30,11,9,20,1,100
1481,30,25,38,63,1,100
1482,30,32,38,70,1,100
1483,30,0,0,0,1,100
1484,30,63,54,117,1,100
1485,30,15,28,43,1,100
1486,30,26,39,65,1,100
1487,30,38,77,115,1,100
1488,30,19,32,51,1,100
1489,30,24,18,42,1,100
1490,30,95,129,224,1,100
1491,30,59,141,200,1,100
1492,30,20,27,47,1,100
1493,30,80,79,159,1,100
1494,30,27,36,63,1,100
1495,30,52,37,89,1,100
1496,30,67,84,151,1,100
1497,30,70,111,181,1,100
1498,30,34,65,99,1,100
1499,30,75,86,161,1,100
1500,30,5,19,24,1,100
1501,30,43,71,114,1,100
1502,30,8,16,24,1,100
1503,30,131,158,289,1,100
1504,30,122,188,310,1,100
1505,30,103,112,215,1,100
1506,30,58,96,154,1,100
1507,30,20,21,41,1,100
1508,30,48,99,147,1,100
1509,30,10,12,22,1,100
1510,30,19,33,52,1,100
1511,30,12,20,32,1,100
1512,30,7,7,14,1,100
1513,30,40,17,57,1,100
1514,30,47,76,123,1,100
1515,30,19,74,93,1,100
1516,30,29,35,64,1,100
1517,30,54,64,118,1,100
1518,30,17,44,61,1,100
1519,30,55,100,155,1,100
1520,30,37,78,115,1,100
1521,30,9,27,36,1,100
1522,30,48,111,159,1,100
1523,30,8,10,18,1,100
1524,30,23,15,38,1,100
1525,30,38,34,72,1,100
1526,30,80,78,158,1,100
1527,30,57,92,149,1,100
1528,30,68,51,119,1,100
1529,30,59,58,117,1,100
1530,30,54,62,116,1,100
1531,30,97,81,178,1,100
1532,30,9,24,33,1,100
1533,30,24,56,80,1,100
1534,30,90,75,165,1,100
1535,30,20,21,41,1,100
1536,30,15,30,45,1,100
1537,30,24,26,50,1,100
1538,30,43,44,87,1,100
1539,30,43,78,121,1,100
1540,30,47,87,134,1,100
1541,30,56,69,125,1,100
1542,30,38,44,82,1,100
1543,30,29,69,98,1,100
1544,30,27,47,74,1,100
1545,30,16,15,31,1,100
1546,30,35,72,107,1,100
1547,30,20,42,62,1,100
1548,30,34,36,70,1,100
1549,30,6,9,15,1,100
1550,30,17,23,40,1,100
1551,30,16,17,33,1,100
1552,30,34,53,87,1,100
1553,30,31,49,80,1,100
1554,30,82,108,190,1,100
1555,30,106,118,224,1,100
1556,30,30,61,91,1,100
1557,30,50,90,140,1,100
1558,30,47,77,124,1,100
1559,30,35,94,129,1,100
1560,30,45,54,99,1,100
1561,30,45,61,106,1,100
1562,30,20,52,72,1,100
1563,30,19,28,47,1,100
1564,30,37,77,114,1,100
1565,30,51,108,159,1,100
1566,30,17,15,32,1,100
1567,30,45,80,125,1,100
1568,30,24,43,67,1,100
1569,30,59,114,173,1,100
1570,30,19,33,52,1,100
1571,30,71,133,204,1,100
1572,30,20,24,44,1,100
1573,30,40,48,88,1,100
1574,30,29,46,75,1,100
1575,30,11,18,29,1,100
1576,30,15,25,40,1,100
1577,30,4,5,9,1,100
1578,30,60,90,150,1,100
1579,30,120,211,331,1,100
1580,30,6,46,52,1,100
1581,30,47,69,116,1,100
1582,30,51,88,139,1,100
1583,30,58,90,148,1,100
1584,30,40,114,154,1,100
1585,30,25,41,66,1,100
1586,30,20,22,42,1,100
1587,30,66,79,145,1,100
1588,30,7,15,22,1,100
1589,30,28,35,63,1,100
1590,30,11,30,41,1,100
1591,30,109,94,203,1,100
1592,30,44,68,112,1,100
1593,30,60,97,157,1,100
1594,30,37,21,58,1,100
1595,30,94,182,276,1,100
1596,30,39,45,84,1,100
1597,30,89,81,170,1,100
1598,30,69,84,153,1,100
1599,30,11,30,41,1,100
1600,30,50,44,94,1,100
1601,30,21,39,60,1,100
1602,30,5,28,33,1,100
1603,30,2,10,12,1,100
1604,30,53,89,142,1,100
1605,30,18,34,52,1,100
1606,30,5,14,19,1,100
1607,30,92,160,252,1,100
1608,30,35,69,104,1,100
1609,30,21,14,35,1,100
1610,30,24,26,50,1,100
1611,30,45,142,187,1,100
1612,30,44,53,97,1,100
1613,30,60,104,164,1,100
1614,30,46,95,141,1,100
1615,30,14,52,66,1,100
1616,30,24,33,57,1,100
1617,30,18,37,55,1,100
1618,30,32,42,74,1,100
1619,30,15,39,54,1,100
1620,30,7,6,13,1,100
1621,30,17,30,47,1,100
1622,30,25,60,85,1,100
1623,30,26,38,64,1,100
1624,30,53,72,125,1,100
1625,30,36,22,58,1,100
1626,30,28,64,92,1,100
1627,30,36,55,91,1,100
1628,30,18,33,51,1,100
1629,30,24,30,54,1,100
1630,30,2,2,4,1,100
1631,30,2,5,7,1,100
1632,30,53,55,108,1,100
1633,30,9,16,25,1,100
1634,30,52,96,148,1,100
1635,30,10,19,29,1,100
1636,30,3,12,15,1,100
1637,30,36,100,136,1,100
1638,30,58,86,144,1,100
1639,30,5,4,9,1,100
1640,30,55,90,145,1,100
1641,30,35,46,81,1,100
1642,30,19,42,61,1,100
1643,30,51,107,158,1,100
1644,30,28,34,62,1,100
1645,30,59,51,110,1,100
1646,30,20,20,40,1,100
1647,30,8,6,14,1,100
1648,30,8,17,25,1,100
1649,30,29,38,67,1,100
1650,30,4,8,12,1,100
1651,40,68,99,167,1,100
1652,40,37,57,94,1,100
1653,40,123,142,265,1,100
1654,40,126,170,296,1,100
1655,40,155,190,345,1,100
1656,40,68,70,138,1,100
1657,40,55,91,146,1,100
1658,40,23,25,48,1,100
1659,40,18,55,73,1,100
1660,40,17,45,62,1,100
1661,40,44,70,114,1,100
1662,40,29,63,92,1,100
1663,40,15,51,66,1,100
1664,40,87,106,193,1,100
1665,40,93,107,200,1,100
1666,40,42,96,138,1,100
1667,40,108,125,233,1,100
1668,40,28,22,50,1,100
1669,40,74,84,158,1,100
1670,40,98,135,233,1,100
1671,40,10,16,26,1,100
1672,40,92,121,213,1,100
1673,40,36,79,115,1,100
1674,40,11,23,34,1,100
1675,40,43,82,125,1,100
1676,40,60,87,147,1,100
1677,40,90,119,209,1,100
1678,40,40,71,111,1,100
1679,40,54,94,148,1,100
1680,40,50,57,107,1,100
1681,40,93,122,215,1,100
1682,40,73,87,160,1,100
1683,40,85,107,192,1,100
1684,40,48,35,83,1,100
1685,40,31,45,76,1,100
1686,40,30,56,86,1,100
1687,40,70,58,128,1,100
1688,40,49,76,125,1,100
1689,40,93,159,252,1,100
1690,40,101,155,256,1,100
1691,40,159,194,353,1,100
1692,40,81,98,179,1,100
1693,40,83,136,219,1,100
1694,40,38,50,88,1,100
1695,40,91,111,202,1,100
1696,40,38,88,126,1,100
1697,40,20,30,50,1,100
1698,40,43,57,100,1,100
1699,40,70,78,148,1,100
1700,40,67,80,147,1,100
1701,40,19,20,39,1,100
1702,40,151,184,335,1,100
1703,40,95,121,216,1,100
1704,40,33,37,70,1,100
1705,40,70,85,155,1,100
1706,40,60,98,158,1,100
1707,40,62,81,143,1,100
1708,40,67,125,192,1,100
1709,40,52,93,145,1,100
1710,40,49,72,121,1,100
1711,40,13,23,36,1,100
1712,40,53,56,109,1,100
1713,40,69,89,158,1,100
1714,40,8,5,13,1,100
1715,40,92,86,178,1,100
1716,40,25,22,47,1,100
1717,40,64,73,137,1,100
1718,40,47,35,82,1,100
1719,40,18,36,54,1,100
1720,40,97,122,219,1,100
1721,40,134,125,259,1,100
1722,40,31,23,54,1,100
1723,40,50,51,101,1,100
1724,40,46,80,126,1,100
1725,40,78,95,173,1,100
1726,40,10,17,27,1,100
1727,40,6,5,11,1,100
1728,40,29,60,89,1,100
1729,40,93,73,166,1,100
1730,40,128,102,230,1,100
1731,40,38,51,89,1,100
1732,40,41,80,121,1,100
1733,40,51,69,120,1,100
1734,40,60,123,183,1,100
1735,40,63,55,118,1,100
1736,40,72,123,195,1,100
1737,40,19,30,49,1,100
1738,40,30,42,72,1,100
1739,40,213,214,427,1,100
1740,40,63,92,155,1,100
1741,40,40,66,106,1,100
1742,40,16,25,41,1,100
1743,40,43,85,128,1,100
1744,40,23,51,74,1,100
1745,40,20,9,29,1,100
1746,40,37,36,73,1,100
1747,40,65,48,113,1,100
1748,40,11,19,30,1,100
1749,40,91,103,194,1,100
1750,40,126,154,280,1,100
1751,40,76,84,160,1,100
1752,40,54,83,137,1,100
1753,40,44,59,103,1,100
1754,40,68,74,142,1,100
1755,40,38,44,82,1,100
1756,40,55,60,115,1,100
1757,40,28,4,32,1,100
1758,40,119,119,238,1,100
1759,40,61,124,185,1,100
1760,40,6,11,17,1,100
1761,40,21,18,39,1,100
1762,40,29,42,71,1,100
1763,40,49,63,112,1,100
1764,40,20,28,48,1,100
1765,40,76,90,166,1,100
1766,40,93,254,347,1,100
1767,40,81,71,152,1,100
1768,40,12,6,18,1,100
1769,40,76,94,170,1,100
1770,40,85,115,200,1,100
1771,40,104,235,339,1,100
1772,40,67,78,145,1,100
1773,40,122,191,313,1,100
1774,40,50,78,128,1,100
1775,40,28,79,107,1,100
1776,40,32,98,130,1,100
1777,40,40,22,62,1,100
1778,40,18,23,41,1,100
1779,40,82,99,181,1,100
1780,40,29,53,82,1,100
1781,40,46,55,101,1,100
1782,40,96,73,169,1,100
1783,40,83,99,182,1,100
1784,40,111,174,285,1,100
1785,40,75,89,164,1,100
1786,40,109,132,241,1,100
1787,40,34,56,90,1,100
1788,40,62,75,137,1,100
1789,40,70,41,111,1,100
1790,40,44,93,137,1,100
1791,40,19,30,49,1,100
1792,40,119,135,254,1,100
1793,40,12,39,51,1,100
1794,40,21,33,54,1,100
1795,40,54,68,122,1,100
1796,40,157,221,378,1,100
1797,40,69,114,183,1,100
1798,40,114,146,260,1,100
1799,40,32,18,50,1,100
1800,40,46,69,115,1,100
1801,40,61,74,135,1,100
1802,40,39,71,110,1,100
1803,40,50,116,166,1,100
1804,40,23,33,56,1,100
1805,40,38,42,80,1,100
1806,40,111,136,247,1,100
1807,40,96,98,194,1,100
1808,40,116,107,223,1,100
1809,40,92,128,220,1,100
1810,40,45,76,121,1,100
1811,40,35,67,102,1,100
1812,40,80,125,205,1,100
1813,40,17,23,40,1,100
1814,40,40,56,96,1,100
1815,40,18,48,66,1,100
1816,40,96,143,239,1,100
1817,40,14,11,25,1,100
1818,40,65,63,128,1,100
1819,40,89,102,191,1,100
1820,40,20,17,37,1,100
1821,40,77,119,196,1,100
1822,40,37,63,100,1,100
1823,40,45,62,107,1,100
1824,40,42,20,62,1,100
1825,40,53,73,126,1,100
1826,40,45,63,108,1,100
1827,40,101,139,240,1,100
1828,40,22,24,46,1,100
1829,40,88,63,151,1,100
1830,40,11,15,26,1,100
1831,40,9,14,23,1,100
1832,40,47,32,79,1,100
1833,40,4,3,7,1,100
1834,40,45,94,139,1,100
1835,40,42,63,105,1,100
1836,40,49,54,103,1,100
1837,40,57,94,151,1,100
1838,40,44,31,75,1,100
1839,40,93,104,197,1,100
1840,40,63,95,158,1,100
1841,40,71,121,192,1,100
1842,40,50,54,104,1,100
1843,40,82,136,218,1,100
1844,40,69,109,178,1,100
1845,40,42,86,128,1,100
1846,40,49,59,108,1,100
1847,40,8,57,65,1,100
1848,40,14,11,25,1,100
1849,40,12,22,34,1,100
1850,40,89,146,235,1,100
1851,40,140,166,306,1,100
1852,40,140,128,268,1,100
1853,40,68,117,185,1,100
1854,40,145,152,297,1,100
1855,40,81,96,177,1,100
1856,40,43,242,285,1,100
1857,40,89,84,173,1,100
1858,40,42,67,109,1,100
1859,40,100,142,242,1,100
1860,40,32,59,91,1,100
1861,40,74,111,185,1,100
1862,40,48,54,102,1,100
1863,40,61,88,149,1,100
1864,40,84,110,194,1,100
1865,40,28,51,79,1,100
1866,40,6,16,22,1,100
1867,40,53,89,142,1,100
1868,40,44,85,129,1,100
1869,40,70,69,139,1,100
1870,40,106,165,271,1,100
1871,40,148,194,342,1,100
1872,40,49,100,149,1,100
1873,40,105,162,267,1,100
1874,40,92,81,173,1,100
1875,40,61,77,138,1,100
1876,40,100,162,262,1,100
1877,40,139,136,275,1,100
1878,40,90,106,196,1,100
1879,40,95,146,241,1,100
1880,40,9,28,37,1,100
1881,40,80,98,178,1,100
1882,40,96,110,206,1,100
1883,40,35,52,87,1,100
1884,40,90,201,291,1,100
1885,40,73,85,158,1,100
1886,40,19,16,35,1,100
1887,40,67,88,155,1,100
1888,40,69,86,155,1,100
1889,40,7,15,22,1,100
1890,40,35,43,78,1,100
1891,40,78,98,176,1,100
1892,40,41,64,105,1,100
1893,40,60,136,196,1,100
1894,40,25,44,69,1,100
1895,40,62,102,164,1,100
1896,40,53,91,144,1,100
1897,40,147,237,384,1,100
1898,40,125,193,318,1,100
1899,40,24,25,49,1,100
1900,40,133,157,290,1,100
1901,40,56,78,134,1,100
1902,40,83,90,173,1,100
1903,40,102,114,216,1,100
1904,40,25,18,43,1,100
1905,40,83,85,168,1,100
1906,40,34,52,86,1,100
1907,40,28,80,108,1,100
1908,40,2,2,4,1,100
1909,40,19,23,42,1,100
1910,40,30,32,62,1,100
1911,40,166,218,384,1,100
1912,40,71,125,196,1,100
1913,40,115,159,274,1,100
1914,40,91,169,260,1,100
1915,40,36,117,153,1,100
1916,40,32,55,87,1,100
1917,40,115,161,276,1,100
1918,40,61,154,215,1,100
1919,40,61,99,160,1,100
1920,40,109,227,336,1,100
1921,40,49,71,120,1,100
1922,40,121,81,202,1,100
1923,40,43,52,95,1,100
1924,40,5,11,16,1,100
1925,40,24,52,76,1,100
1926,40,62,83,145,1,100
1927,40,56,82,138,1,100
1928,40,82,96,178,1,100
1929,40,106,157,263,1,100
1930,40,134,158,292,1,100
1931,40,86,78,164,1,100
1932,40,88,94,182,1,100
1933,40,98,84,182,1,100
1934,40,108,81,189,1,100
1935,40,36,54,90,1,100
1936,40,75,98,173,1,100
1937,40,9,10,19,1,100
1938,40,44,70,114,1,100
1939,40,36,70,106,1,100
1940,40,82,97,179,1,100
1941,40,84,157,241,1,100
1942,40,18,27,45,1,100
1943,40,20,36,56,1,100
1944,40,62,105,167,1,100
1945,40,44,82,126,1,100
1946,40,12,13,25,1,100
1947,40,49,57,106,1,100
1948,40,53,89,142,1,100
1949,40,54,40,94,1,100
1950,40,46,37,83,1,100
1951,40,23,33,56,1,100
1952,40,18,39,57,1,100
1953,40,72,141,213,1,100
1954,40,94,153,247,1,100
1955,40,74,58,132,1,100
1956,40,113,112,225,1,100
1957,40,103,67,170,1,100
1958,40,51,28,79,1,100
1959,40,53,37,90,1,100
1960,40,67,69,136,1,100
1961,40,18,17,35,1,100
1962,40,42,52,94,1,100
1963,40,99,210,309,1,100
1964,40,78,199,277,1,100
1965,40,66,96,162,1,100
1966,40,62,299,361,1,100
1967,40,50,80,130,1,100
1968,40,56,89,145,1,100
1969,40,36,33,69,1,100
1970,40,66,82,148,1,100
1971,40,27,85,112,1,100
1972,40,43,75,118,1,100
1973,40,78,141,219,1,100
1974,40,60,75,135,1,100
1975,40,70,106,176,1,100
1976,40,49,74,123,1,100
1977,40,97,131,228,1,100
1978,40,52,67,119,1,100
1979,40,23,14,37,1,100
1980,40,68,168,236,1,100
1981,40,14,16,30,1,100
1982,40,24,39,63,1,100
1983,40,23,49,72,1,100
1984,40,123,153,276,1,100
1985,40,57,129,186,1,100
1986,40,56,80,136,1,100
1987,40,37,55,92,1,100
1988,40,74,105,179,1,100
1989,40,25,78,103,1,100
1990,40,88,90,178,1,100
1991,40,10,16,26,1,100
1992,40,14,28,42,1,100
1993,40,88,89,177,1,100
1994,40,96,81,177,1,100
1995,40,90,145,235,1,100
1996,40,103,110,213,1,100
1997,40,46,86,132,1,100
1998,40,98,140,238,1,100
1999,40,69,93,162,1,100
2000,40,36,56,92,1,100
2001,40,55,46,101,1,100
2002,40,47,52,99,1,100
2003,40,28,37,65,1,100
2004,40,24,38,62,1,100
2005,40,22,43,65,1,100
2006,40,16,48,64,1,100
2007,40,51,124,175,1,100
2008,40,11,24,35,1,100
2009,40,55,52,107,1,100
2010,40,74,47,121,1,100
2011,40,126,94,220,1,100
2012,40,88,131,219,1,100
2013,40,64,68,132,1,100
2014,40,60,74,134,1,100
2015,40,136,261,397,1,100
2016,40,29,24,53,1,100
2017,40,103,122,225,1,100
2018,40,100,102,202,1,100
2019,40,51,71,122,1,100
2020,40,66,51,117,1,100
2021,40,46,59,105,1,100
2022,40,70,99,169,1,100
2023,40,66,47,113,1,100
2024,40,20,50,70,1,100
2025,40,9,22,31,1,100
2026,40,96,216,312,1,100
2027,40,62,115,177,1,100
2028,40,122,183,305,1,100
2029,40,45,90,135,1,100
2030,40,83,73,156,1,100
2031,40,64,117,181,1,100
2032,40,53,71,124,1,100
2033,40,90,227,317,1,100
2034,40,46,113,159,1,100
2035,40,415,626,1041,1,100
2036,40,170,319,489,1,100
2037,40,167,109,276,1,100
2038,40,65,52,117,1,100
2039,40,57,74,131,1,100
2040,40,92,162,254,1,100
2041,40,117,167,284,1,100
2042,40,61,55,116,1,100
2043,40,98,110,208,1,100
2044,40,169,180,349,1,100
2045,40,64,83,147,1,100
2046,40,76,109,185,1,100
2047,40,34,45,79,1,100
2048,40,2,1,3,1,100
2049,40,62,41,103,1,100
2050,40,58,27,85,1,100
2051,40,54,53,107,1,100
2052,40,92,81,173,1,100
2053,40,27,40,67,1,100
2054,40,114,130,244,1,100
2055,40,63,75,138,1,100
2056,40,91,95,186,1,100
2057,40,54,77,131,1,100
2058,40,124,179,303,1,100
2059,40,104,199,303,1,100
2060,40,11,5,16,1,100
2061,40,68,74,142,1,100
2062,40,14,28,42,1,100
2063,40,29,49,78,1,100
2064,40,33,28,61,1,100
2065,40,24,37,61,1,100
2066,40,15,18,33,1,100
2067,40,43,64,107,1,100
2068,50,99,131,230,1,100
2069,50,79,219,298,1,100
2070,50,118,154,272,1,100
2071,50,90,208,298,1,100
2072,50,121,206,327,1,100
2073,50,128,213,341,1,100
2074,50,54,72,126,1,100
2075,50,54,87,141,1,100
2076,50,145,248,393,1,100
2077,50,120,204,324,1,100
2078,50,52,112,164,1,100
2079,50,169,309,478,1,100
2080,50,61,111,172,1,100
2081,50,9,25,34,1,100
2082,50,86,171,257,1,100
2083,50,100,149,249,1,100
2084,50,90,167,257,1,100
2085,50,89,155,244,1,100
2086,50,90,135,225,1,100
2087,50,74,99,173,1,100
2088,50,26,37,63,1,100
2089,50,48,45,93,1,100
2090,50,44,55,99,1,100
2091,50,37,42,79,1,100
2092,50,45,94,139,1,100
2093,50,62,115,177,1,100
2094,50,206,206,412,1,100
2095,50,92,152,244,1,100
2096,50,242,291,533,1,100
2097,50,69,141,210,1,100
2098,50,189,239,428,1,100
2099,50,56,122,178,1,100
2100,50,160,216,376,1,100
2101,50,185,292,477,1,100
2102,50,40,90,130,1,100
2103,50,81,104,185,1,100
2104,50,28,57,85,1,100
2105,50,109,183,292,1,100
2106,50,128,186,314,1,100
2107,50,80,188,268,1,100
2108,50,146,222,368,1,100
2109,50,95,204,299,1,100
2110,50,126,186,312,1,100
2111,50,28,46,74,1,100
2112,50,36,75,111,1,100
2113,50,93,203,296,1,100
2114,50,5,11,16,1,100
2115,50,20,41,61,1,100
2116,50,74,122,196,1,100
2117,50,17,43,60,1,100
2118,50,280,391,671,1,100
2119,50,117,264,381,1,100
2120,50,123,221,344,1,100
2121,50,75,129,204,1,100
2122,50,101,89,190,1,100
2123,50,130,174,304,1,100
2124,50,234,247,481,1,100
2125,50,59,135,194,1,100
2126,50,68,90,158,1,100
2127,50,66,99,165,1,100
2128,50,37,73,110,1,100
2129,50,39,68,107,1,100
2130,50,14,28,42,1,100
2131,50,25,66,91,1,100
2132,50,33,52,85,1,100
2133,50,36,91,127,1,100
2134,50,89,343,432,1,100
2135,50,78,197,275,1,100
2136,50,90,163,253,1,100
2137,50,80,117,197,1,100
2138,50,82,183,265,1,100
2139,50,12,20,32,1,100
2140,50,37,90,127,1,100
2141,50,20,49,69,1,100
2142,50,6,14,20,1,100
2143,50,125,197,322,1,100
2144,50,72,169,241,1,100
2145,50,185,395,580,1,100
2146,50,63,107,170,1,100
2147,50,131,198,329,1,100
2148,50,87,118,205,1,100
2149,50,53,103,156,1,100
2150,50,15,104,119,1,100
2151,50,8,165,173,1,100
2152,50,29,43,72,1,100
2153,50,30,102,132,1,100
2154,50,9,11,20,1,100
2155,50,11,10,21,1,100
2156,50,5,14,19,1,100
2157,50,155,295,450,1,100
2158,50,93,119,212,1,100
2159,50,88,230,318,1,100
2160,50,114,192,306,1,100
2161,50,105,129,234,1,100
2162,50,80,117,197,1,100
2163,50,68,124,192,1,100
2164,50,20,47,67,1,100
2165,50,85,63,148,1,100
2166,50,50,92,142,1,100
2167,50,96,154,250,1,100
2168,50,85,134,219,1,100
2169,50,2,12,14,1,100
2170,50,43,69,112,1,100
2171,50,8,28,36,1,100
2172,50,16,60,76,1,100
2173,50,89,198,287,1,100
2174,50,37,28,65,1,100
2175,50,73,113,186,1,100
2176,50,38,33,71,1,100
2177,50,28,37,65,1,100
2178,50,133,135,268,1,100
2179,50,96,191,287,1,100
2180,50,102,119,221,1,100
2181,50,35,88,123,1,100
2182,50,51,142,193,1,100
2183,50,16,71,87,1,100
2184,50,96,136,232,1,100
2185,50,46,45,91,1,100
2186,50,86,95,181,1,100
2187,50,78,101,179,1,100
2188,50,49,24,73,1,100
2189,50,29,48,77,1,100
2190,50,58,97,155,1,100
2191,50,34,76,110,1,100
2192,50,117,62,179,1,100
2193,50,66,145,211,1,100
2194,50,110,182,292,1,100
2195,50,69,103,172,1,100
2196,50,76,136,212,1,100
2197,50,27,40,67,1,100
2198,50,79,122,201,1,100
2199,50,68,114,182,1,100
2200,50,13,34,47,1,100
2201,50,67,94,161,1,100
2202,50,24,23,47,1,100
2203,50,78,81,159,1,100
2204,50,56,62,118,1,100
2205,50,139,227,366,1,100
2206,50,71,117,188,1,100
2207,50,120,235,355,1,100
2208,50,81,161,242,1,100
2209,50,132,194,326,1,100
2210,50,33,45,78,1,100
2211,50,56,72,128,1,100
2212,50,18,40,58,1,100
2213,50,16,24,40,1,100
2214,50,105,176,281,1,100
2215,50,89,141,230,1,100
2216,50,114,209,323,1,100
2217,50,32,27,59,1,100
2218,50,97,170,267,1,100
2219,50,78,54,132,1,100
2220,50,24,47,71,1,100
2221,50,70,69,139,1,100
2222,50,175,175,350,1,100
2223,50,25,35,60,1,100
2224,50,2,9,11,1,100
2225,50,76,103,179,1,100
2226,50,99,198,297,1,100
2227,50,152,224,376,1,100
2228,50,117,239,356,1,100
2229,50,106,158,264,1,100
2230,50,31,36,67,1,100
2231,50,160,245,405,1,100
2232,50,127,214,341,1,100
2233,50,82,125,207,1,100
2234,50,80,132,212,1,100
2235,50,5,1,6,1,100
2236,50,131,405,536,1,100
2237,50,102,183,285,1,100
2238,50,54,87,141,1,100
2239,50,105,238,343,1,100
2240,50,157,197,354,1,100
2241,50,104,163,267,1,100
2242,50,27,49,76,1,100
2243,50,121,221,342,1,100
2244,50,32,92,124,1,100
2245,50,85,117,202,1,100
2246,50,164,222,386,1,100
2247,50,68,125,193,1,100
2248,50,96,115,211,1,100
2249,50,60,118,178,1,100
2250,50,76,98,174,1,100
2251,50,200,142,342,1,100
2252,50,90,51,141,1,100
2253,50,87,127,214,1,100
2254,50,87,183,270,1,100
2255,50,77,136,213,1,100
2256,50,37,65,102,1,100
2257,50,7,37,44,1,100
2258,50,14,41,55,1,100
2259,50,71,59,130,1,100
2260,50,134,215,349,1,100
2261,50,27,12,39,1,100
2262,50,43,90,133,1,100
2263,50,60,69,129,1,100
2264,50,88,192,280,1,100
2265,50,75,124,199,1,100
2266,50,147,252,399,1,100
2267,50,113,271,384,1,100
2268,50,69,113,182,1,100
2269,50,130,195,325,1,100
2270,50,24,126,150,1,100
2271,50,42,78,120,1,100
2272,50,129,230,359,1,100
2273,50,29,69,98,1,100
2274,50,62,161,223,1,100
2275,50,29,81,110,1,100
2276,50,20,55,75,1,100
2277,50,106,157,263,1,100
2278,50,72,175,247,1,100
2279,50,70,68,138,1,100
2280,50,80,182,262,1,100
2281,50,69,118,187,1,100
2282,50,145,193,338,1,100
2283,50,82,161,243,1,100
2284,50,126,141,267,1,100
2285,50,116,216,332,1,100
2286,50,76,119,195,1,100
2287,50,83,114,197,1,100
2288,50,39,64,103,1,100
2289,50,33,98,131,1,100
2290,50,40,111,151,1,100
2291,50,12,7,19,1,100
2292,50,8,45,53,1,100
2293,50,23,37,60,1,100
2294,50,73,57,130,1,100
2295,50,31,62,93,1,100
2296,50,100,148,248,1,100
2297,50,134,194,328,1,100
2298,50,50,116,166,1,100
2299,50,127,298,425,1,100
2300,50,76,127,203,1,100
2301,50,93,180,273,1,100
2302,50,101,161,262,1,100
2303,50,45,95,140,1,100
2304,50,21,64,85,1,100
2305,50,4,13,17,1,100
2306,50,61,121,182,1,100
2307,50,72,271,343,1,100
2308,50,147,133,280,1,100
2309,50,240,346,586,1,100
2310,50,81,134,215,1,100
2311,50,93,171,264,1,100
2312,50,142,236,378,1,100
2313,50,49,134,183,1,100
2314,50,107,232,339,1,100
2315,50,9,21,30,1,100
2316,50,78,133,211,1,100
2317,50,30,51,81,1,100
2318,50,35,55,90,1,100
2319,50,14,13,27,1,100
2320,50,116,225,341,1,100
2321,50,30,25,55,1,100
2322,50,170,187,357,1,100
2323,50,135,232,367,1,100
2324,50,126,247,373,1,100
2325,50,90,89,179,1,100
2326,50,42,66,108,1,100
2327,50,38,77,115,1,100
2328,50,100,95,195,1,100
2329,50,152,198,350,1,100
2330,50,33,9,42,1,100
2331,50,27,27,54,1,100
2332,50,131,199,330,1,100
2333,50,106,153,259,1,100
2334,50,5,11,16,1,100
2335,50,41,80,121,1,100
2336,50,126,152,278,1,100
2337,50,80,101,181,1,100
2338,50,148,317,465,1,100
2339,50,107,291,398,1,100
2340,50,59,89,148,1,100
2341,50,58,75,133,1,100
2342,50,87,113,200,1,100
2343,50,60,89,149,1,100
2344,50,109,191,300,1,100
2345,50,24,39,63,1,100
2346,50,89,108,197,1,100
2347,50,45,90,135,1,100
2348,50,65,135,200,1,100
2349,50,185,307,492,1,100
2350,50,80,108,188,1,100
2351,50,125,149,274,1,100
2352,50,38,73,111,1,100
2353,50,52,81,133,1,100
2354,50,176,202,378,1,100
2355,50,74,113,187,1,100
2356,50,29,66,95,1,100
2357,50,57,70,127,1,100
2358,50,43,29,72,1,100
2359,50,78,122,200,1,100
2360,50,94,134,228,1,100
2361,50,60,24,84,1,100
2362,50,52,90,142,1,100
2363,50,126,231,357,1,100
2364,50,48,79,127,1,100
2365,50,134,229,363,1,100
2366,50,117,163,280,1,100
2367,50,120,202,322,1,100
2368,50,61,107,168,1,100
2369,50,82,196,278,1,100
2370,50,209,245,454,1,100
2371,50,19,41,60,1,100
2372,50,159,149,308,1,100
2373,50,79,137,216,1,100
2374,50,43,113,156,1,100
2375,50,55,88,143,1,100
2376,50,140,165,305,1,100
2377,50,97,150,247,1,100
2378,50,165,338,503,1,100
2379,50,35,77,112,1,100
2380,50,77,92,169,1,100
2381,50,52,113,165,1,100
2382,50,75,92,167,1,100
2383,50,19,42,61,1,100
2384,50,60,79,139,1,100
2385,50,76,114,190,1,100
2386,50,89,85,174,1,100
2387,50,9,14,23,1,100
2388,50,37,53,90,1,100
2389,50,170,169,339,1,100
2390,50,138,273,411,1,100
2391,50,72,141,213,1,100
2392,50,93,168,261,1,100
2393,50,52,94,146,1,100
2394,50,28,75,103,1,100
2395,50,176,244,420,1,100
2396,50,159,245,404,1,100
2397,50,32,70,102,1,100
2398,50,14,37,51,1,100
2399,50,81,162,243,1,100
2400,50,59,82,141,1,100
2401,50,118,235,353,1,100
2402,50,66,170,236,1,100
2403,50,117,134,251,1,100
2404,50,71,183,254,1,100
2405,50,66,74,140,1,100
2406,50,67,132,199,1,100
2407,50,59,88,147,1,100
2408,50,93,117,210,1,100
2409,50,84,146,230,1,100
2410,50,70,120,190,1,100
2411,50,112,201,313,1,100
2412,50,93,149,242,1,100
2413,50,115,305,420,1,100
2414,50,63,95,158,1,100
2415,50,53,95,148,1,100
2416,50,56,90,146,1,100
2417,50,82,84,166,1,100
2418,50,68,94,162,1,100
2419,50,7,46,53,1,100
2420,50,32,67,99,1,100
2421,50,49,68,117,1,100
2422,50,70,79,149,1,100
2423,50,153,159,312,1,100
2424,50,49,110,159,1,100
2425,50,16,19,35,1,100
2426,50,68,78,146,1,100
2427,50,72,95,167,1,100
2428,50,94,97,191,1,100
2429,50,109,181,290,1,100
2430,50,167,156,323,1,100
2431,50,151,201,352,1,100
2432,50,42,82,124,1,100
2433,50,52,45,97,1,100
2434,50,69,65,134,1,100
2435,50,54,36,90,1,100
2436,50,23,74,97,1,100
2437,50,133,139,272,1,100
2438,50,108,146,254,1,100
2439,50,35,65,100,1,100
2440,50,213,280,493,1,100
2441,50,83,110,193,1,100
2442,50,91,125,216,1,100
2443,50,98,122,220,1,100
2444,50,111,180,291,1,100
2445,50,69,101,170,1,100
2446,50,77,95,172,1,100
2447,50,30,45,75,1,100
2448,50,55,112,167,1,100
2449,50,76,75,151,1,100
2450,50,82,141,223,1,100
2451,50,21,15,36,1,100
2452,50,103,143,246,1,100
2453,50,91,118,209,1,100
2454,50,49,98,147,1,100
2455,50,75,129,204,1,100
2456,50,25,39,64,1,100
2457,50,79,120,199,1,100
2458,50,93,103,196,1,100
2459,50,89,143,232,1,100
2460,50,105,145,250,1,100
2461,50,78,223,301,1,100
2462,50,22,40,62,1,100
2463,50,12,33,45,1,100
2464,50,135,197,332,1,100
2465,50,259,498,757,1,100
2466,50,90,114,204,1,100
2467,50,93,157,250,1,100
2468,50,59,101,160,1,100
2469,50,106,132,238,1,100
2470,50,48,43,91,1,100
2471,50,57,63,120,1,100
2472,50,95,167,262,1,100
2473,50,159,212,371,1,100
2474,50,96,190,286,1,100
2475,50,69,139,208,1,100
2476,50,326,337,663,1,100
2477,50,275,211,486,1,100
2478,50,28,59,87,1,100
2479,50,100,133,233,1,100
2480,50,85,144,229,1,100
2481,50,85,55,140,1,100
2482,50,57,156,213,1,100
2483,50,54,91,145,1,100
2484,50,52,95,147,1,100
2485,60,101,240,341,1,100
2486,60,157,376,533,1,100
2487,60,188,440,628,1,100
2488,60,128,259,387,1,100
2489,60,194,324,518,1,100
2490,60,85,170,255,1,100
2491,60,91,197,288,1,100
2492,60,102,187,289,1,100
2493,60,33,31,64,1,100
2494,60,104,188,292,1,100
2495,60,55,122,177,1,100
2496,60,169,293,462,1,100
2497,60,114,134,248,1,100
2498,60,84,77,161,1,100
2499,60,98,154,252,1,100
2500,60,146,223,369,1,100
2501,60,17,25,42,1,100
2502,60,122,146,268,1,100
2503,60,107,128,235,1,100
2504,60,122,331,453,1,100
2505,60,95,170,265,1,100
2506,60,84,214,298,1,100
2507,60,50,170,220,1,100
2508,60,123,306,429,1,100
2509,60,88,102,190,1,100
2510,60,90,290,380,1,100
2511,60,75,149,224,1,100
2512,60,113,211,324,1,100
2513,60,39,77,116,1,100
2514,60,51,131,182,1,100
2515,60,35,64,99,1,100
2516,60,47,58,105,1,100
2517,60,4,41,45,1,100
2518,60,46,85,131,1,100
2519,60,137,315,452,1,100
2520,60,103,154,257,1,100
2521,60,78,132,210,1,100
2522,60,165,248,413,1,100
2523,60,139,234,373,1,100
2524,60,88,159,247,1,100
2525,60,120,223,343,1,100
2526,60,79,114,193,1,100
2527,60,85,136,221,1,100
2528,60,78,127,205,1,100
2529,60,111,121,232,1,100
2530,60,63,123,186,1,100
2531,60,40,26,66,1,100
2532,60,121,229,350,1,100
2533,60,53,87,140,1,100
2534,60,137,137,274,1,100
2535,60,41,62,103,1,100
2536,60,77,127,204,1,100
2537,60,48,97,145,1,100
2538,60,47,34,81,1,100
2539,60,139,229,368,1,100
2540,60,99,145,244,1,100
2541,60,62,143,205,1,100
2542,60,36,57,93,1,100
2543,60,32,92,124,1,100
2544,60,30,15,45,1,100
2545,60,65,97,162,1,100
2546,60,112,193,305,1,100
2547,60,146,248,394,1,100
2548,60,85,188,273,1,100
2549,60,103,162,265,1,100
2550,60,90,74,164,1,100
2551,60,128,211,339,1,100
2552,60,63,147,210,1,100
2553,60,57,102,159,1,100
2554,60,68,162,230,1,100
2555,60,165,226,391,1,100
2556,60,58,97,155,1,100
2557,60,56,114,170,1,100
2558,60,130,220,350,1,100
2559,60,115,310,425,1,100
2560,60,46,113,159,1,100
2561,60,47,64,111,1,100
2562,60,48,96,144,1,100
2563,60,180,303,483,1,100
2564,60,53,94,147,1,100
2565,60,52,105,157,1,100
2566,60,121,212,333,1,100
2567,60,10,19,29,1,100
2568,60,34,109,143,1,100
2569,60,92,105,197,1,100
2570,60,174,261,435,1,100
2571,60,18,39,57,1,100
2572,60,167,116,283,1,100
2573,60,119,196,315,1,100
2574,60,50,91,141,1,100
2575,60,114,167,281,1,100
2576,60,98,232,330,1,100
2577,60,57,99,156,1,100
2578,60,122,138,260,1,100
2579,60,64,128,192,1,100
2580,60,11,42,53,1,100
2581,60,51,77,128,1,100
2582,60,69,165,234,1,100
2583,60,77,102,179,1,100
2584,60,85,175,260,1,100
2585,60,142,223,365,1,100
2586,60,145,278,423,1,100
2587,60,128,331,459,1,100
2588,60,125,237,362,1,100
2589,60,108,193,301,1,100
2590,60,67,110,177,1,100
2591,60,84,118,202,1,100
2592,60,69,138,207,1,100
2593,60,60,78,138,1,100
2594,60,75,66,141,1,100
2595,60,25,64,89,1,100
2596,60,8,13,21,1,100
2597,60,91,226,317,1,100
2598,60,133,187,320,1,100
2599,60,65,84,149,1,100
2600,60,115,103,218,1,100
2601,60,8,24,32,1,100
2602,60,163,231,394,1,100
2603,60,26,73,99,1,100
2604,60,131,313,444,1,100
2605,60,73,153,226,1,100
2606,60,33,31,64,1,100
2607,60,111,183,294,1,100
2608,60,48,88,136,1,100
2609,60,48,202,250,1,100
2610,60,65,137,202,1,100
2611,60,25,38,63,1,100
2612,60,95,127,222,1,100
2613,60,41,70,111,1,100
2614,60,62,83,145,1,100
2615,60,59,125,184,1,100
2616,60,48,146,194,1,100
2617,60,75,116,191,1,100
2618,60,72,163,235,1,100
2619,60,74,134,208,1,100
2620,60,40,89,129,1,100
2621,60,19,8,27,1,100
2622,60,27,95,122,1,100
2623,60,48,75,123,1,100
2624,60,108,203,311,1,100
2625,60,109,170,279,1,100
2626,60,65,108,173,1,100
2627,60,77,115,192,1,100
2628,60,71,187,258,1,100
2629,60,33,114,147,1,100
2630,60,28,68,96,1,100
2631,60,10,20,30,1,100
2632,60,33,162,195,1,100
2633,60,36,73,109,1,100
2634,60,25,75,100,1,100
2635,60,8,33,41,1,100
2636,60,84,108,192,1,100
2637,60,15,40,55,1,100
2638,60,51,112,163,1,100
2639,60,42,141,183,1,100
2640,60,107,188,295,1,100
2641,60,53,72,125,1,100
2642,60,183,350,533,1,100
2643,60,45,110,155,1,100
2644,60,56,133,189,1,100
2645,60,102,182,284,1,100
2646,60,72,143,215,1,100
2647,60,71,166,237,1,100
2648,60,39,95,134,1,100
2649,60,71,114,185,1,100
2650,60,33,114,147,1,100
2651,60,9,11,20,1,100
2652,60,11,25,36,1,100
2653,60,31,55,86,1,100
2654,60,50,88,138,1,100
2655,60,112,179,291,1,100
2656,60,74,114,188,1,100
2657,60,71,96,167,1,100
2658,60,55,66,121,1,100
2659,60,158,187,345,1,100
2660,60,177,282,459,1,100
2661,60,174,365,539,1,100
2662,60,34,56,90,1,100
2663,60,95,258,353,1,100
2664,60,55,97,152,1,100
2665,60,106,183,289,1,100
2666,60,40,61,101,1,100
2667,60,68,120,188,1,100
2668,60,36,47,83,1,100
2669,60,15,16,31,1,100
2670,60,113,292,405,1,100
2671,60,97,129,226,1,100
2672,60,99,196,295,1,100
2673,60,126,248,374,1,100
2674,60,109,266,375,1,100
2675,60,8,51,59,1,100
2676,60,65,89,154,1,100
2677,60,69,172,241,1,100
2678,60,48,75,123,1,100
2679,60,6,7,13,1,100
2680,60,77,126,203,1,100
2681,60,44,106,150,1,100
2682,60,54,135,189,1,100
2683,60,13,12,25,1,100
2684,60,70,160,230,1,100
2685,60,39,71,110,1,100
2686,60,58,175,233,1,100
2687,60,88,96,184,1,100
2688,60,282,376,658,1,100
2689,60,27,28,55,1,100
2690,60,14,39,53,1,100
2691,60,25,43,68,1,100
2692,60,14,27,41,1,100
2693,60,35,64,99,1,100
2694,60,3,8,11,1,100
2695,60,79,206,285,1,100
2696,60,142,281,423,1,100
2697,60,64,124,188,1,100
2698,60,34,58,92,1,100
2699,60,71,178,249,1,100
2700,60,51,85,136,1,100
2701,60,38,93,131,1,100
2702,60,127,172,299,1,100
2703,60,72,87,159,1,100
2704,60,63,120,183,1,100
2705,60,104,147,251,1,100
2706,60,14,37,51,1,100
2707,60,70,87,157,1,100
2708,60,84,144,228,1,100
2709,60,23,41,64,1,100
2710,60,14,19,33,1,100
2711,60,16,22,38,1,100
2712,60,10,41,51,1,100
2713,60,92,129,221,1,100
2714,60,70,122,192,1,100
2715,60,63,128,191,1,100
2716,60,85,100,185,1,100
2717,60,71,90,161,1,100
2718,60,149,209,358,1,100
2719,60,94,91,185,1,100
2720,60,52,100,152,1,100
2721,60,47,116,163,1,100
2722,60,31,23,54,1,100
2723,60,51,104,155,1,100
2724,60,75,150,225,1,100
2725,60,106,150,256,1,100
2726,60,46,90,136,1,100
2727,60,105,140,245,1,100
2728,60,54,84,138,1,100
2729,60,34,166,200,1,100
2730,60,142,201,343,1,100
2731,60,96,161,257,1,100
2732,60,58,101,159,1,100
2733,60,88,174,262,1,100
2734,60,93,102,195,1,100
2735,60,28,104,132,1,100
2736,60,44,148,192,1,100
2737,60,37,55,92,1,100
2738,60,98,184,282,1,100
2739,60,140,235,375,1,100
2740,60,82,127,209,1,100
2741,60,149,291,440,1,100
2742,60,49,112,161,1,100
2743,60,6,33,39,1,100
2744,60,101,112,213,1,100
2745,60,24,62,86,1,100
2746,60,89,188,277,1,100
2747,60,34,66,100,1,100
2748,60,94,215,309,1,100
2749,60,91,179,270,1,100
2750,60,94,87,181,1,100
2751,60,77,96,173,1,100
2752,60,101,118,219,1,100
2753,60,65,140,205,1,100
2754,60,105,143,248,1,100
2755,60,183,218,401,1,100
2756,60,74,74,148,1,100
2757,60,87,106,193,1,100
2758,60,69,114,183,1,100
2759,60,147,176,323,1,100
2760,60,139,176,315,1,100
2761,60,83,113,196,1,100
2762,60,25,5,30,1,100
2763,60,24,60,84,1,100
2764,60,87,149,236,1,100
2765,60,38,79,117,1,100
2766,60,168,158,326,1,100
2767,60,111,65,176,1,100
2768,60,104,73,177,1,100
2769,60,58,141,199,1,100
2770,60,172,352,524,1,100
2771,60,93,100,193,1,100
2772,60,45,98,143,1,100
2773,60,118,215,333,1,100
2774,60,54,72,126,1,100
2775,60,35,91,126,1,100
2776,60,37,63,100,1,100
2777,60,42,31,73,1,100
2778,60,80,209,289,1,100
2779,60,42,77,119,1,100
2780,60,185,251,436,1,100
2781,60,85,137,222,1,100
2782,60,97,251,348,1,100
2783,60,100,307,407,1,100
2784,60,133,207,340,1,100
2785,60,74,124,198,1,100
2786,60,96,146,242,1,100
2787,60,178,295,473,1,100
2788,60,71,169,240,1,100
2789,60,120,142,262,1,100
2790,60,89,89,178,1,100
2791,60,94,115,209,1,100
2792,60,77,176,253,1,100
2793,60,154,298,452,1,100
2794,60,186,420,606,1,100
2795,60,110,186,296,1,100
2796,60,130,305,435,1,100
2797,60,103,191,294,1,100
2798,60,40,90,130,1,100
2799,60,39,48,87,1,100
2800,60,9,15,24,1,100
2801,60,60,173,233,1,100
2802,60,22,22,44,1,100
2803,60,51,100,151,1,100
2804,60,111,285,396,1,100
2805,60,162,334,496,1,100
2806,60,55,84,139,1,100
2807,60,59,152,211,1,100
2808,60,68,134,202,1,100
2809,60,52,92,144,1,100
2810,60,43,85,128,1,100
2811,60,8,28,36,1,100
2812,60,32,70,102,1,100
2813,60,25,85,110,1,100
2814,60,21,77,98,1,100
2815,60,10,40,50,1,100
2816,60,12,6,18,1,100
2817,60,77,114,191,1,100
2818,60,55,108,163,1,100
2819,60,169,236,405,1,100
2820,60,132,133,265,1,100
2821,60,88,109,197,1,100
2822,60,90,358,448,1,100
2823,60,89,306,395,1,100
2824,60,49,87,136,1,100
2825,60,38,60,98,1,100
2826,60,102,161,263,1,100
2827,60,97,79,176,1,100
2828,60,39,78,117,1,100
2829,60,145,217,362,1,100
2830,60,98,142,240,1,100
2831,60,61,70,131,1,100
2832,60,59,83,142,1,100
2833,60,68,100,168,1,100
2834,60,122,245,367,1,100
2835,60,117,118,235,1,100
2836,60,92,123,215,1,100
2837,60,63,101,164,1,100
2838,60,84,199,283,1,100
2839,60,69,96,165,1,100
2840,60,88,194,282,1,100
2841,60,93,174,267,1,100
2842,60,98,172,270,1,100
2843,60,101,158,259,1,100
2844,60,124,259,383,1,100
2845,60,54,67,121,1,100
2846,60,110,232,342,1,100
2847,60,84,118,202,1,100
2848,60,62,171,233,1,100
2849,60,100,213,313,1,100
2850,60,40,63,103,1,100
2851,60,139,151,290,1,100
2852,60,20,50,70,1,100
2853,60,100,295,395,1,100
2854,60,125,244,369,1,100
2855,60,82,86,168,1,100
2856,60,61,113,174,1,100
2857,60,136,282,418,1,100
2858,60,115,134,249,1,100
2859,60,70,102,172,1,100
2860,60,80,186,266,1,100
2861,60,31,93,124,1,100
2862,60,57,81,138,1,100
2863,75,123,254,377,1,100
2864,75,78,215,293,1,100
2865,75,47,65,112,1,100
2866,75,171,285,456,1,100
2867,75,132,221,353,1,100
2868,75,86,112,198,1,100
2869,75,64,53,117,1,100
2870,75,206,416,622,1,100
2871,75,125,207,332,1,100
2872,75,64,120,184,1,100
2873,75,86,58,144,1,100
2874,75,138,178,316,1,100
2875,75,42,70,112,1,100
2876,75,61,117,178,1,100
2877,75,45,149,194,1,100
2878,75,57,136,193,1,100
2879,75,36,113,149,1,100
2880,75,75,208,283,1,100
2881,75,67,154,221,1,100
2882,75,36,52,88,1,100
2883,75,26,55,81,1,100
2884,75,57,135,192,1,100
2885,75,58,132,190,1,100
2886,75,59,79,138,1,100
2887,75,64,100,164,1,100
2888,75,54,106,160,1,100
2889,75,194,332,526,1,100
2890,75,153,206,359,1,100
2891,75,121,204,325,1,100
2892,75,110,228,338,1,100
2893,75,122,131,253,1,100
2894,75,155,366,521,1,100
2895,75,88,264,352,1,100
2896,75,131,203,334,1,100
2897,75,88,159,247,1,100
2898,75,41,81,122,1,100
2899,75,133,243,376,1,100
2900,75,32,22,54,1,100
2901,75,88,144,232,1,100
2902,75,151,167,318,1,100
2903,75,82,223,305,1,100
2904,75,43,90,133,1,100
2905,75,38,78,116,1,100
2906,75,82,205,287,1,100
2907,75,122,224,346,1,100
2908,75,39,134,173,1,100
2909,75,130,253,383,1,100
2910,75,48,104,152,1,100
2911,75,118,291,409,1,100
2912,75,31,74,105,1,100
2913,75,107,129,236,1,100
2914,75,44,69,113,1,100
2915,75,116,250,366,1,100
2916,75,93,160,253,1,100
2917,75,103,140,243,1,100
2918,75,104,229,333,1,100
2919,75,74,88,162,1,100
2920,75,104,144,248,1,100
2921,75,139,276,415,1,100
2922,75,64,113,177,1,100
2923,75,85,173,258,1,100
2924,75,150,210,360,1,100
2925,75,147,274,421,1,100
2926,75,109,255,364,1,100
2927,75,256,423,679,1,100
2928,75,117,249,366,1,100
2929,75,108,172,280,1,100
2930,75,101,68,169,1,100
2931,75,74,78,152,1,100
2932,75,86,113,199,1,100
2933,75,102,167,269,1,100
2934,75,160,230,390,1,100
2935,75,57,126,183,1,100
2936,75,146,185,331,1,100
2937,75,127,149,276,1,100
2938,75,34,55,89,1,100
2939,75,68,81,149,1,100
2940,75,45,95,140,1,100
2941,75,81,116,197,1,100
2942,75,94,250,344,1,100
2943,75,100,253,353,1,100
2944,75,156,355,511,1,100
2945,75,103,206,309,1,100
2946,75,84,190,274,1,100
2947,75,157,369,526,1,100
2948,75,169,137,306,1,100
2949,75,107,244,351,1,100
2950,75,106,223,329,1,100
2951,75,46,94,140,1,100
2952,75,99,192,291,1,100
2953,75,68,187,255,1,100
2954,75,109,174,283,1,100
2955,75,156,202,358,1,100
2956,75,143,192,335,1,100
2957,75,56,107,163,1,100
2958,75,74,105,179,1,100
2959,75,138,248,386,1,100
2960,75,180,318,498,1,100
2961,75,69,131,200,1,100
2962,75,87,196,283,1,100
2963,75,107,182,289,1,100
2964,75,127,194,321,1,100
2965,75,39,119,158,1,100
2966,75,11,48,59,1,100
2967,75,38,103,141,1,100
2968,75,66,159,225,1,100
2969,75,87,102,189,1,100
2970,75,156,266,422,1,100
2971,75,189,387,576,1,100
2972,75,132,231,363,1,100
2973,75,112,263,375,1,100
2974,75,68,144,212,1,100
2975,75,140,282,422,1,100
2976,75,181,340,521,1,100
2977,75,48,94,142,1,100
2978,75,14,69,83,1,100
2979,75,74,92,166,1,100
2980,75,105,196,301,1,100
2981,75,81,109,190,1,100
2982,75,115,241,356,1,100
2983,75,44,106,150,1,100
2984,75,68,130,198,1,100
2985,75,74,170,244,1,100
2986,75,99,194,293,1,100
2987,75,151,305,456,1,100
2988,75,42,114,156,1,100
2989,75,63,93,156,1,100
2990,75,65,99,164,1,100
2991,75,19,31,50,1,100
2992,75,39,52,91,1,100
2993,75,40,48,88,1,100
2994,75,129,256,385,1,100
2995,75,93,163,256,1,100
2996,75,54,108,162,1,100
2997,75,238,426,664,1,100
2998,75,111,197,308,1,100
2999,75,122,210,332,1,100
3000,75,245,289,534,1,100
3001,75,98,168,266,1,100
3002,75,76,137,213,1,100
3003,75,215,547,762,1,100
3004,75,125,119,244,1,100
3005,75,115,208,323,1,100
3006,75,128,144,272,1,100
3007,75,127,225,352,1,100
3008,75,82,59,141,1,100
3009,75,57,82,139,1,100
3010,75,74,95,169,1,100
3011,75,106,135,241,1,100
3012,75,63,93,156,1,100
3013,75,32,44,76,1,100
3014,75,32,75,107,1,100
3015,75,9,22,31,1,100
3016,75,53,116,169,1,100
3017,75,60,80,140,1,100
3018,75,24,37,61,1,100
3019,75,96,171,267,1,100
3020,75,36,44,80,1,100
3021,75,93,157,250,1,100
3022,75,98,110,208,1,100
3023,75,25,50,75,1,100
3024,75,51,96,147,1,100
3025,75,64,95,159,1,100
3026,75,96,230,326,1,100
3027,75,92,238,330,1,100
3028,75,95,202,297,1,100
3029,75,74,190,264,1,100
3030,75,81,193,274,1,100
3031,75,170,139,309,1,100
3032,75,58,128,186,1,100
3033,75,111,151,262,1,100
3034,75,27,50,77,1,100
3035,75,12,74,86,1,100
3036,75,72,146,218,1,100
3037,75,43,93,136,1,100
3038,75,31,36,67,1,100
3039,75,44,93,137,1,100
3040,75,63,169,232,1,100
3041,75,153,335,488,1,100
3042,75,96,128,224,1,100
3043,75,51,145,196,1,100
3044,75,97,136,233,1,100
3045,75,66,118,184,1,100
3046,75,17,11,28,1,100
3047,75,90,194,284,1,100
3048,75,104,306,410,1,100
3049,75,60,208,268,1,100
3050,75,80,242,322,1,100
3051,75,25,172,197,1,100
3052,75,66,169,235,1,100
3053,75,108,290,398,1,100
3054,75,38,34,72,1,100
3055,75,132,309,441,1,100
3056,75,40,132,172,1,100
3057,75,75,225,300,1,100
3058,75,80,144,224,1,100
3059,75,53,109,162,1,100
3060,75,86,117,203,1,100
3061,75,85,130,215,1,100
3062,75,224,386,610,1,100
3063,75,141,259,400,1,100
3064,75,58,162,220,1,100
3065,75,114,214,328,1,100
3066,75,58,170,228,1,100
3067,75,14,79,93,1,100
3068,75,133,255,388,1,100
3069,75,43,143,186,1,100
3070,75,98,264,362,1,100
3071,75,115,347,462,1,100
3072,75,100,317,417,1,100
3073,75,120,283,403,1,100
3074,75,80,172,252,1,100
3075,75,85,209,294,1,100
3076,75,48,104,152,1,100
3077,75,76,89,165,1,100
3078,75,153,316,469,1,100
3079,75,26,43,69,1,100
3080,75,88,192,280,1,100
3081,75,110,281,391,1,100
3082,75,197,267,464,1,100
3083,75,95,218,313,1,100
3084,75,150,248,398,1,100
3085,75,73,196,269,1,100
3086,75,31,10,41,1,100
3087,75,17,49,66,1,100
3088,75,102,165,267,1,100
3089,75,51,67,118,1,100
3090,75,202,304,506,1,100
3091,75,33,53,86,1,100
3092,75,94,202,296,1,100
3093,75,22,19,41,1,100
3094,75,120,184,304,1,100
3095,75,89,136,225,1,100
3096,75,69,43,112,1,100
3097,75,117,181,298,1,100
3098,75,98,80,178,1,100
3099,75,67,101,168,1,100
3100,75,93,131,224,1,100
3101,75,77,114,191,1,100
3102,75,28,109,137,1,100
3103,75,72,124,196,1,100
3104,75,66,96,162,1,100
3105,75,57,90,147,1,100
3106,75,222,172,394,1,100
3107,75,60,82,142,1,100
3108,75,24,72,96,1,100
3109,75,66,72,138,1,100
3110,75,45,132,177,1,100
3111,75,28,82,110,1,100
3112,75,74,189,263,1,100
3113,75,118,183,301,1,100
3114,75,136,305,441,1,100
3115,75,152,345,497,1,100
3116,75,58,125,183,1,100
3117,75,127,283,410,1,100
3118,75,28,26,54,1,100
3119,75,178,246,424,1,100
3120,75,105,262,367,1,100
3121,75,53,105,158,1,100
3122,75,28,24,52,1,100
3123,75,68,161,229,1,100
3124,75,48,75,123,1,100
3125,75,171,435,606,1,100
3126,75,48,88,136,1,100
3127,75,81,166,247,1,100
3128,75,77,96,173,1,100
3129,75,177,197,374,1,100
3130,75,111,271,382,1,100
3131,75,30,72,102,1,100
3132,75,71,167,238,1,100
3133,75,11,15,26,1,100
3134,75,80,203,283,1,100
3135,75,22,40,62,1,100
3136,75,87,139,226,1,100
3137,75,48,114,162,1,100
3138,75,90,174,264,1,100
3139,75,138,309,447,1,100
3140,75,107,237,344,1,100
3141,75,77,182,259,1,100
3142,75,33,100,133,1,100
3143,75,137,80,217,1,100
3144,75,45,63,108,1,100
3145,75,22,96,118,1,100
3146,75,47,128,175,1,100
3147,75,63,151,214,1,100
3148,75,150,298,448,1,100
3149,75,125,193,318,1,100
3150,75,190,247,437,1,100
3151,75,88,196,284,1,100
3152,75,141,233,374,1,100
3153,75,152,184,336,1,100
3154,75,57,198,255,1,100
3155,75,109,180,289,1,100
3156,75,84,142,226,1,100
3157,75,216,319,535,1,100
3158,75,89,113,202,1,100
3159,75,79,79,158,1,100
3160,75,208,264,472,1,100
3161,75,85,115,200,1,100
3162,75,96,143,239,1,100
3163,75,200,372,572,1,100
3164,75,64,278,342,1,100
3165,75,101,181,282,1,100
3166,75,52,189,241,1,100
3167,75,67,81,148,1,100
3168,75,40,67,107,1,100
3169,75,67,152,219,1,100
3170,75,18,12,30,1,100
3171,75,79,121,200,1,100
3172,75,90,255,345,1,100
3173,75,100,159,259,1,100
3174,75,160,194,354,1,100
3175,75,149,338,487,1,100
3176,75,72,174,246,1,100
3177,75,252,381,633,1,100
3178,75,163,209,372,1,100
3179,75,124,178,302,1,100
3180,75,91,242,333,1,100
3181,75,68,155,223,1,100
3182,75,108,130,238,1,100
3183,75,95,146,241,1,100
3184,75,67,77,144,1,100
3185,75,85,168,253,1,100
3186,75,61,107,168,1,100
3187,75,93,228,321,1,100
3188,75,34,68,102,1,100
3189,75,46,83,129,1,100
3190,75,70,161,231,1,100
3191,75,11,62,73,1,100
3192,75,84,172,256,1,100
3193,75,108,133,241,1,100
3194,75,155,219,374,1,100
3195,75,25,108,133,1,100
3196,75,71,87,158,1,100
3197,75,101,145,246,1,100
3198,75,95,124,219,1,100
3199,75,188,342,530,1,100
3200,75,75,131,206,1,100
3201,75,204,384,588,1,100
3202,75,87,190,277,1,100
3203,75,36,107,143,1,100
3204,75,76,392,468,1,100
3205,75,51,182,233,1,100
3206,75,44,96,140,1,100
3207,75,45,86,131,1,100
3208,75,83,167,250,1,100
3209,75,138,199,337,1,100
3210,75,130,260,390,1,100
3211,75,115,186,301,1,100
3212,75,128,163,291,1,100
3213,75,109,202,311,1,100
3214,75,171,273,444,1,100
3215,75,195,312,507,1,100
3216,75,56,134,190,1,100
3217,75,178,253,431,1,100
3218,75,23,71,94,1,100
3219,75,53,172,225,1,100
3220,75,3,26,29,1,100
3221,75,146,238,384,1,100
3222,75,154,300,454,1,100
3223,75,52,30,82,1,100
3224,75,65,161,226,1,100
3225,75,25,65,90,1,100
3226,75,66,97,163,1,100
3227,75,106,89,195,1,100
3228,75,133,78,211,1,100
3229,75,41,187,228,1,100
3230,75,115,107,222,1,100
3231,75,70,189,259,1,100
3232,75,98,201,299,1,100
3233,75,97,275,372,1,100
3234,75,83,178,261,1,100
3235,75,50,70,120,1,100
3236,75,235,353,588,1,100
3237,75,65,136,201,1,100
3238,75,226,238,464,1,100
3239,75,147,202,349,1,100
3240,75,210,165,375,1,100
3241,75,106,183,289,1,100
3242,75,61,114,175,1,100
3243,75,90,244,334,1,100
3244,75,92,74,166,1,100
3245,75,72,135,207,1,100
3246,75,33,96,129,1,100
3247,75,82,128,210,1,100
3248,75,40,99,139,1,100
3249,90,49,158,207,1,100
3250,90,258,198,456,1,100
3251,90,86,352,438,1,100
3252,90,126,231,357,1,100
3253,90,61,142,203,1,100
3254,90,64,108,172,1,100
3255,90,301,681,982,1,100
3256,90,33,97,130,1,100
3257,90,42,102,144,1,100
3258,90,33,37,70,1,100
3259,90,19,53,72,1,100
3260,90,112,170,282,1,100
3261,90,81,131,212,1,100
3262,90,77,64,141,1,100
3263,90,88,154,242,1,100
3264,90,46,76,122,1,100
3265,90,162,298,460,1,100
3266,90,98,209,307,1,100
3267,90,133,185,318,1,100
3268,90,55,33,88,1,100
3269,90,69,117,186,1,100
3270,90,114,218,332,1,100
3271,90,128,197,325,1,100
3272,90,105,147,252,1,100
3273,90,45,116,161,1,100
3274,90,90,144,234,1,100
3275,90,58,68,126,1,100
3276,90,136,371,507,1,100
3277,90,9,51,60,1,100
3278,90,81,104,185,1,100
3279,90,108,224,332,1,100
3280,90,152,375,527,1,100
3281,90,63,76,139,1,100
3282,90,169,293,462,1,100
3283,90,93,151,244,1,100
3284,90,91,151,242,1,100
3285,90,94,61,155,1,100
3286,90,49,183,232,1,100
3287,90,65,182,247,1,100
3288,90,29,77,106,1,100
3289,90,97,172,269,1,100
3290,90,24,76,100,1,100
3291,90,81,186,267,1,100
3292,90,97,135,232,1,100
3293,90,103,164,267,1,100
3294,90,68,83,151,1,100
3295,90,124,277,401,1,100
3296,90,50,114,164,1,100
3297,90,88,206,294,1,100
3298,90,132,139,271,1,100
3299,90,120,189,309,1,100
3300,90,67,156,223,1,100
3301,90,48,170,218,1,100
3302,90,176,269,445,1,100
3303,90,89,218,307,1,100
3304,90,53,100,153,1,100
3305,90,10,22,32,1,100
3306,90,46,37,83,1,100
3307,90,68,158,226,1,100
3308,90,147,263,410,1,100
3309,90,84,142,226,1,100
3310,90,69,161,230,1,100
3311,90,111,219,330,1,100
3312,90,68,85,153,1,100
3313,90,138,454,592,1,100
3314,90,48,105,153,1,100
3315,90,62,116,178,1,100
3316,90,24,72,96,1,100
3317,90,72,167,239,1,100
3318,90,28,62,90,1,100
3319,90,15,34,49,1,100
3320,90,27,21,48,1,100
3321,90,121,299,420,1,100
3322,90,81,210,291,1,100
3323,90,71,127,198,1,100
3324,90,112,144,256,1,100
3325,90,173,287,460,1,100
3326,90,190,305,495,1,100
3327,90,65,129,194,1,100
3328,90,68,117,185,1,100
3329,90,37,132,169,1,100
3330,90,41,90,131,1,100
3331,90,53,110,163,1,100
3332,90,48,120,168,1,100
3333,90,120,296,416,1,100
3334,90,82,140,222,1,100
3335,90,110,289,399,1,100
3336,90,101,273,374,1,100
3337,90,48,144,192,1,100
3338,90,65,146,211,1,100
3339,90,328,260,588,1,100
3340,90,64,101,165,1,100
3341,90,30,96,126,1,100
3342,90,80,146,226,1,100
3343,90,94,200,294,1,100
3344,90,26,53,79,1,100
3345,90,122,171,293,1,100
3346,90,82,84,166,1,100
3347,90,34,72,106,1,100
3348,90,89,174,263,1,100
3349,90,44,56,100,1,100
3350,90,76,102,178,1,100
3351,90,76,56,132,1,100
3352,90,118,252,370,1,100
3353,90,20,37,57,1,100
3354,90,13,32,45,1,100
3355,90,55,105,160,1,100
3356,90,48,30,78,1,100
3357,90,67,118,185,1,100
3358,90,165,224,389,1,100
3359,90,59,104,163,1,100
3360,90,73,167,240,1,100
3361,90,18,42,60,1,100
3362,90,27,85,112,1,100
3363,90,94,98,192,1,100
3364,90,78,105,183,1,100
3365,90,45,76,121,1,100
3366,90,41,74,115,1,100
3367,90,43,70,113,1,100
3368,90,51,108,159,1,100
3369,90,39,43,82,1,100
3370,90,22,53,75,1,100
3371,90,51,62,113,1,100
3372,90,169,322,491,1,100
3373,90,92,144,236,1,100
3374,90,123,320,443,1,100
3375,90,115,214,329,1,100
3376,90,226,483,709,1,100
3377,90,178,410,588,1,100
3378,90,66,133,199,1,100
3379,90,91,140,231,1,100
3380,90,4,32,36,1,100
3381,90,30,53,83,1,100
3382,90,49,126,175,1,100
3383,90,65,141,206,1,100
3384,90,103,400,503,1,100
3385,90,126,228,354,1,100
3386,90,74,161,235,1,100
3387,90,17,36,53,1,100
3388,90,178,331,509,1,100
3389,90,77,159,236,1,100
3390,90,95,207,302,1,100
3391,90,66,144,210,1,100
3392,90,82,110,192,1,100
3393,90,98,213,311,1,100
3394,90,5,15,20,1,100
3395,90,88,160,248,1,100
3396,90,147,226,373,1,100
3397,90,110,139,249,1,100
3398,90,88,208,296,1,100
3399,90,49,66,115,1,100
3400,90,117,155,272,1,100
3401,90,86,150,236,1,100
3402,90,186,478,664,1,100
3403,90,12,74,86,1,100
3404,90,40,42,82,1,100
3405,90,71,115,186,1,100
3406,90,50,96,146,1,100
3407,90,101,131,232,1,100
3408,90,18,38,56,1,100
3409,90,16,36,52,1,100
3410,90,102,185,287,1,100
3411,90,25,41,66,1,100
3412,90,115,371,486,1,100
3413,90,81,214,295,1,100
3414,90,188,303,491,1,100
3415,90,103,143,246,1,100
3416,90,47,130,177,1,100
3417,90,82,102,184,1,100
3418,90,97,274,371,1,100
3419,90,55,112,167,1,100
3420,90,67,117,184,1,100
3421,90,40,158,198,1,100
3422,90,135,183,318,1,100
3423,90,84,177,261,1,100
3424,90,110,191,301,1,100
3425,90,86,105,191,1,100
3426,90,64,268,332,1,100
3427,90,57,87,144,1,100
3428,90,39,59,98,1,100
3429,90,11,42,53,1,100
3430,90,94,143,237,1,100
3431,90,33,97,130,1,100
3432,90,57,109,166,1,100
3433,90,0,2,2,1,100
3434,90,50,113,163,1,100
3435,90,12,49,61,1,100
3436,90,55,124,179,1,100
3437,90,69,125,194,1,100
3438,90,94,226,320,1,100
3439,90,81,206,287,1,100
3440,90,132,221,353,1,100
3441,90,58,93,151,1,100
3442,90,111,93,204,1,100
3443,90,59,84,143,1,100
3444,90,23,57,80,1,100
3445,90,26,115,141,1,100
3446,90,69,114,183,1,100
3447,90,99,143,242,1,100
3448,90,112,186,298,1,100
3449,90,128,130,258,1,100
3450,90,91,217,308,1,100
3451,90,102,169,271,1,100
3452,90,38,35,73,1,100
3453,90,55,63,118,1,100
3454,90,96,118,214,1,100
3455,90,31,65,96,1,100
3456,90,36,84,120,1,100
3457,90,65,119,184,1,100
3458,90,129,183,312,1,100
3459,90,122,153,275,1,100
3460,90,45,130,175,1,100
3461,90,69,175,244,1,100
3462,90,148,246,394,1,100
3463,90,190,397,587,1,100
3464,90,109,174,283,1,100
3465,90,89,234,323,1,100
3466,90,18,32,50,1,100
3467,90,60,98,158,1,100
3468,90,75,127,202,1,100
3469,90,87,136,223,1,100
3470,90,97,224,321,1,100
3471,90,97,154,251,1,100
3472,90,156,416,572,1,100
3473,90,86,188,274,1,100
3474,90,70,195,265,1,100
3475,90,27,91,118,1,100
3476,90,21,36,57,1,100
3477,90,57,47,104,1,100
3478,90,99,175,274,1,100
3479,90,31,65,96,1,100
3480,90,142,219,361,1,100
3481,90,46,116,162,1,100
3482,90,96,152,248,1,100
3483,90,75,139,214,1,100
3484,90,48,102,150,1,100
3485,90,110,151,261,1,100
3486,90,147,156,303,1,100
3487,90,30,55,85,1,100
3488,90,79,194,273,1,100
3489,90,49,49,98,1,100
3490,90,26,87,113,1,100
3491,90,20,45,65,1,100
3492,90,43,101,144,1,100
3493,90,105,179,284,1,100
3494,90,98,158,256,1,100
3495,90,50,137,187,1,100
3496,90,110,283,393,1,100
3497,90,73,198,271,1,100
3498,90,239,481,720,1,100
3499,90,70,113,183,1,100
3500,90,60,82,142,1,100
3501,90,187,288,475,1,100
3502,90,45,88,133,1,100
3503,90,29,36,65,1,100
3504,90,91,111,202,1,100
3505,90,59,105,164,1,100
3506,90,98,75,173,1,100
3507,90,76,83,159,1,100
3508,90,33,57,90,1,100
3509,90,46,48,94,1,100
3510,90,51,70,121,1,100
3511,90,104,143,247,1,100
3512,90,97,167,264,1,100
3513,90,88,253,341,1,100
3514,90,106,253,359,1,100
3515,90,48,93,141,1,100
3516,90,106,216,322,1,100
3517,90,69,129,198,1,100
3518,90,21,67,88,1,100
3519,90,70,117,187,1,100
3520,90,84,112,196,1,100
3521,90,119,126,245,1,100
3522,90,30,63,93,1,100
3523,90,47,31,78,1,100
3524,90,59,123,182,1,100
3525,90,56,150,206,1,100
3526,90,71,209,280,1,100
3527,90,49,51,100,1,100
3528,90,37,145,182,1,100
3529,90,62,160,222,1,100
3530,90,55,133,188,1,100
3531,90,72,48,120,1,100
3532,90,70,160,230,1,100
3533,90,30,91,121,1,100
3534,90,73,107,180,1,100
3535,90,3,10,13,1,100
3536,90,83,208,291,1,100
3537,90,190,425,615,1,100
3538,90,58,220,278,1,100
3539,90,99,233,332,1,100
3540,90,112,165,277,1,100
3541,90,232,446,678,1,100
3542,90,49,78,127,1,100
3543,90,39,52,91,1,100
3544,90,18,36,54,1,100
3545,90,38,117,155,1,100
3546,90,118,139,257,1,100
3547,90,44,92,136,1,100
3548,90,36,79,115,1,100
3549,90,138,224,362,1,100
3550,90,88,112,200,1,100
3551,90,18,47,65,1,100
3552,90,5,14,19,1,100
3553,90,44,99,143,1,100
3554,90,57,224,281,1,100
3555,90,75,153,228,1,100
3556,90,81,145,226,1,100
3557,90,29,94,123,1,100
3558,90,106,168,274,1,100
3559,90,97,218,315,1,100
3560,90,59,138,197,1,100
3561,90,35,84,119,1,100
3562,90,208,228,436,1,100
3563,90,60,123,183,1,100
3564,90,40,75,115,1,100
3565,90,57,131,188,1,100
3566,90,47,94,141,1,100
3567,90,72,154,226,1,100
3568,90,107,238,345,1,100
3569,90,165,272,437,1,100
3570,90,129,282,411,1,100
3571,90,27,76,103,1,100
3572,90,121,314,435,1,100
3573,90,46,64,110,1,100
3574,90,91,144,235,1,100
3575,90,26,92,118,1,100
3576,90,122,273,395,1,100
3577,90,28,66,94,1,100
3578,90,51,72,123,1,100
3579,90,66,168,234,1,100
3580,90,82,309,391,1,100
3581,90,50,131,181,1,100
3582,90,207,350,557,1,100
3583,90,183,221,404,1,100
3584,90,80,154,234,1,100
3585,90,94,334,428,1,100
3586,90,55,120,175,1,100
3587,90,132,329,461,1,100
3588,90,82,132,214,1,100
3589,90,66,79,145,1,100
3590,90,110,176,286,1,100
3591,90,96,145,241,1,100
3592,90,38,83,121,1,100
3593,90,78,105,183,1,100
3594,90,51,112,163,1,100
3595,90,47,74,121,1,100
3596,90,83,203,286,1,100
3597,90,24,32,56,1,100
3598,90,50,94,144,1,100
3599,90,74,105,179,1,100
3600,90,103,182,285,1,100
3601,90,82,109,191,1,100
3602,90,38,71,109,1,100
3603,90,38,86,124,1,100
3604,90,89,126,215,1,100
3605,90,62,148,210,1,100
3606,90,104,223,327,1,100
3607,90,78,69,147,1,100
3608,90,71,138,209,1,100
3609,90,114,165,279,1,100
3610,90,72,100,172,1,100
3611,90,46,118,164,1,100
3612,90,115,161,276,1,100
3613,90,51,59,110,1,100
3614,90,42,121,163,1,100
3615,90,47,131,178,1,100
3616,90,65,124,189,1,100
3617,90,83,149,232,1,100
3618,90,25,77,102,1,100
3619,90,122,218,340,1,100
3620,90,9,14,23,1,100
3621,90,58,127,185,1,100
3622,90,111,170,281,1,100
3623,90,51,93,144,1,100
3624,90,37,59,96,1,100
3625,90,63,77,140,1,100
3626,90,82,129,211,1,100
3627,90,122,246,368,1,100
3628,90,39,81,120,1,100
3629,90,89,183,272,1,100
3630,90,96,189,285,1,100
3631,90,45,134,179,1,100
3632,90,104,186,290,1,100
3633,90,22,38,60,1,100
3634,90,46,49,95,1,100
3635,90,78,106,184,1,100
3636,90,73,107,180,1,100
3637,90,53,155,208,1,100
3638,120,38,161,199,1,100
3639,120,53,193,246,1,100
3640,120,13,43,56,1,100
3641,120,95,240,335,1,100
3642,120,74,133,207,1,100
3643,120,72,177,249,1,100
3644,120,95,157,252,1,100
3645,120,27,66,93,1,100
3646,120,109,254,363,1,100
3647,120,71,172,243,1,100
3648,120,9,18,27,1,100
3649,120,25,69,94,1,100
3650,120,43,68,111,1,100
3651,120,51,71,122,1,100
3652,120,35,122,157,1,100
3653,120,84,64,148,1,100
3654,120,95,81,176,1,100
3655,120,36,34,70,1,100
3656,120,129,229,358,1,100
3657,120,52,110,162,1,100
3658,120,64,172,236,1,100
3659,120,118,109,227,1,100
3660,120,119,212,331,1,100
3661,120,77,146,223,1,100
3662,120,27,47,74,1,100
3663,120,81,124,205,1,100
3664,120,42,105,147,1,100
3665,120,33,66,99,1,100
3666,120,7,23,30,1,100
3667,120,34,62,96,1,100
3668,120,42,54,96,1,100
3669,120,57,103,160,1,100
3670,120,67,116,183,1,100
3671,120,148,269,417,1,100
3672,120,114,294,408,1,100
3673,120,104,132,236,1,100
3674,120,81,81,162,1,100
3675,120,45,78,123,1,100
3676,120,8,18,26,1,100
3677,120,41,64,105,1,100
3678,120,3,9,12,1,100
3679,120,22,38,60,1,100
3680,120,25,27,52,1,100
3681,120,75,166,241,1,100
3682,120,70,106,176,1,100
3683,120,57,104,161,1,100
3684,120,174,199,373,1,100
3685,120,50,64,114,1,100
3686,120,176,350,526,1,100
3687,120,73,176,249,1,100
3688,120,40,96,136,1,100
3689,120,51,75,126,1,100
3690,120,36,76,112,1,100
3691,120,30,48,78,1,100
3692,120,58,111,169,1,100
3693,120,1,24,25,1,100
3694,120,81,84,165,1,100
3695,120,68,179,247,1,100
3696,120,33,105,138,1,100
3697,120,37,207,244,1,100
3698,120,61,157,218,1,100
3699,120,61,115,176,1,100
3700,120,86,109,195,1,100
3701,120,40,46,86,1,100
3702,120,29,56,85,1,100
3703,120,34,90,124,1,100
3704,120,20,41,61,1,100
3705,120,13,40,53,1,100
3706,120,16,41,57,1,100
3707,120,45,98,143,1,100
3708,120,76,173,249,1,100
3709,120,39,70,109,1,100
3710,120,44,43,87,1,100
3711,120,45,35,80,1,100
3712,120,29,74,103,1,100
3713,120,43,198,241,1,100
3714,120,65,155,220,1,100
3715,120,63,115,178,1,100
3716,120,115,222,337,1,100
3717,120,56,75,131,1,100
3718,120,5,9,14,1,100
3719,120,75,137,212,1,100
3720,120,31,65,96,1,100
3721,120,138,293,431,1,100
3722,120,79,171,250,1,100
3723,120,55,124,179,1,100
3724,120,48,93,141,1,100
3725,120,29,107,136,1,100
3726,120,47,34,81,1,100
3727,120,28,71,99,1,100
3728,120,102,155,257,1,100
3729,120,53,118,171,1,100
3730,120,15,14,29,1,100
3731,120,31,151,182,1,100
3732,120,53,120,173,1,100
3733,120,73,116,189,1,100
3734,120,43,108,151,1,100
3735,120,114,181,295,1,100
3736,120,42,74,116,1,100
3737,120,74,140,214,1,100
3738,120,6,17,23,1,100
3739,120,52,65,117,1,100
3740,120,63,122,185,1,100
3741,120,52,100,152,1,100
3742,120,74,120,194,1,100
3743,120,101,214,315,1,100
3744,120,193,269,462,1,100
3745,120,119,229,348,1,100
3746,120,106,101,207,1,100
3747,120,61,140,201,1,100
3748,120,90,196,286,1,100
3749,120,28,57,85,1,100
3750,120,66,196,262,1,100
3751,120,76,184,260,1,100
3752,120,37,81,118,1,100
3753,120,85,120,205,1,100
3754,120,57,84,141,1,100
3755,120,86,133,219,1,100
3756,120,114,143,257,1,100
3757,120,82,275,357,1,100
3758,120,125,304,429,1,100
3759,120,61,181,242,1,100
3760,120,52,195,247,1,100
3761,120,16,71,87,1,100
3762,120,47,237,284,1,100
3763,120,81,191,272,1,100
3764,120,129,132,261,1,100
3765,120,51,104,155,1,100
3766,120,41,174,215,1,100
3767,120,23,53,76,1,100
3768,120,40,71,111,1,100
3769,120,93,113,206,1,100
3770,120,19,35,54,1,100
3771,120,93,145,238,1,100
3772,120,17,22,39,1,100
3773,120,32,45,77,1,100
3774,120,6,10,16,1,100
3775,120,55,53,108,1,100
3776,120,28,65,93,1,100
3777,120,138,212,350,1,100
3778,120,72,156,228,1,100
3779,120,76,150,226,1,100
3780,120,166,231,397,1,100
3781,120,59,177,236,1,100
3782,120,58,118,176,1,100
3783,120,29,122,151,1,100
3784,120,79,124,203,1,100
3785,120,107,187,294,1,100
3786,120,108,209,317,1,100
3787,120,32,48,80,1,100
3788,120,130,203,333,1,100
3789,120,33,75,108,1,100
3790,120,69,194,263,1,100
3791,120,149,251,400,1,100
3792,120,71,101,172,1,100
3793,120,108,280,388,1,100
3794,120,76,145,221,1,100
3795,120,35,83,118,1,100
3796,120,54,101,155,1,100
3797,120,64,100,164,1,100
3798,120,74,208,282,1,100
3799,120,28,88,116,1,100
3800,120,4,32,36,1,100
3801,120,55,95,150,1,100
3802,120,54,171,225,1,100
3803,120,83,113,196,1,100
3804,120,103,241,344,1,100
3805,120,103,284,387,1,100
3806,120,121,202,323,1,100
3807,120,30,79,109,1,100
3808,120,55,109,164,1,100
3809,120,68,96,164,1,100
3810,120,37,84,121,1,100
3811,120,22,34,56,1,100
3812,120,41,113,154,1,100
3813,120,17,56,73,1,100
3814,120,17,19,36,1,100
3815,120,7,12,19,1,100
3816,120,32,137,169,1,100
3817,120,44,105,149,1,100
3818,120,62,165,227,1,100
3819,120,68,105,173,1,100
3820,120,115,126,241,1,100
3821,120,44,133,177,1,100
3822,120,58,95,153,1,100
3823,120,45,87,132,1,100
3824,120,18,68,86,1,100
3825,120,21,53,74,1,100
3826,120,34,83,117,1,100
3827,120,17,77,94,1,100
3828,120,19,49,68,1,100
3829,120,19,12,31,1,100
3830,120,111,264,375,1,100
3831,120,45,71,116,1,100
3832,120,56,76,132,1,100
3833,120,77,148,225,1,100
3834,120,109,256,365,1,100
3835,120,89,117,206,1,100
3836,120,66,151,217,1,100
3837,120,90,158,248,1,100
3838,120,36,72,108,1,100
3839,120,60,106,166,1,100
3840,120,53,113,166,1,100
3841,120,66,46,112,1,100
3842,120,24,67,91,1,100
3843,120,22,69,91,1,100
3844,120,73,208,281,1,100
3845,120,25,98,123,1,100
3846,120,65,141,206,1,100
3847,120,63,105,168,1,100
3848,120,80,168,248,1,100
3849,120,89,102,191,1,100
3850,120,10,13,23,1,100
3851,120,30,141,171,1,100
3852,120,66,136,202,1,100
3853,120,14,59,73,1,100
3854,120,74,109,183,1,100
3855,120,64,154,218,1,100
3856,120,53,101,154,1,100
3857,120,48,111,159,1,100
3858,120,9,0,9,1,100
3859,120,69,156,225,1,100
3860,120,76,116,192,1,100
3861,120,108,209,317,1,100
3862,120,106,118,224,1,100
3863,120,86,175,261,1,100
3864,120,130,321,451,1,100
3865,120,87,198,285,1,100
3866,120,96,201,297,1,100
3867,120,53,93,146,1,100
3868,120,35,108,143,1,100
3869,120,45,139,184,1,100
3870,120,33,45,78,1,100
3871,120,59,35,94,1,100
3872,120,70,80,150,1,100
3873,120,65,126,191,1,100
3874,120,42,116,158,1,100
3875,120,38,62,100,1,100
3876,120,93,131,224,1,100
3877,120,72,103,175,1,100
3878,120,53,158,211,1,100
3879,120,41,141,182,1,100
3880,120,60,90,150,1,100
3881,120,11,15,26,1,100
3882,120,18,37,55,1,100
3883,120,11,28,39,1,100
3884,120,0,9,9,1,100
3885,120,22,54,76,1,100
3886,120,50,149,199,1,100
3887,120,83,135,218,1,100
3888,120,40,111,151,1,100
3889,120,98,124,222,1,100
3890,120,116,176,292,1,100
3891,120,159,213,372,1,100
3892,120,116,232,348,1,100
3893,120,119,224,343,1,100
3894,120,35,99,134,1,100
3895,120,74,121,195,1,100
3896,120,42,45,87,1,100
3897,120,79,106,185,1,100
3898,120,26,39,65,1,100
3899,120,103,162,265,1,100
3900,120,15,47,62,1,100
3901,120,28,40,68,1,100
3902,120,1,6,7,1,100
3903,120,54,76,130,1,100
3904,120,183,151,334,1,100
3905,120,111,284,395,1,100
3906,120,117,280,397,1,100
3907,120,142,203,345,1,100
3908,120,190,184,374,1,100
3909,120,60,82,142,1,100
3910,120,21,67,88,1,100
3911,120,78,166,244,1,100
3912,120,71,171,242,1,100
3913,120,144,229,373,1,100
3914,120,78,62,140,1,100
3915,120,98,154,252,1,100
3916,120,159,103,262,1,100
3917,120,61,91,152,1,100
3918,120,41,75,116,1,100
3919,120,40,96,136,1,100
3920,120,10,60,70,1,100
3921,120,36,90,126,1,100
3922,120,19,70,89,1,100
3923,120,60,99,159,1,100
3924,120,26,35,61,1,100
3925,120,47,75,122,1,100
3926,120,117,194,311,1,100
3927,120,40,82,122,1,100
3928,120,23,53,76,1,100
3929,120,60,145,205,1,100
3930,120,42,94,136,1,100
3931,120,94,204,298,1,100
3932,120,15,40,55,1,100
3933,120,94,132,226,1,100
3934,120,29,79,108,1,100
3935,120,65,264,329,1,100
3936,120,50,87,137,1,100
3937,120,7,30,37,1,100
3938,120,202,264,466,1,100
3939,120,46,104,150,1,100
3940,120,133,108,241,1,100
3941,120,100,144,244,1,100
3942,120,5,37,42,1,100
3943,120,66,129,195,1,100
3944,120,29,62,91,1,100
3945,120,40,70,110,1,100
3946,120,35,93,128,1,100
3947,120,52,66,118,1,100
3948,120,47,66,113,1,100
3949,120,48,116,164,1,100
3950,120,8,21,29,1,100
3951,120,29,81,110,1,100
3952,120,33,46,79,1,100
3953,120,31,38,69,1,100
3954,120,72,133,205,1,100
3955,120,38,116,154,1,100
3956,120,93,225,318,1,100
3957,120,193,387,580,1,100
3958,120,36,92,128,1,100
3959,120,69,89,158,1,100
3960,120,102,146,248,1,100
3961,120,72,149,221,1,100
3962,120,55,63,118,1,100
3963,120,29,77,106,1,100
3964,120,56,83,139,1,100
3965,120,48,113,161,1,100
3966,120,61,84,145,1,100
3967,120,4,10,14,1,100
3968,120,26,66,92,1,100
3969,120,21,40,61,1,100
3970,120,87,195,282,1,100
3971,120,41,86,127,1,100
3972,120,106,146,252,1,100
3973,120,126,202,328,1,100
3974,120,86,154,240,1,100
3975,120,92,149,241,1,100
3976,120,91,66,157,1,100
3977,120,70,139,209,1,100
3978,120,82,89,171,1,100
3979,120,36,60,96,1,100
3980,120,144,230,374,1,100
3981,120,95,121,216,1,100
3982,120,42,76,118,1,100
3983,120,2,7,9,1,100
3984,120,52,104,156,1,100
3985,120,38,79,117,1,100
3986,120,104,201,305,1,100
3987,120,92,239,331,1,100
3988,120,206,340,546,1,100
3989,120,82,106,188,1,100
3990,120,74,151,225,1,100
3991,120,133,245,378,1,100
3992,120,92,188,280,1,100
3993,120,73,110,183,1,100
3994,120,50,128,178,1,100
3995,120,41,48,89,1,100
3996,120,41,60,101,1,100
3997,120,91,178,269,1,100
3998,120,58,64,122,1,100
3999,120,35,76,111,1,100
4000,120,67,178,245,1,100
4001,120,80,148,228,1,100
4002,120,45,46,91,1,100
4003,120,62,135,197,1,100
4004,120,126,239,365,1,100
4005,120,59,179,238,1,100
4006,120,25,142,167,1,100
4007,120,42,128,170,1,100
4008,120,55,207,262,1,100
4009,120,54,129,183,1,100
4010,120,48,92,140,1,100
4011,120,46,109,155,1,100
4012,120,51,80,131,1,100
4013,120,74,220,294,1,100
4014,120,29,139,168,1,100
4015,120,13,88,101,1,100
4016,120,53,152,205,1,100
4017,120,36,51,87,1,100
4018,120,56,102,158,1,100
4019,120,66,186,252,1,100
4020,120,53,164,217,1,100
4021,120,62,64,126,1,100
4022,120,122,164,286,1,100
4023,120,165,308,473,1,100
4024,120,36,90,126,1,100
4025,120,45,96,141,1,100
4026,120,61,138,199,1,100
4027,120,112,234,346,1,100
4028,120,27,77,104,1,100
4029,120,45,89,134,1,100
4030,120,2,14,16,1,100
4031,120,65,114,179,1,100
4032,120,31,108,139,1,100
4033,120,50,94,144,1,100
4034,120,48,90,138,1,100
4035,120,55,98,153,1,100
4036,120,47,28,75,1,100
4037,120,54,112,166,1,100
4038,120,92,157,249,1,100
4039,120,24,49,73,1,100
4040,120,92,212,304,1,100
4041,120,15,62,77,1,100
4042,120,92,116,208,1,100
4043,120,98,244,342,1,100
4044,120,84,118,202,1,100
4045,120,23,88,111,1,100
4046,120,23,79,102,1,100
4047,120,38,70,108,1,100
4048,120,107,209,316,1,100
4049,120,87,147,234,1,100
4050,120,64,138,202,1,100
4051,120,44,77,121,1,100
4052,120,134,215,349,1,100
4053,120,5,27,32,1,100
4054,120,18,29,47,1,100
4055,120,35,98,133,1,100
4056,120,95,174,269,1,100
4057,120,69,106,175,1,100
4058,120,25,59,84,1,100
4059,120,8,27,35,1,100
4060,120,45,66,111,1,100
4061,120,52,113,165,1,100
4062,120,26,33,59,1,100
4063,120,36,76,112,1,100
4064,120,74,150,224,1,100
4065,120,72,91,163,1,100
4066,120,56,90,146,1,100
4067,120,59,120,179,1,100
4068,120,67,113,180,1,100
4069,120,29,28,57,1,100
4070,120,38,81,119,1,100
4071,120,95,208,303,1,100
4072,120,118,182,300,1,100
4073,120,33,65,98,1,100
4074,120,59,99,158,1,100
4075,120,28,46,74,1,100
4076,120,14,32,46,1,100
4077,120,12,24,36,1,100
4078,120,7,26,33,1,100
4079,150,44,50,94,1,100
4080,150,9,9,18,1,100
4081,150,23,47,70,1,100
4082,150,45,81,126,1,100
4083,150,9,26,35,1,100
4084,150,55,115,170,1,100
4085,150,49,103,152,1,100
4086,150,50,138,188,1,100
4087,150,32,127,159,1,100
4088,150,53,70,123,1,100
4089,150,65,115,180,1,100
4090,150,47,52,99,1,100
4091,150,47,133,180,1,100
4092,150,14,56,70,1,100
4093,150,47,110,157,1,100
4094,150,47,78,125,1,100
4095,150,9,13,22,1,100
4096,150,44,92,136,1,100
4097,150,24,48,72,1,100
4098,150,2,11,13,1,100
4099,150,29,40,69,1,100
4100,150,2,17,19,1,100
4101,150,30,25,55,1,100
4102,150,12,44,56,1,100
4103,150,40,70,110,1,100
4104,150,43,113,156,1,100
4105,150,145,327,472,1,100
4106,150,54,117,171,1,100
4107,150,75,91,166,1,100
4108,150,37,79,116,1,100
4109,150,28,32,60,1,100
4110,150,52,63,115,1,100
4111,150,24,83,107,1,100
4112,150,14,42,56,1,100
4113,150,30,47,77,1,100
4114,150,19,24,43,1,100
4115,150,32,84,116,1,100
4116,150,66,127,193,1,100
4117,150,138,157,295,1,100
4118,150,30,47,77,1,100
4119,150,62,71,133,1,100
4120,150,15,37,52,1,100
4121,150,95,98,193,1,100
4122,150,76,152,228,1,100
4123,150,39,77,116,1,100
4124,150,71,111,182,1,100
4125,150,93,124,217,1,100
4126,150,42,81,123,1,100
4127,150,12,12,24,1,100
4128,150,64,114,178,1,100
4129,150,10,26,36,1,100
4130,150,13,27,40,1,100
4131,150,94,133,227,1,100
4132,150,72,93,165,1,100
4133,150,47,113,160,1,100
4134,150,17,26,43,1,100
4135,150,18,11,29,1,100
4136,150,63,133,196,1,100
4137,150,72,153,225,1,100
4138,150,44,104,148,1,100
4139,150,30,60,90,1,100
4140,150,41,100,141,1,100
4141,150,26,72,98,1,100
4142,150,32,69,101,1,100
4143,150,17,50,67,1,100
4144,150,12,9,21,1,100
4145,150,11,13,24,1,100
4146,150,62,140,202,1,100
4147,150,17,50,67,1,100
4148,150,70,135,205,1,100
4149,150,29,90,119,1,100
4150,150,92,259,351,1,100
4151,150,8,44,52,1,100
4152,150,37,110,147,1,100
4153,150,49,87,136,1,100
4154,150,22,67,89,1,100
4155,150,50,54,104,1,100
4156,150,14,29,43,1,100
4157,150,75,115,190,1,100
4158,150,39,48,87,1,100
4159,150,62,153,215,1,100
4160,150,47,66,113,1,100
4161,150,60,122,182,1,100
4162,150,121,229,350,1,100
4163,150,53,147,200,1,100
4164,150,36,68,104,1,100
4165,150,22,51,73,1,100
4166,150,30,66,96,1,100
4167,150,78,161,239,1,100
4168,150,16,61,77,1,100
4169,150,31,85,116,1,100
4170,150,26,58,84,1,100
4171,150,50,87,137,1,100
4172,150,14,34,48,1,100
4173,150,72,174,246,1,100
4174,150,31,35,66,1,100
4175,150,82,188,270,1,100
4176,150,83,184,267,1,100
4177,150,72,248,320,1,100
4178,150,92,217,309,1,100
4179,150,65,198,263,1,100
4180,150,73,170,243,1,100
4181,150,49,118,167,1,100
4182,150,26,25,51,1,100
4183,150,28,64,92,1,100
4184,150,71,111,182,1,100
4185,150,7,5,12,1,100
4186,150,142,278,420,1,100
4187,150,48,82,130,1,100
4188,150,20,30,50,1,100
4189,150,71,121,192,1,100
4190,150,27,57,84,1,100
4191,150,128,248,376,1,100
4192,150,66,228,294,1,100
4193,150,55,87,142,1,100
4194,150,69,94,163,1,100
4195,150,28,44,72,1,100
4196,150,16,53,69,1,100
4197,150,4,38,42,1,100
4198,150,13,26,39,1,100
4199,150,22,32,54,1,100
4200,150,74,115,189,1,100
4201,150,15,19,34,1,100
4202,150,66,156,222,1,100
4203,150,27,28,55,1,100
4204,150,66,80,146,1,100
4205,150,19,40,59,1,100
4206,150,60,88,148,1,100
4207,150,59,64,123,1,100
4208,150,52,93,145,1,100
4209,150,39,67,106,1,100
4210,150,6,15,21,1,100
4211,150,101,125,226,1,100
4212,150,68,60,128,1,100
4213,150,69,81,150,1,100
4214,150,21,38,59,1,100
4215,150,5,29,34,1,100
4216,150,15,26,41,1,100
4217,150,84,165,249,1,100
4218,150,36,123,159,1,100
4219,150,42,45,87,1,100
4220,150,113,167,280,1,100
4221,150,41,81,122,1,100
4222,150,105,154,259,1,100
4223,150,106,175,281,1,100
4224,150,44,89,133,1,100
4225,150,86,154,240,1,100
4226,150,24,56,80,1,100
4227,150,14,49,63,1,100
4228,150,18,21,39,1,100
4229,150,5,9,14,1,100
4230,150,22,38,60,1,100
4231,150,15,53,68,1,100
4232,150,17,11,28,1,100
4233,150,24,70,94,1,100
4234,150,43,70,113,1,100
4235,150,39,92,131,1,100
4236,150,20,31,51,1,100
4237,150,108,204,312,1,100
4238,150,52,69,121,1,100
4239,150,35,15,50,1,100
4240,150,48,141,189,1,100
4241,150,72,181,253,1,100
4242,150,111,188,299,1,100
4243,150,112,217,329,1,100
4244,150,21,58,79,1,100
4245,150,25,63,88,1,100
4246,150,61,66,127,1,100
4247,150,14,33,47,1,100
4248,150,59,133,192,1,100
4249,150,33,83,116,1,100
4250,150,11,23,34,1,100
4251,150,76,70,146,1,100
4252,150,90,93,183,1,100
4253,150,113,104,217,1,100
4254,150,44,77,121,1,100
4255,150,64,123,187,1,100
4256,150,69,159,228,1,100
4257,150,42,152,194,1,100
4258,150,99,185,284,1,100
4259,150,53,121,174,1,100
4260,150,96,114,210,1,100
4261,150,81,135,216,1,100
4262,150,87,171,258,1,100
4263,150,20,75,95,1,100
4264,150,37,96,133,1,100
4265,150,15,14,29,1,100
4266,150,21,54,75,1,100
4267,150,14,52,66,1,100
4268,150,2,4,6,1,100
4269,150,72,125,197,1,100
4270,150,56,90,146,1,100
4271,150,13,42,55,1,100
4272,150,90,168,258,1,100
4273,150,22,52,74,1,100
4274,150,45,83,128,1,100
4275,150,33,48,81,1,100
4276,150,14,38,52,1,100
4277,150,25,30,55,1,100
4278,150,35,83,118,1,100
4279,150,33,56,89,1,100
4280,150,53,49,102,1,100
4281,150,6,31,37,1,100
4282,150,26,43,69,1,100
4283,150,74,73,147,1,100
4284,150,62,67,129,1,100
4285,150,43,125,168,1,100
4286,150,6,0,6,1,100
4287,150,41,86,127,1,100
4288,150,2,3,5,1,100
4289,150,41,83,124,1,100
4290,150,22,48,70,1,100
4291,150,43,53,96,1,100
4292,150,4,5,9,1,100
4293,150,27,76,103,1,100
4294,150,8,14,22,1,100
4295,150,30,53,83,1,100
4296,150,24,33,57,1,100
4297,150,36,72,108,1,100
4298,150,44,124,168,1,100
4299,150,90,186,276,1,100
4300,150,51,116,167,1,100
4301,150,13,20,33,1,100
4302,150,25,58,83,1,100
4303,150,46,110,156,1,100
4304,150,4,7,11,1,100
4305,150,40,30,70,1,100
4306,150,2,16,18,1,100
4307,150,33,51,84,1,100
4308,150,16,22,38,1,100
4309,150,2,1,3,1,100
4310,150,48,121,169,1,100
4311,150,42,68,110,1,100
4312,150,85,91,176,1,100
4313,150,26,49,75,1,100
4314,150,71,136,207,1,100
4315,150,146,186,332,1,100
4316,150,55,69,124,1,100
4317,150,26,46,72,1,100
4318,150,61,88,149,1,100
4319,150,54,93,147,1,100
4320,150,21,35,56,1,100
4321,150,68,151,219,1,100
4322,150,64,130,194,1,100
4323,150,55,69,124,1,100
4324,150,26,48,74,1,100
4325,150,60,119,179,1,100
4326,150,52,104,156,1,100
4327,150,15,24,39,1,100
4328,150,5,17,22,1,100
4329,150,56,101,157,1,100
4330,150,31,39,70,1,100
4331,150,26,41,67,1,100
4332,150,20,48,68,1,100
4333,150,63,113,176,1,100
4334,150,109,185,294,1,100
4335,150,48,146,194,1,100
4336,150,14,36,50,1,100
4337,150,16,26,42,1,100
4338,150,46,70,116,1,100
4339,150,41,104,145,1,100
4340,150,32,38,70,1,100
4341,150,19,20,39,1,100
4342,150,52,79,131,1,100
4343,150,13,39,52,1,100
4344,150,32,27,59,1,100
4345,150,75,115,190,1,100
4346,150,114,216,330,1,100
4347,150,23,67,90,1,100
4348,150,52,69,121,1,100
4349,150,17,39,56,1,100
4350,150,28,72,100,1,100
4351,150,62,106,168,1,100
4352,150,71,172,243,1,100
4353,150,122,130,252,1,100
4354,150,64,83,147,1,100
4355,150,65,112,177,1,100
4356,150,29,96,125,1,100
4357,150,125,75,200,1,100
4358,150,18,17,35,1,100
4359,150,65,135,200,1,100
4360,150,22,49,71,1,100
4361,150,15,33,48,1,100
4362,150,24,79,103,1,100
4363,150,70,128,198,1,100
4364,150,73,151,224,1,100
4365,150,28,47,75,1,100
4366,150,49,148,197,1,100
4367,150,14,20,34,1,100
4368,150,42,68,110,1,100
4369,150,52,87,139,1,100
4370,150,56,109,165,1,100
4371,150,61,130,191,1,100
4372,150,45,108,153,1,100
4373,150,38,117,155,1,100
4374,150,21,92,113,1,100
4375,150,63,160,223,1,100
4376,150,6,7,13,1,100
4377,150,30,60,90,1,100
4378,150,53,89,142,1,100
4379,150,41,60,101,1,100
4380,150,5,18,23,1,100
4381,150,40,101,141,1,100
4382,150,46,62,108,1,100
4383,150,51,83,134,1,100
4384,150,6,28,34,1,100
4385,150,10,17,27,1,100
4386,150,81,102,183,1,100
4387,150,24,25,49,1,100
4388,150,69,177,246,1,100
4389,150,58,74,132,1,100
4390,150,40,87,127,1,100
4391,150,31,67,98,1,100
4392,150,79,165,244,1,100
4393,150,26,28,54,1,100
4394,150,47,60,107,1,100
4395,150,45,170,215,1,100
4396,150,23,68,91,1,100
4397,150,90,141,231,1,100
4398,150,36,51,87,1,100
4399,150,31,47,78,1,100
4400,150,63,164,227,1,100
4401,150,26,34,60,1,100
4402,150,38,90,128,1,100
4403,150,30,29,59,1,100
4404,150,56,40,96,1,100
4405,150,17,34,51,1,100
4406,150,39,67,106,1,100
4407,150,29,76,105,1,100
4408,150,26,79,105,1,100
4409,150,91,142,233,1,100
4410,150,96,103,199,1,100
4411,150,31,75,106,1,100
4412,150,95,126,221,1,100
4413,150,162,219,381,1,100
4414,150,46,95,141,1,100
4415,150,57,73,130,1,100
4416,150,30,58,88,1,100
4417,150,43,72,115,1,100
4418,150,64,133,197,1,100
4419,150,2,82,84,1,100
4420,150,39,40,79,1,100
4421,150,39,33,72,1,100
4422,150,61,137,198,1,100
4423,150,1,1,2,1,100
4424,150,43,110,153,1,100
4425,150,11,43,54,1,100
4426,150,68,99,167,1,100
4427,150,48,112,160,1,100
4428,150,58,75,133,1,100
4429,150,99,116,215,1,100
4430,150,23,43,66,1,100
4431,150,137,121,258,1,100
4432,150,90,121,211,1,100
4433,150,71,143,214,1,100
4434,150,55,115,170,1,100
4435,150,20,81,101,1,100
4436,150,43,89,132,1,100
4437,150,43,71,114,1,100
4438,150,21,53,74,1,100
4439,150,15,26,41,1,100
4440,150,24,21,45,1,100
4441,150,29,91,120,1,100
4442,150,68,138,206,1,100
4443,150,22,14,36,1,100
4444,150,125,228,353,1,100
4445,150,68,125,193,1,100
4446,150,40,85,125,1,100
4447,150,110,204,314,1,100
4448,150,31,71,102,1,100
4449,150,17,38,55,1,100
4450,150,45,55,100,1,100
4451,150,30,83,113,1,100
4452,150,39,37,76,1,100
4453,150,29,28,57,1,100
4454,150,51,188,239,1,100
4455,150,33,93,126,1,100
4456,150,47,102,149,1,100
4457,150,2,5,7,1,100
4458,150,10,14,24,1,100
4459,150,20,19,39,1,100
4460,150,4,5,9,1,100
4461,150,85,171,256,1,100
4462,150,19,91,110,1,100
4463,150,10,46,56,1,100
4464,150,54,103,157,1,100
4465,150,28,42,70,1,100
4466,150,78,123,201,1,100
4467,150,47,47,94,1,100
4468,150,46,135,181,1,100
4469,150,76,148,224,1,100
4470,150,21,40,61,1,100
4471,150,94,197,291,1,100
4472,150,61,97,158,1,100
4473,150,12,15,27,1,100
4474,150,24,42,66,1,100
4475,150,41,77,118,1,100
4476,150,15,30,45,1,100
4477,150,23,43,66,1,100
4478,150,15,58,73,1,100
4479,150,1,6,7,1,100
4480,150,28,100,128,1,100
4481,150,99,190,289,1,100
4482,150,52,108,160,1,100
4483,150,100,109,209,1,100
4484,150,56,85,141,1,100
4485,150,82,124,206,1,100
4486,150,86,113,199,1,100
4487,150,52,75,127,1,100
4488,150,38,49,87,1,100
4489,150,50,110,160,1,100
4490,150,61,180,241,1,100
4491,150,60,126,186,1,100
4492,150,91,81,172,1,100
4493,150,79,126,205,1,100
4494,150,23,37,60,1,100
4495,150,33,69,102,1,100
4496,150,5,16,21,1,100
4497,150,57,124,181,1,100
4498,150,43,78,121,1,100
4499,150,81,74,155,1,100
4500,150,22,42,64,1,100
4501,150,97,75,172,1,100
4502,150,57,96,153,1,100
4503,150,66,59,125,1,100
4504,150,9,17,26,1,100
4505,150,45,45,90,1,100
4506,150,39,73,112,1,100
4507,150,26,49,75,1,100
4508,150,71,149,220,1,100
4509,150,61,100,161,1,100
4510,150,33,92,125,1,100
4511,150,47,60,107,1,100
4512,150,10,30,40,1,100
4513,150,23,30,53,1,100
4514,150,60,126,186,1,100
4515,150,58,130,188,1,100
4516,150,53,160,213,1,100
4517,150,55,102,157,1,100
4518,150,18,41,59,1,100
4519,150,99,159,258,1,100
4520,150,6,37,43,1,100
4521,150,48,85,133,1,100
4522,150,40,91,131,1,100
4523,150,58,98,156,1,100
4524,150,29,68,97,1,100
4525,150,31,104,135,1,100
4526,150,74,175,249,1,100
4527,150,82,236,318,1,100
4528,150,10,14,24,1,100
4529,150,58,143,201,1,100
4530,150,32,55,87,1,100
4531,150,40,41,81,1,100
4532,150,11,24,35,1,100
4533,150,179,280,459,1,100
4534,150,21,17,38,1,100
4535,150,23,44,67,1,100
4536,150,40,73,113,1,100
4537,150,14,19,33,1,100
4538,150,30,81,111,1,100
4539,150,17,37,54,1,100
4540,150,37,55,92,1,100
4541,150,13,22,35,1,100
4542,150,51,96,147,1,100
4543,150,65,113,178,1,100
4544,150,83,163,246,1,100
4545,150,25,63,88,1,100
4546,150,25,50,75,1,100
4547,150,128,110,238,1,100
4548,150,53,97,150,1,100
4549,150,160,249,409,1,100
4550,150,72,143,215,1,100
4551,150,68,86,154,1,100
4552,150,14,39,53,1,100
4553,150,50,82,132,1,100
4554,150,47,81,128,1,100
4555,150,66,91,157,1,100
4556,150,59,114,173,1,100
4557,150,52,112,164,1,100
4558,150,86,105,191,1,100
4559,150,121,293,414,1,100
4560,150,37,70,107,1,100
4561,150,19,62,81,1,100
4562,150,91,107,198,1,100
4563,150,82,104,186,1,100
4564,150,70,164,234,1,100
4565,150,3,13,16,1,100
4566,150,55,116,171,1,100
4567,150,68,79,147,1,100
4568,150,18,65,83,1,100
4569,150,14,51,65,1,100
4570,150,19,51,70,1,100
4571,150,5,12,17,1,100
4572,180,93,184,277,1,100
4573,180,60,94,154,1,100
4574,180,32,78,110,1,100
4575,180,45,80,125,1,100
4576,180,69,98,167,1,100
4577,180,78,115,193,1,100
4578,180,68,143,211,1,100
4579,180,47,86,133,1,100
4580,180,54,102,156,1,100
4581,180,46,132,178,1,100
4582,180,9,34,43,1,100
4583,180,17,66,83,1,100
4584,180,70,156,226,1,100
4585,180,16,24,40,1,100
4586,180,75,129,204,1,100
4587,180,3,15,18,1,100
4588,180,49,67,116,1,100
4589,180,120,115,235,1,100
4590,180,16,29,45,1,100
4591,180,25,63,88,1,100
4592,180,86,128,214,1,100
4593,180,95,158,253,1,100
4594,180,52,69,121,1,100
4595,180,47,82,129,1,100
4596,180,88,150,238,1,100
4597,180,79,138,217,1,100
4598,180,8,26,34,1,100
4599,180,19,40,59,1,100
4600,180,34,49,83,1,100
4601,180,37,86,123,1,100
4602,180,44,84,128,1,100
4603,180,69,118,187,1,100
4604,180,38,45,83,1,100
4605,180,65,130,195,1,100
4606,180,54,140,194,1,100
4607,180,36,69,105,1,100
4608,180,56,101,157,1,100
4609,180,114,252,366,1,100
4610,180,4,17,21,1,100
4611,180,43,101,144,1,100
4612,180,65,152,217,1,100
4613,180,100,144,244,1,100
4614,180,70,142,212,1,100
4615,180,62,86,148,1,100
4616,180,68,145,213,1,100
4617,180,20,51,71,1,100
4618,180,41,106,147,1,100
4619,180,28,44,72,1,100
4620,180,38,40,78,1,100
4621,180,15,38,53,1,100
4622,180,53,120,173,1,100
4623,180,87,169,256,1,100
4624,180,157,203,360,1,100
4625,180,78,110,188,1,100
4626,180,20,29,49,1,100
4627,180,44,77,121,1,100
4628,180,82,163,245,1,100
4629,180,63,109,172,1,100
4630,180,82,180,262,1,100
4631,180,30,50,80,1,100
4632,180,62,148,210,1,100
4633,180,123,212,335,1,100
4634,180,89,159,248,1,100
4635,180,66,203,269,1,100
4636,180,100,191,291,1,100
4637,180,117,276,393,1,100
4638,180,134,274,408,1,100
4639,180,150,344,494,1,100
4640,180,19,102,121,1,100
4641,180,70,138,208,1,100
4642,180,37,84,121,1,100
4643,180,40,130,170,1,100
4644,180,56,111,167,1,100
4645,180,19,24,43,1,100
4646,180,102,210,312,1,100
4647,180,115,180,295,1,100
4648,180,64,120,184,1,100
4649,180,75,169,244,1,100
4650,180,122,190,312,1,100
4651,180,45,142,187,1,100
4652,180,53,148,201,1,100
4653,180,64,126,190,1,100
4654,180,54,54,108,1,100
4655,180,29,101,130,1,100
4656,180,74,159,233,1,100
4657,180,53,113,166,1,100
4658,180,92,73,165,1,100
4659,180,175,202,377,1,100
4660,180,38,115,153,1,100
4661,180,42,88,130,1,100
4662,180,27,154,181,1,100
4663,180,52,140,192,1,100
4664,180,66,154,220,1,100
4665,180,88,244,332,1,100
4666,180,61,211,272,1,100
4667,180,76,267,343,1,100
4668,180,48,102,150,1,100
4669,180,27,66,93,1,100
4670,180,52,82,134,1,100
4671,180,71,182,253,1,100
4672,180,14,33,47,1,100
4673,180,111,243,354,1,100
4674,180,8,11,19,1,100
4675,180,93,138,231,1,100
4676,180,90,137,227,1,100
4677,180,126,185,311,1,100
4678,180,120,123,243,1,100
4679,180,96,108,204,1,100
4680,180,58,101,159,1,100
4681,180,59,134,193,1,100
4682,180,43,67,110,1,100
4683,180,59,175,234,1,100
4684,180,5,33,38,1,100
4685,180,54,36,90,1,100
4686,180,67,120,187,1,100
4687,180,106,236,342,1,100
4688,180,140,288,428,1,100
4689,180,102,149,251,1,100
4690,180,142,178,320,1,100
4691,180,39,132,171,1,100
4692,180,56,155,211,1,100
4693,180,71,172,243,1,100
4694,180,47,137,184,1,100
4695,180,53,102,155,1,100
4696,180,71,99,170,1,100
4697,180,99,56,155,1,100
4698,180,59,47,106,1,100
4699,180,80,85,165,1,100
4700,180,61,76,137,1,100
4701,180,49,135,184,1,100
4702,180,53,106,159,1,100
4703,180,66,54,120,1,100
4704,180,83,124,207,1,100
4705,180,76,140,216,1,100
4706,180,105,254,359,1,100
4707,180,87,145,232,1,100
4708,180,38,123,161,1,100
4709,180,29,123,152,1,100
4710,180,8,8,16,1,100
4711,180,77,132,209,1,100
4712,180,52,67,119,1,100
4713,180,51,59,110,1,100
4714,180,122,109,231,1,100
4715,180,7,67,74,1,100
4716,180,83,108,191,1,100
4717,180,75,89,164,1,100
4718,180,34,80,114,1,100
4719,180,68,116,184,1,100
4720,180,72,151,223,1,100
4721,180,8,26,34,1,100
4722,180,47,78,125,1,100
4723,180,74,164,238,1,100
4724,180,54,118,172,1,100
4725,180,91,197,288,1,100
4726,180,83,234,317,1,100
4727,180,106,180,286,1,100
4728,180,82,96,178,1,100
4729,180,71,253,324,1,100
4730,180,73,105,178,1,100
4731,180,50,91,141,1,100
4732,180,29,46,75,1,100
4733,180,44,100,144,1,100
4734,180,105,210,315,1,100
4735,180,44,146,190,1,100
4736,180,27,67,94,1,100
4737,180,0,4,4,1,100
4738,180,65,132,197,1,100
4739,180,69,148,217,1,100
4740,180,126,229,355,1,100
4741,180,80,134,214,1,100
4742,180,49,77,126,1,100
4743,180,83,120,203,1,100
4744,180,21,24,45,1,100
4745,180,59,101,160,1,100
4746,180,26,42,68,1,100
4747,180,82,184,266,1,100
4748,180,30,69,99,1,100
4749,180,98,190,288,1,100
4750,180,86,122,208,1,100
4751,180,78,119,197,1,100
4752,180,45,82,127,1,100
4753,180,37,92,129,1,100
4754,180,16,36,52,1,100
4755,180,40,113,153,1,100
4756,180,48,68,116,1,100
4757,180,58,95,153,1,100
4758,180,86,124,210,1,100
4759,180,17,49,66,1,100
4760,180,49,144,193,1,100
4761,180,45,69,114,1,100
4762,180,30,29,59,1,100
4763,180,4,28,32,1,100
4764,180,33,54,87,1,100
4765,180,25,54,79,1,100
4766,180,34,45,79,1,100
4767,180,90,217,307,1,100
4768,180,100,190,290,1,100
4769,180,104,147,251,1,100
4770,180,59,134,193,1,100
4771,180,74,127,201,1,100
4772,180,19,73,92,1,100
4773,180,103,147,250,1,100
4774,180,78,203,281,1,100
4775,180,68,182,250,1,100
4776,180,147,284,431,1,100
4777,180,48,157,205,1,100
4778,180,59,179,238,1,100
4779,180,84,127,211,1,100
4780,180,26,37,63,1,100
4781,180,166,215,381,1,100
4782,180,26,48,74,1,100
4783,180,64,104,168,1,100
4784,180,73,117,190,1,100
4785,180,158,240,398,1,100
4786,180,32,55,87,1,100
4787,180,90,90,180,1,100
4788,180,9,26,35,1,100
4789,180,71,116,187,1,100
4790,180,40,58,98,1,100
4791,180,132,220,352,1,100
4792,180,145,230,375,1,100
4793,180,45,108,153,1,100
4794,180,70,183,253,1,100
4795,180,73,132,205,1,100
4796,180,60,115,175,1,100
4797,180,94,151,245,1,100
4798,180,69,119,188,1,100
4799,180,48,139,187,1,100
4800,180,47,100,147,1,100
4801,180,32,56,88,1,100
4802,180,41,65,106,1,100
4803,180,35,91,126,1,100
4804,180,85,151,236,1,100
4805,180,107,191,298,1,100
4806,180,61,97,158,1,100
4807,180,92,130,222,1,100
4808,180,61,109,170,1,100
4809,180,51,94,145,1,100
4810,180,18,46,64,1,100
4811,180,50,110,160,1,100
4812,180,30,79,109,1,100
4813,180,33,49,82,1,100
4814,180,25,42,67,1,100
4815,180,51,40,91,1,100
4816,180,35,96,131,1,100
4817,180,18,105,123,1,100
4818,180,30,25,55,1,100
4819,180,20,35,55,1,100
4820,180,17,43,60,1,100
4821,180,112,192,304,1,100
4822,180,72,117,189,1,100
4823,180,47,96,143,1,100
4824,180,153,190,343,1,100
4825,180,55,53,108,1,100
4826,180,70,46,116,1,100
4827,180,84,186,270,1,100
4828,180,60,101,161,1,100
4829,180,33,95,128,1,100
4830,180,43,73,116,1,100
4831,180,5,3,8,1,100
4832,180,59,54,113,1,100
4833,180,9,42,51,1,100
4834,180,1,1,2,1,100
4835,180,9,13,22,1,100
4836,180,88,170,258,1,100
4837,180,25,71,96,1,100
4838,180,12,16,28,1,100
4839,180,118,180,298,1,100
4840,180,198,326,524,1,100
4841,180,125,279,404,1,100
4842,180,152,274,426,1,100
4843,180,98,129,227,1,100
4844,180,93,114,207,1,100
4845,180,88,147,235,1,100
4846,180,108,146,254,1,100
4847,180,55,95,150,1,100
4848,180,61,184,245,1,100
4849,180,19,40,59,1,100
4850,180,93,82,175,1,100
4851,180,35,63,98,1,100
4852,180,83,153,236,1,100
4853,180,64,68,132,1,100
4854,180,98,194,292,1,100
4855,180,50,80,130,1,100
4856,180,61,99,160,1,100
4857,180,80,171,251,1,100
4858,180,65,130,195,1,100
4859,180,143,181,324,1,100
4860,180,9,23,32,1,100
4861,180,118,117,235,1,100
4862,180,24,45,69,1,100
4863,180,6,31,37,1,100
4864,180,38,46,84,1,100
4865,180,7,15,22,1,100
4866,180,28,76,104,1,100
4867,180,52,116,168,1,100
4868,180,54,75,129,1,100
4869,180,63,74,137,1,100
4870,180,47,80,127,1,100
4871,180,33,82,115,1,100
4872,180,59,104,163,1,100
4873,180,78,154,232,1,100
4874,180,154,188,342,1,100
4875,180,42,73,115,1,100
4876,180,130,225,355,1,100
4877,180,76,131,207,1,100
4878,180,21,25,46,1,100
4879,180,56,48,104,1,100
4880,180,44,119,163,1,100
4881,180,44,35,79,1,100
4882,180,18,29,47,1,100
4883,180,56,178,234,1,100
4884,180,58,65,123,1,100
4885,180,31,66,97,1,100
4886,180,26,64,90,1,100
4887,180,31,109,140,1,100
4888,180,75,113,188,1,100
4889,180,72,107,179,1,100
4890,180,86,134,220,1,100
4891,180,86,198,284,1,100
4892,180,21,46,67,1,100
4893,180,41,89,130,1,100
4894,180,19,60,79,1,100
4895,180,42,109,151,1,100
4896,180,48,67,115,1,100
4897,180,43,83,126,1,100
4898,180,85,108,193,1,100
4899,180,27,72,99,1,100
4900,180,21,49,70,1,100
4901,180,27,28,55,1,100
4902,180,68,97,165,1,100
4903,180,35,23,58,1,100
4904,180,45,68,113,1,100
4905,180,36,56,92,1,100
4906,180,46,76,122,1,100
4907,180,129,137,266,1,100
4908,180,29,96,125,1,100
4909,180,51,80,131,1,100
4910,180,65,104,169,1,100
4911,180,21,48,69,1,100
4912,180,8,4,12,1,100
4913,180,43,70,113,1,100
4914,180,33,68,101,1,100
4915,180,100,242,342,1,100
4916,180,44,126,170,1,100
4917,180,84,128,212,1,100
4918,180,34,113,147,1,100
4919,180,33,70,103,1,100
4920,180,53,153,206,1,100
4921,180,44,73,117,1,100
4922,180,46,105,151,1,100
4923,180,41,62,103,1,100
4924,180,27,48,75,1,100
4925,180,69,133,202,1,100
4926,180,46,96,142,1,100
4927,180,50,99,149,1,100
4928,180,68,145,213,1,100
4929,180,71,127,198,1,100
4930,180,52,149,201,1,100
4931,180,64,78,142,1,100
4932,180,103,157,260,1,100
4933,180,50,122,172,1,100
4934,180,60,87,147,1,100
4935,180,47,131,178,1,100
4936,180,79,152,231,1,100
4937,180,48,102,150,1,100
4938,180,25,43,68,1,100
4939,180,37,34,71,1,100
4940,180,38,40,78,1,100
4941,180,70,127,197,1,100
4942,180,24,49,73,1,100
4943,180,21,51,72,1,100
4944,180,105,239,344,1,100
4945,180,60,44,104,1,100
4946,180,31,72,103,1,100
4947,180,113,197,310,1,100
4948,180,22,90,112,1,100
4949,180,87,40,127,1,100
4950,180,33,88,121,1,100
4951,180,86,121,207,1,100
4952,180,37,33,70,1,100
4953,180,27,32,59,1,100
4954,180,21,49,70,1,100
4955,180,22,25,47,1,100
4956,180,40,41,81,1,100
4957,180,17,38,55,1,100
4958,180,17,27,44,1,100
4959,180,15,26,41,1,100
4960,180,60,98,158,1,100
4961,180,120,183,303,1,100
4962,180,49,108,157,1,100
4963,180,50,144,194,1,100
4964,180,54,97,151,1,100
4965,180,23,73,96,1,100
4966,180,64,72,136,1,100
4967,180,95,145,240,1,100
4968,180,9,28,37,1,100
4969,180,43,122,165,1,100
4970,180,25,52,77,1,100
4971,180,86,73,159,1,100
4972,180,68,56,124,1,100
4973,180,44,84,128,1,100
4974,180,45,70,115,1,100
4975,180,65,91,156,1,100
4976,180,82,131,213,1,100
4977,180,18,58,76,1,100
4978,180,23,50,73,1,100
4979,180,46,87,133,1,100
4980,180,43,54,97,1,100
4981,180,50,97,147,1,100
4982,180,7,14,21,1,100
4983,180,73,80,153,1,100
4984,180,28,83,111,1,100
4985,180,67,136,203,1,100
4986,180,76,67,143,1,100
4987,180,88,134,222,1,100
4988,180,47,62,109,1,100
4989,180,47,77,124,1,100
4990,180,63,41,104,1,100
4991,180,69,29,98,1,100
4992,180,49,106,155,1,100
4993,180,73,155,228,1,100
4994,180,152,325,477,1,100
4995,180,88,148,236,1,100
4996,180,25,42,67,1,100
4997,180,63,113,176,1,100
4998,180,43,56,99,1,100
4999,180,18,17,35,1,100
5000,180,53,96,149,1,100
5001,180,26,26,52,1,100
5002,180,19,4,23,1,100
5003,180,32,37,69,1,100
5004,180,40,46,86,1,100
5005,180,68,136,204,1,100
5006,180,37,98,135,1,100
5007,180,101,175,276,1,100
5008,180,41,97,138,1,100
5009,180,48,70,118,1,100
5010,180,49,147,196,1,100
5011,180,118,101,219,1,100
5012,180,23,39,62,1,100
5013,180,28,73,101,1,100
5014,180,36,63,99,1,100
5015,180,32,145,177,1,100
0,0,5,9,14,2,0
1,0,0,3,3,2,0
2,0,10,18,28,2,0
3,0,53,84,137,2,0
4,0,56,107,163,2,0
5,0,19,49,68,2,0
6,0,21,21,42,2,0
7,0,22,18,40,2,0
8,0,9,98,107,2,0
9,0,54,114,168,2,0
10,0,32,38,70,2,0
11,0,3,47,50,2,0
12,0,13,26,39,2,0
13,0,0,0,0,2,0
14,0,2,6,8,2,0
15,0,25,31,56,2,0
16,0,16,20,36,2,0
17,0,48,27,75,2,0
18,0,17,32,49,2,0
19,0,11,28,39,2,0
20,0,14,31,45,2,0
21,0,8,18,26,2,0
22,0,3,7,10,2,0
23,0,38,103,141,2,0
24,0,15,34,49,2,0
25,0,3,13,16,2,0
26,0,49,103,152,2,0
27,0,1,13,14,2,0
28,0,12,10,22,2,0
29,0,0,12,12,2,0
30,0,2,1,3,2,0
31,0,15,56,71,2,0
32,0,9,18,27,2,0
33,0,17,31,48,2,0
34,0,13,22,35,2,0
35,0,14,24,38,2,0
36,0,3,7,10,2,0
37,0,17,36,53,2,0
38,0,27,40,67,2,0
39,0,19,25,44,2,0
40,0,10,29,39,2,0
41,0,8,26,34,2,0
42,0,13,14,27,2,0
43,0,7,48,55,2,0
44,0,12,63,75,2,0
45,0,14,13,27,2,0
46,0,7,9,16,2,0
47,0,14,15,29,2,0
48,0,74,78,152,2,0
49,0,38,45,83,2,0
50,0,43,58,101,2,0
51,0,44,60,104,2,0
52,0,54,89,143,2,0
53,0,15,11,26,2,0
54,0,12,16,28,2,0
55,0,7,13,20,2,0
56,0,4,11,15,2,0
57,0,3,4,7,2,0
58,0,5,4,9,2,0
59,0,34,48,82,2,0
60,0,55,63,118,2,0
61,0,18,24,42,2,0
62,0,29,46,75,2,0
63,0,23,35,58,2,0
64,0,17,21,38,2,0
65,0,22,20,42,2,0
66,0,23,31,54,2,0
67,0,23,16,39,2,0
68,0,11,23,34,2,0
69,0,19,36,55,2,0
70,0,6,40,46,2,0
71,0,31,68,99,2,0
72,0,6,9,15,2,0
73,0,0,2,2,2,0
74,0,22,70,92,2,0
75,0,23,44,67,2,0
76,0,6,11,17,2,0
77,0,27,47,74,2,0
78,0,30,85,115,2,0
79,0,26,22,48,2,0
80,0,6,10,16,2,0
81,0,22,26,48,2,0
82,0,18,18,36,2,0
83,0,11,27,38,2,0
84,0,19,21,40,2,0
85,0,11,24,35,2,0
86,0,31,30,61,2,0
87,0,26,41,67,2,0
88,0,30,39,69,2,0
89,0,35,54,89,2,0
90,0,27,38,65,2,0
91,0,18,33,51,2,0
92,0,25,36,61,2,0
93,0,5,19,24,2,0
94,0,11,11,22,2,0
95,0,17,52,69,2,0
96,0,48,69,117,2,0
97,0,14,26,40,2,0
98,0,32,45,77,2,0
99,0,36,47,83,2,0
100,0,12,9,21,2,0
101,0,20,26,46,2,0
102,0,17,23,40,2,0
103,0,43,59,102,2,0
104,0,2,15,17,2,0
105,0,12,13,25,2,0
106,0,42,51,93,2,0
107,0,52,101,153,2,0
108,0,29,38,67,2,0
109,0,27,44,71,2,0
110,0,39,51,90,2,0
111,0,27,52,79,2,0
112,0,31,33,64,2,0
113,0,43,70,113,2,0
114,0,15,39,54,2,0
115,0,5,17,22,2,0
116,0,28,39,67,2,0
117,0,13,35,48,2,0
118,0,35,53,88,2,0
119,0,19,49,68,2,0
120,0,17,41,58,2,0
121,0,49,62,111,2,0
122,0,15,43,58,2,0
123,0,28,27,55,2,0
124,0,32,38,70,2,0
125,0,23,46,69,2,0
126,0,37,40,77,2,0
127,0,31,35,66,2,0
128,0,20,56,76,2,0
129,0,22,24,46,2,0
130,0,28,41,69,2,0
131,0,8,13,21,2,0
132,0,57,55,112,2,0
133,0,16,32,48,2,0
134,0,4,12,16,2,0
135,0,3,8,11,2,0
136,0,2,3,5,2,0
137,0,30,33,63,2,0
138,0,35,62,97,2,0
139,0,10,56,66,2,0
140,0,44,107,151,2,0
141,0,46,88,134,2,0
142,0,25,49,74,2,0
143,0,47,58,105,2,0
144,0,34,53,87,2,0
145,0,12,26,38,2,0
146,0,18,74,92,2,0
147,0,3,26,29,2,0
148,0,14,14,28,2,0
149,0,26,43,69,2,0
150,0,27,104,131,2,0
151,0,7,23,30,2,0
152,0,19,27,46,2,0
153,0,18,38,56,2,0
154,0,54,53,107,2,0
155,0,37,69,106,2,0
156,0,27,39,66,2,0
157,0,10,10,20,2,0
158,0,46,65,111,2,0
159,0,26,34,60,2,0
160,0,38,43,81,2,0
161,0,19,9,28,2,0
162,0,27,74,101,2,0
163,0,33,40,73,2,0
164,0,19,16,35,2,0
165,0,26,45,71,2,0
166,0,20,22,42,2,0
167,0,13,32,45,2,0
168,0,23,26,49,2,0
169,0,19,47,66,2,0
170,0,17,32,49,2,0
171,0,19,31,50,2,0
172,0,34,44,78,2,0
173,0,53,85,138,2,0
174,0,33,38,71,2,0
175,0,22,25,47,2,0
176,0,13,41,54,2,0
177,0,11,18,29,2,0
178,0,18,29,47,2,0
179,0,14,20,34,2,0
180,0,13,27,40,2,0
181,0,7,13,20,2,0
182,0,14,23,37,2,0
183,0,11,25,36,2,0
184,0,18,30,48,2,0
185,0,7,10,17,2,0
186,0,10,18,28,2,0
187,0,11,53,64,2,0
188,0,20,35,55,2,0
189,0,34,53,87,2,0
190,0,13,40,53,2,0
191,0,18,42,60,2,0
192,0,53,89,142,2,0
193,0,33,110,143,2,0
194,0,29,28,57,2,0
195,0,3,27,30,2,0
196,0,28,45,73,2,0
197,0,12,32,44,2,0
198,0,4,23,27,2,0
199,0,18,37,55,2,0
200,0,6,120,126,2,0
201,0,13,37,50,2,0
202,0,7,19,26,2,0
203,0,7,19,26,2,0
204,0,10,28,38,2,0
205,0,10,19,29,2,0
206,0,2,12,14,2,0
207,0,13,38,51,2,0
208,0,2,14,16,2,0
209,0,6,13,19,2,0
210,0,10,20,30,2,0
211,0,10,13,23,2,0
212,0,40,56,96,2,0
213,0,10,9,19,2,0
214,0,16,21,37,2,0
215,0,4,16,20,2,0
216,0,5,35,40,2,0
217,0,5,19,24,2,0
218,0,8,38,46,2,0
219,0,11,19,30,2,0
220,0,22,40,62,2,0
221,0,15,44,59,2,0
222,0,6,11,17,2,0
223,0,3,12,15,2,0
224,0,7,8,15,2,0
225,0,4,4,8,2,0
226,0,7,19,26,2,0
227,0,19,36,55,2,0
228,0,18,24,42,2,0
229,0,19,16,35,2,0
230,0,15,24,39,2,0
231,0,6,3,9,2,0
232,0,10,19,29,2,0
233,0,3,8,11,2,0
234,0,0,4,4,2,0
235,0,1,5,6,2,0
236,0,4,14,18,2,0
237,0,13,32,45,2,0
238,0,5,22,27,2,0
239,0,10,19,29,2,0
240,0,0,4,4,2,0
241,0,22,39,61,2,0
242,0,8,16,24,2,0
243,0,12,14,26,2,0
244,0,0,14,14,2,0
245,0,1,1,2,2,0
246,0,1,3,4,2,0
247,0,3,25,28,2,0
248,0,12,18,30,2,0
249,0,22,25,47,2,0
250,0,12,18,30,2,0
251,0,8,30,38,2,0
252,0,10,24,34,2,0
253,0,14,32,46,2,0
254,0,23,36,59,2,0
255,0,0,11,11,2,0
256,0,10,6,16,2,0
257,0,1,5,6,2,0
258,0,38,40,78,2,0
259,0,7,5,12,2,0
260,0,7,8,15,2,0
261,0,5,17,22,2,0
262,0,3,9,12,2,0
263,0,50,77,127,2,0
264,0,18,13,31,2,0
265,0,9,25,34,2,0
266,0,10,21,31,2,0
267,0,19,54,73,2,0
268,0,8,19,27,2,0
269,0,1,1,2,2,0
270,0,2,11,13,2,0
271,0,0,4,4,2,0
272,0,9,11,20,2,0
273,0,24,74,98,2,0
274,0,18,39,57,2,0
275,0,5,6,11,2,0
276,0,4,2,6,2,0
277,0,33,55,88,2,0
278,0,2,10,12,2,0
279,0,2,9,11,2,0
280,0,11,36,47,2,0
281,0,12,12,24,2,0
282,0,3,7,10,2,0
283,0,5,14,19,2,0
284,0,8,18,26,2,0
285,0,2,4,6,2,0
286,0,7,7,14,2,0
287,0,6,42,48,2,0
288,0,3,7,10,2,0
289,0,5,26,31,2,0
290,0,19,45,64,2,0
291,0,0,0,0,2,0
292,0,2,1,3,2,0
293,0,5,15,20,2,0
294,0,1,16,17,2,0
295,0,10,31,41,2,0
296,0,1,2,3,2,0
297,0,1,8,9,2,0
298,0,1,4,5,2,0
299,0,2,3,5,2,0
300,0,7,3,10,2,0
301,0,0,0,0,2,0
302,0,5,29,34,2,0
303,0,6,7,13,2,0
304,0,12,26,38,2,0
305,0,3,17,20,2,0
306,0,12,13,25,2,0
307,0,13,23,36,2,0
308,0,1,4,5,2,0
309,0,8,21,29,2,0
310,0,7,22,29,2,0
311,0,1,2,3,2,0
312,0,12,14,26,2,0
313,0,1,11,12,2,0
314,0,10,22,32,2,0
315,0,28,58,86,2,0
316,0,11,15,26,2,0
317,0,26,43,69,2,0
318,0,32,54,86,2,0
319,0,8,17,25,2,0
320,0,31,57,88,2,0
321,0,19,43,62,2,0
322,0,2,14,16,2,0
323,0,1,4,5,2,0
324,0,0,14,14,2,0
325,0,5,32,37,2,0
326,0,19,61,80,2,0
327,0,7,34,41,2,0
328,0,16,32,48,2,0
329,0,18,38,56,2,0
330,0,13,32,45,2,0
331,0,27,64,91,2,0
332,0,39,112,151,2,0
333,0,2,1,3,2,0
334,0,13,22,35,2,0
335,0,3,2,5,2,0
336,0,12,23,35,2,0
337,0,22,63,85,2,0
338,0,29,58,87,2,0
339,0,13,39,52,2,0
340,0,3,7,10,2,0
341,0,4,26,30,2,0
342,0,4,15,19,2,0
343,0,1,4,5,2,0
344,0,11,51,62,2,0
345,0,5,18,23,2,0
346,0,9,20,29,2,0
347,0,7,20,27,2,0
348,0,8,31,39,2,0
349,0,52,80,132,2,0
350,0,45,49,94,2,0
351,0,9,25,34,2,0
352,0,27,62,89,2,0
353,0,11,29,40,2,0
354,0,13,31,44,2,0
355,0,22,35,57,2,0
356,0,6,10,16,2,0
357,10,21,77,98,2,100
358,10,23,37,60,2,100
359,10,30,52,82,2,100
360,10,25,28,53,2,100
361,10,7,18,25,2,100
362,10,45,76,121,2,100
363,10,18,28,46,2,100
364,10,51,83,134,2,100
365,10,15,28,43,2,100
366,10,10,11,21,2,100
367,10,31,67,98,2,100
368,10,11,26,37,2,100
369,10,20,38,58,2,100
370,10,45,38,83,2,100
371,10,3,3,6,2,100
372,10,2,7,9,2,100
373,10,17,18,35,2,100
374,10,25,50,75,2,100
375,10,13,17,30,2,100
376,10,72,98,170,2,100
377,10,46,69,115,2,100
378,10,36,90,126,2,100
379,10,16,49,65,2,100
380,10,22,49,71,2,100
381,10,18,34,52,2,100
382,10,8,31,39,2,100
383,10,21,26,47,2,100
384,10,10,21,31,2,100
385,10,11,22,33,2,100
386,10,75,89,164,2,100
387,10,28,57,85,2,100
388,10,58,131,189,2,100
389,10,54,96,150,2,100
390,10,61,67,128,2,100
391,10,35,32,67,2,100
392,10,41,31,72,2,100
393,10,56,99,155,2,100
394,10,1,1,2,2,100
395,10,25,18,43,2,100
396,10,20,16,36,2,100
397,10,3,30,33,2,100
398,10,33,36,69,2,100
399,10,5,8,13,2,100
400,10,0,2,2,2,100
401,10,9,9,18,2,100
402,10,2,1,3,2,100
403,10,9,21,30,2,100
404,10,30,62,92,2,100
405,10,18,42,60,2,100
406,10,18,29,47,2,100
407,10,15,28,43,2,100
408,10,11,14,25,2,100
409,10,12,14,26,2,100
410,10,14,27,41,2,100
411,10,28,43,71,2,100
412,10,31,59,90,2,100
413,10,28,50,78,2,100
414,10,11,16,27,2,100
415,10,28,49,77,2,100
416,10,24,47,71,2,100
417,10,50,77,127,2,100
418,10,21,22,43,2,100
419,10,25,58,83,2,100
420,10,16,118,134,2,100
421,10,17,22,39,2,100
422,10,8,8,16,2,100
423,10,16,24,40,2,100
424,10,11,5,16,2,100
425,10,5,12,17,2,100
426,10,6,63,69,2,100
427,10,69,106,175,2,100
428,10,23,47,70,2,100
429,10,6,23,29,2,100
430,10,5,15,20,2,100
431,10,5,12,17,2,100
432,10,16,25,41,2,100
433,10,33,83,116,2,100
434,10,10,34,44,2,100
435,10,38,16,54,2,100
436,10,37,57,94,2,100
437,10,19,41,60,2,100
438,10,21,32,53,2,100
439,10,40,44,84,2,100
440,10,28,45,73,2,100
441,10,19,26,45,2,100
442,10,27,68,95,2,100
443,10,20,22,42,2,100
444,10,2,18,20,2,100
445,10,16,16,32,2,100
446,10,5,20,25,2,100
447,10,4,16,20,2,100
448,10,21,6,27,2,100
449,10,32,68,100,2,100
450,10,56,169,225,2,100
451,10,36,31,67,2,100
452,10,75,92,167,2,100
453,10,75,150,225,2,100
454,10,8,5,13,2,100
455,10,13,42,55,2,100
456,10,17,34,51,2,100
457,10,20,45,65,2,100
458,10,9,28,37,2,100
459,10,25,10,35,2,100
460,10,20,26,46,2,100
461,10,11,6,17,2,100
462,10,44,81,125,2,100
463,10,19,155,174,2,100
464,10,35,74,109,2,100
465,10,23,20,43,2,100
466,10,26,37,63,2,100
467,10,19,27,46,2,100
468,10,41,83,124,2,100
469,10,36,70,106,2,100
470,10,39,112,151,2,100
471,10,31,42,73,2,100
472,10,22,39,61,2,100
473,10,59,66,125,2,100
474,10,51,84,135,2,100
475,10,17,36,53,2,100
476,10,19,9,28,2,100
477,10,18,36,54,2,100
478,10,10,17,27,2,100
479,10,29,39,68,2,100
480,10,14,19,33,2,100
481,10,3,3,6,2,100
482,10,7,17,24,2,100
483,10,35,48,83,2,100
484,10,33,45,78,2,100
485,10,0,0,0,2,100
486,10,0,2,2,2,100
487,10,9,20,29,2,100
488,10,3,21,24,2,100
489,10,8,29,37,2,100
490,10,24,32,56,2,100
491,10,4,7,11,2,100
492,10,13,17,30,2,100
493,10,53,60,113,2,100
494,10,11,31,42,2,100
495,10,30,63,93,2,100
496,10,12,14,26,2,100
497,10,32,25,57,2,100
498,10,15,22,37,2,100
499,10,9,25,34,2,100
500,10,5,11,16,2,100
501,10,12,47,59,2,100
502,10,17,37,54,2,100
503,10,5,6,11,2,100
504,10,32,57,89,2,100
505,10,17,23,40,2,100
506,10,26,42,68,2,100
507,10,12,24,36,2,100
508,10,22,40,62,2,100
509,10,6,22,28,2,100
510,10,82,38,120,2,100
511,10,50,79,129,2,100
512,10,2,5,7,2,100
513,10,24,36,60,2,100
514,10,1,6,7,2,100
515,10,26,57,83,2,100
516,10,18,28,46,2,100
517,10,28,49,77,2,100
518,10,48,69,117,2,100
519,10,45,67,112,2,100
520,10,16,24,40,2,100
521,10,25,27,52,2,100
522,10,20,14,34,2,100
523,10,18,59,77,2,100
524,10,10,26,36,2,100
525,10,10,101,111,2,100
526,10,7,12,19,2,100
527,10,18,47,65,2,100
528,10,26,43,69,2,100
529,10,10,4,14,2,100
530,10,2,9,11,2,100
531,10,3,10,13,2,100
532,10,18,32,50,2,100
533,10,13,20,33,2,100
534,10,69,152,221,2,100
535,10,24,72,96,2,100
536,10,18,13,31,2,100
537,10,25,38,63,2,100
538,10,43,87,130,2,100
539,10,27,60,87,2,100
540,10,8,44,52,2,100
541,10,38,87,125,2,100
542,10,1,38,39,2,100
543,10,20,12,32,2,100
544,10,4,26,30,2,100
545,10,14,6,20,2,100
546,10,28,33,61,2,100
547,10,32,81,113,2,100
548,10,13,32,45,2,100
549,10,21,51,72,2,100
550,10,32,61,93,2,100
551,10,18,28,46,2,100
552,10,30,62,92,2,100
553,10,20,38,58,2,100
554,10,19,40,59,2,100
555,10,14,22,36,2,100
556,10,70,102,172,2,100
557,10,3,7,10,2,100
558,10,4,6,10,2,100
559,10,15,58,73,2,100
560,10,3,39,42,2,100
561,10,8,17,25,2,100
562,10,27,29,56,2,100
563,10,11,2,13,2,100
564,10,26,62,88,2,100
565,10,33,49,82,2,100
566,10,25,23,48,2,100
567,10,16,24,40,2,100
568,10,28,45,73,2,100
569,10,7,14,21,2,100
570,10,34,76,110,2,100
571,10,17,22,39,2,100
572,10,25,41,66,2,100
573,10,24,60,84,2,100
574,10,33,58,91,2,100
575,10,39,86,125,2,100
576,10,51,74,125,2,100
577,10,40,60,100,2,100
578,10,44,62,106,2,100
579,10,10,13,23,2,100
580,10,16,14,30,2,100
581,10,34,38,72,2,100
582,10,27,61,88,2,100
583,10,24,51,75,2,100
584,10,26,75,101,2,100
585,10,18,24,42,2,100
586,10,25,43,68,2,100
587,10,11,30,41,2,100
588,10,10,16,26,2,100
589,10,45,93,138,2,100
590,10,35,45,80,2,100
591,10,14,38,52,2,100
592,10,65,96,161,2,100
593,10,25,52,77,2,100
594,10,71,146,217,2,100
595,10,49,91,140,2,100
596,10,57,63,120,2,100
597,10,13,47,60,2,100
598,10,28,25,53,2,100
599,10,9,26,35,2,100
600,10,24,37,61,2,100
601,10,43,110,153,2,100
602,10,32,54,86,2,100
603,10,48,92,140,2,100
604,10,18,49,67,2,100
605,10,19,91,110,2,100
606,10,32,79,111,2,100
607,10,34,50,84,2,100
608,10,25,53,78,2,100
609,10,28,47,75,2,100
610,10,31,32,63,2,100
611,10,36,57,93,2,100
612,10,28,58,86,2,100
613,10,25,37,62,2,100
614,10,36,69,105,2,100
615,10,26,36,62,2,100
616,10,56,100,156,2,100
617,10,37,74,111,2,100
618,10,12,14,26,2,100
619,10,34,31,65,2,100
620,10,16,18,34,2,100
621,10,27,22,49,2,100
622,10,52,85,137,2,100
623,10,56,108,164,2,100
624,10,66,65,131,2,100
625,10,14,26,40,2,100
626,10,57,66,123,2,100
627,10,53,98,151,2,100
628,10,78,141,219,2,100
629,10,34,60,94,2,100
630,10,16,36,52,2,100
631,10,46,67,113,2,100
632,10,4,18,22,2,100
633,10,35,38,73,2,100
634,10,60,49,109,2,100
635,10,1,7,8,2,100
636,10,35,71,106,2,100
637,10,13,15,28,2,100
638,10,11,14,25,2,100
639,10,9,29,38,2,100
640,10,39,66,105,2,100
641,10,54,69,123,2,100
642,10,59,65,124,2,100
643,10,45,78,123,2,100
644,10,18,159,177,2,100
645,10,53,103,156,2,100
646,10,51,94,145,2,100
647,10,41,86,127,2,100
648,10,36,52,88,2,100
649,10,20,55,75,2,100
650,10,51,85,136,2,100
651,10,20,44,64,2,100
652,10,38,56,94,2,100
653,10,30,21,51,2,100
654,10,61,95,156,2,100
655,10,65,112,177,2,100
656,10,16,20,36,2,100
657,10,37,56,93,2,100
658,10,31,43,74,2,100
659,10,32,32,64,2,100
660,10,15,20,35,2,100
661,10,32,61,93,2,100
662,10,13,27,40,2,100
663,10,14,15,29,2,100
664,10,12,44,56,2,100
665,10,2,2,4,2,100
666,10,15,27,42,2,100
667,10,40,40,80,2,100
668,10,25,36,61,2,100
669,10,21,45,66,2,100
670,10,28,44,72,2,100
671,10,23,25,48,2,100
672,10,40,57,97,2,100
673,10,23,32,55,2,100
674,10,52,85,137,2,100
675,10,21,66,87,2,100
676,10,81,144,225,2,100
677,10,50,94,144,2,100
678,10,47,93,140,2,100
679,10,8,27,35,2,100
680,10,34,41,75,2,100
681,10,41,35,76,2,100
682,10,15,34,49,2,100
683,10,17,22,39,2,100
684,10,27,44,71,2,100
685,10,24,59,83,2,100
686,10,18,32,50,2,100
687,10,7,23,30,2,100
688,10,5,17,22,2,100
689,10,14,32,46,2,100
690,10,24,48,72,2,100
691,10,2,3,5,2,100
692,10,14,38,52,2,100
693,10,45,93,138,2,100
694,10,36,63,99,2,100
695,10,24,45,69,2,100
696,10,31,51,82,2,100
697,10,34,55,89,2,100
698,10,8,21,29,2,100
699,10,13,5,18,2,100
700,10,57,61,118,2,100
701,10,20,13,33,2,100
702,10,40,56,96,2,100
703,10,53,74,127,2,100
704,10,15,4,19,2,100
705,10,10,8,18,2,100
706,10,26,34,60,2,100
707,10,18,19,37,2,100
708,10,77,65,142,2,100
709,10,58,39,97,2,100
710,10,13,24,37,2,100
711,10,48,55,103,2,100
712,10,20,40,60,2,100
713,10,23,21,44,2,100
714,10,29,38,67,2,100
715,10,12,30,42,2,100
716,10,21,35,56,2,100
717,10,33,21,54,2,100
718,10,31,41,72,2,100
719,10,15,51,66,2,100
720,10,36,49,85,2,100
721,10,4,9,13,2,100
722,10,11,6,17,2,100
723,10,10,17,27,2,100
724,10,36,26,62,2,100
725,10,4,6,10,2,100
726,10,18,23,41,2,100
727,10,4,5,9,2,100
728,10,7,12,19,2,100
729,10,1,6,7,2,100
730,10,20,45,65,2,100
731,10,41,64,105,2,100
732,10,17,39,56,2,100
733,10,19,44,63,2,100
734,10,5,26,31,2,100
735,10,32,44,76,2,100
736,10,31,30,61,2,100
737,10,14,17,31,2,100
738,10,11,16,27,2,100
739,10,9,15,24,2,100
740,10,1,23,24,2,100
741,10,11,39,50,2,100
742,10,3,19,22,2,100
743,10,27,28,55,2,100
744,10,9,42,51,2,100
745,10,22,41,63,2,100
746,10,44,122,166,2,100
747,10,7,16,23,2,100
748,10,78,131,209,2,100
749,10,100,189,289,2,100
750,10,31,59,90,2,100
751,10,32,37,69,2,100
752,10,5,17,22,2,100
753,10,35,102,137,2,100
754,10,11,36,47,2,100
755,20,23,34,57,2,100
756,20,28,39,67,2,100
757,20,49,69,118,2,100
758,20,38,72,110,2,100
759,20,36,68,104,2,100
760,20,8,31,39,2,100
761,20,80,155,235,2,100
762,20,31,26,57,2,100
763,20,36,74,110,2,100
764,20,65,92,157,2,100
765,20,19,20,39,2,100
766,20,15,8,23,2,100
767,20,9,14,23,2,100
768,20,16,35,51,2,100
769,20,13,10,23,2,100
770,20,78,137,215,2,100
771,20,39,75,114,2,100
772,20,36,67,103,2,100
773,20,33,49,82,2,100
774,20,19,44,63,2,100
775,20,40,61,101,2,100
776,20,24,28,52,2,100
777,20,11,26,37,2,100
778,20,0,0,0,2,100
779,20,0,0,0,2,100
780,20,32,40,72,2,100
781,20,17,26,43,2,100
782,20,85,136,221,2,100
783,20,40,54,94,2,100
784,20,86,122,208,2,100
785,20,32,35,67,2,100
786,20,67,108,175,2,100
787,20,52,56,108,2,100
788,20,9,33,42,2,100
789,20,19,40,59,2,100
790,20,26,13,39,2,100
791,20,22,36,58,2,100
792,20,37,96,133,2,100
793,20,4,29,33,2,100
794,20,46,72,118,2,100
795,20,19,16,35,2,100
796,20,40,50,90,2,100
797,20,47,37,84,2,100
798,20,24,64,88,2,100
799,20,42,40,82,2,100
800,20,24,48,72,2,100
801,20,51,86,137,2,100
802,20,24,35,59,2,100
803,20,9,22,31,2,100
804,20,51,91,142,2,100
805,20,14,36,50,2,100
806,20,30,42,72,2,100
807,20,46,42,88,2,100
808,20,16,16,32,2,100
809,20,17,38,55,2,100
810,20,54,84,138,2,100
811,20,40,69,109,2,100
812,20,41,54,95,2,100
813,20,29,37,66,2,100
814,20,37,74,111,2,100
815,20,10,7,17,2,100
816,20,2,4,6,2,100
817,20,68,141,209,2,100
818,20,59,60,119,2,100
819,20,33,69,102,2,100
820,20,4,21,25,2,100
821,20,67,108,175,2,100
822,20,41,91,132,2,100
823,20,34,38,72,2,100
824,20,22,30,52,2,100
825,20,28,32,60,2,100
826,20,51,31,82,2,100
827,20,16,17,33,2,100
828,20,18,37,55,2,100
829,20,15,17,32,2,100
830,20,8,37,45,2,100
831,20,2,1,3,2,100
832,20,91,97,188,2,100
833,20,43,24,67,2,100
834,20,58,71,129,2,100
835,20,12,30,42,2,100
836,20,13,34,47,2,100
837,20,46,35,81,2,100
838,20,33,45,78,2,100
839,20,49,72,121,2,100
840,20,8,24,32,2,100
841,20,86,136,222,2,100
842,20,23,37,60,2,100
843,20,18,20,38,2,100
844,20,41,52,93,2,100
845,20,7,12,19,2,100
846,20,26,29,55,2,100
847,20,7,23,30,2,100
848,20,5,16,21,2,100
849,20,22,17,39,2,100
850,20,28,48,76,2,100
851,20,18,27,45,2,100
852,20,18,18,36,2,100
853,20,62,64,126,2,100
854,20,42,62,104,2,100
855,20,39,42,81,2,100
856,20,36,32,68,2,100
857,20,24,40,64,2,100
858,20,25,27,52,2,100
859,20,38,47,85,2,100
860,20,29,40,69,2,100
861,20,40,56,96,2,100
862,20,20,14,34,2,100
863,20,29,41,70,2,100
864,20,36,42,78,2,100
865,20,56,82,138,2,100
866,20,71,81,152,2,100
867,20,20,23,43,2,100
868,20,53,81,134,2,100
869,20,44,51,95,2,100
870,20,19,44,63,2,100
871,20,36,57,93,2,100
872,20,15,37,52,2,100
873,20,48,57,105,2,100
874,20,78,72,150,2,100
875,20,43,75,118,2,100
876,20,51,73,124,2,100
877,20,16,18,34,2,100
878,20,12,30,42,2,100
879,20,10,46,56,2,100
880,20,50,63,113,2,100
881,20,82,72,154,2,100
882,20,36,28,64,2,100
883,20,20,19,39,2,100
884,20,13,40,53,2,100
885,20,31,36,67,2,100
886,20,30,30,60,2,100
887,20,31,64,95,2,100
888,20,14,7,21,2,100
889,20,43,18,61,2,100
890,20,28,44,72,2,100
891,20,46,51,97,2,100
892,20,37,64,101,2,100
893,20,22,28,50,2,100
894,20,76,128,204,2,100
895,20,30,28,58,2,100
896,20,27,21,48,2,100
897,20,68,70,138,2,100
898,20,27,65,92,2,100
899,20,25,51,76,2,100
900,20,34,79,113,2,100
901,20,57,81,138,2,100
902,20,48,68,116,2,100
903,20,30,67,97,2,100
904,20,51,64,115,2,100
905,20,20,23,43,2,100
906,20,43,25,68,2,100
907,20,29,40,69,2,100
908,20,72,134,206,2,100
909,20,10,25,35,2,100
910,20,55,82,137,2,100
911,20,4,1,5,2,100
912,20,72,62,134,2,100
913,20,31,64,95,2,100
914,20,38,33,71,2,100
915,20,108,174,282,2,100
916,20,36,67,103,2,100
917,20,56,70,126,2,100
918,20,54,74,128,2,100
919,20,63,76,139,2,100
920,20,15,48,63,2,100
921,20,4,10,14,2,100
922,20,16,11,27,2,100
923,20,42,38,80,2,100
924,20,46,56,102,2,100
925,20,20,23,43,2,100
926,20,6,9,15,2,100
927,20,2,9,11,2,100
928,20,4,8,12,2,100
929,20,12,25,37,2,100
930,20,12,28,40,2,100
931,20,19,23,42,2,100
932,20,13,21,34,2,100
933,20,11,11,22,2,100
934,20,22,26,48,2,100
935,20,33,77,110,2,100
936,20,50,56,106,2,100
937,20,36,34,70,2,100
938,20,61,79,140,2,100
939,20,17,24,41,2,100
940,20,23,36,59,2,100
941,20,25,48,73,2,100
942,20,35,30,65,2,100
943,20,17,19,36,2,100
944,20,17,59,76,2,100
945,20,47,33,80,2,100
946,20,62,53,115,2,100
947,20,65,57,122,2,100
948,20,16,29,45,2,100
949,20,5,10,15,2,100
950,20,25,44,69,2,100
951,20,38,65,103,2,100
952,20,48,53,101,2,100
953,20,38,45,83,2,100
954,20,15,33,48,2,100
955,20,17,36,53,2,100
956,20,47,70,117,2,100
957,20,68,74,142,2,100
958,20,2,8,10,2,100
959,20,52,79,131,2,100
960,20,20,29,49,2,100
961,20,12,15,27,2,100
962,20,9,12,21,2,100
963,20,39,67,106,2,100
964,20,8,10,18,2,100
965,20,7,21,28,2,100
966,20,35,54,89,2,100
967,20,20,26,46,2,100
968,20,82,113,195,2,100
969,20,23,48,71,2,100
970,20,10,15,25,2,100
971,20,46,54,100,2,100
972,20,4,19,23,2,100
973,20,50,109,159,2,100
974,20,52,34,86,2,100
975,20,25,71,96,2,100
976,20,2,8,10,2,100
977,20,24,31,55,2,100
978,20,13,14,27,2,100
979,20,27,53,80,2,100
980,20,63,26,89,2,100
981,20,40,68,108,2,100
982,20,89,62,151,2,100
983,20,54,77,131,2,100
984,20,59,52,111,2,100
985,20,40,58,98,2,100
986,20,77,128,205,2,100
987,20,38,61,99,2,100
988,20,43,59,102,2,100
989,20,31,31,62,2,100
990,20,50,69,119,2,100
991,20,38,75,113,2,100
992,20,1,7,8,2,100
993,20,26,27,53,2,100
994,20,43,36,79,2,100
995,20,41,55,96,2,100
996,20,33,49,82,2,100
997,20,72,99,171,2,100
998,20,18,12,30,2,100
999,20,21,36,57,2,100
1000,20,19,65,84,2,100
1001,20,20,57,77,2,100
1002,20,23,65,88,2,100
1003,20,0,0,0,2,100
1004,20,1,8,9,2,100
1005,20,14,33,47,2,100
1006,20,12,21,33,2,100
1007,20,36,55,91,2,100
1008,20,15,68,83,2,100
1009,20,40,81,121,2,100
1010,20,49,49,98,2,100
1011,20,24,43,67,2,100
1012,20,45,97,142,2,100
1013,20,6,49,55,2,100
1014,20,11,23,34,2,100
1015,20,36,76,112,2,100
1016,20,4,19,23,2,100
1017,20,28,72,100,2,100
1018,20,28,48,76,2,100
1019,20,48,93,141,2,100
1020,20,45,55,100,2,100
1021,20,39,48,87,2,100
1022,20,56,80,136,2,100
1023,20,20,11,31,2,100
1024,20,2,34,36,2,100
1025,20,24,40,64,2,100
1026,20,5,4,9,2,100
1027,20,14,37,51,2,100
1028,20,7,9,16,2,100
1029,20,79,56,135,2,100
1030,20,2,1,3,2,100
1031,20,23,16,39,2,100
1032,20,12,31,43,2,100
1033,20,75,84,159,2,100
1034,20,31,34,65,2,100
1035,20,11,26,37,2,100
1036,20,16,20,36,2,100
1037,20,19,79,98,2,100
1038,20,22,23,45,2,100
1039,20,41,31,72,2,100
1040,20,39,42,81,2,100
1041,20,18,37,55,2,100
1042,20,12,69,81,2,100
1043,20,11,9,20,2,100
1044,20,12,38,50,2,100
1045,20,4,18,22,2,100
1046,20,67,63,130,2,100
1047,20,38,53,91,2,100
1048,20,1,3,4,2,100
1049,20,9,10,19,2,100
1050,20,28,30,58,2,100
1051,20,10,9,19,2,100
1052,20,10,11,21,2,100
1053,20,8,10,18,2,100
1054,20,25,39,64,2,100
1055,20,20,42,62,2,100
1056,20,13,22,35,2,100
1057,20,16,16,32,2,100
1058,20,36,41,77,2,100
1059,20,25,36,61,2,100
1060,20,40,53,93,2,100
1061,20,57,51,108,2,100
1062,20,15,22,37,2,100
1063,20,12,20,32,2,100
1064,20,18,25,43,2,100
1065,20,18,34,52,2,100
1066,20,3,25,28,2,100
1067,20,11,26,37,2,100
1068,20,15,14,29,2,100
1069,20,7,8,15,2,100
1070,20,5,7,12,2,100
1071,20,76,101,177,2,100
1072,20,42,65,107,2,100
1073,20,33,51,84,2,100
1074,20,48,50,98,2,100
1075,20,36,39,75,2,100
1076,20,23,41,64,2,100
1077,20,51,54,105,2,100
1078,20,8,35,43,2,100
1079,20,33,56,89,2,100
1080,20,0,3,3,2,100
1081,20,14,16,30,2,100
1082,20,42,122,164,2,100
1083,20,14,12,26,2,100
1084,20,25,43,68,2,100
1085,20,25,28,53,2,100
1086,20,46,87,133,2,100
1087,20,16,17,33,2,100
1088,20,20,22,42,2,100
1089,20,13,9,22,2,100
1090,20,26,42,68,2,100
1091,20,36,55,91,2,100
1092,20,42,54,96,2,100
1093,20,78,129,207,2,100
1094,20,29,60,89,2,100
1095,20,33,54,87,2,100
1096,20,6,23,29,2,100
1097,20,45,85,130,2,100
1098,20,44,106,150,2,100
1099,20,19,40,59,2,100
1100,20,5,28,33,2,100
1101,20,17,38,55,2,100
1102,20,3,7,10,2,100
1103,20,72,204,276,2,100
1104,20,58,60,118,2,100
1105,20,11,8,19,2,100
1106,20,26,26,52,2,100
1107,20,7,30,37,2,100
1108,20,56,75,131,2,100
1109,20,38,56,94,2,100
1110,20,17,33,50,2,100
1111,20,30,30,60,2,100
1112,20,29,59,88,2,100
1113,20,4,7,11,2,100
1114,20,8,31,39,2,100
1115,20,6,2,8,2,100
1116,20,5,11,16,2,100
1117,20,43,42,85,2,100
1118,20,15,22,37,2,100
1119,20,23,45,68,2,100
1120,20,12,40,52,2,100
1121,20,15,17,32,2,100
1122,20,15,28,43,2,100
1123,20,16,34,50,2,100
1124,20,15,31,46,2,100
1125,20,19,20,39,2,100
1126,20,28,22,50,2,100
1127,20,24,45,69,2,100
1128,20,10,20,30,2,100
1129,20,7,20,27,2,100
1130,20,2,3,5,2,100
1131,20,13,30,43,2,100
1132,20,10,22,32,2,100
1133,20,5,17,22,2,100
1134,20,3,8,11,2,100
1135,20,12,31,43,2,100
1136,20,5,5,10,2,100
1137,20,9,15,24,2,100
1138,20,10,16,26,2,100
1139,20,28,40,68,2,100
1140,20,39,49,88,2,100
1141,20,17,25,42,2,100
1142,20,7,18,25,2,100
1143,20,9,32,41,2,100
1144,20,12,17,29,2,100
1145,20,11,24,35,2,100
1146,20,4,4,8,2,100
1147,20,22,24,46,2,100
1148,20,9,4,13,2,100
1149,20,16,19,35,2,100
1150,20,6,44,50,2,100
1151,20,18,12,30,2,100
1152,20,4,16,20,2,100
1153,30,6,4,10,2,100
1154,30,38,30,68,2,100
1155,30,43,67,110,2,100
1156,30,20,31,51,2,100
1157,30,113,114,227,2,100
1158,30,99,127,226,2,100
1159,30,63,56,119,2,100
1160,30,10,1,11,2,100
1161,30,27,35,62,2,100
1162,30,80,62,142,2,100
1163,30,105,70,175,2,100
1164,30,35,35,70,2,100
1165,30,59,45,104,2,100
1166,30,45,59,104,2,100
1167,30,16,35,51,2,100
1168,30,37,78,115,2,100
1169,30,26,46,72,2,100
1170,30,29,42,71,2,100
1171,30,83,40,123,2,100
1172,30,27,29,56,2,100
1173,30,10,11,21,2,100
1174,30,26,30,56,2,100
1175,30,16,20,36,2,100
1176,30,29,15,44,2,100
1177,30,16,16,32,2,100
1178,30,42,75,117,2,100
1179,30,41,55,96,2,100
1180,30,36,42,78,2,100
1181,30,45,35,80,2,100
1182,30,47,96,143,2,100
1183,30,32,53,85,2,100
1184,30,39,59,98,2,100
1185,30,59,29,88,2,100
1186,30,112,167,279,2,100
1187,30,13,14,27,2,100
1188,30,37,28,65,2,100
1189,30,108,126,234,2,100
1190,30,32,42,74,2,100
1191,30,17,31,48,2,100
1192,30,9,32,41,2,100
1193,30,51,37,88,2,100
1194,30,43,64,107,2,100
1195,30,15,30,45,2,100
1196,30,6,5,11,2,100
1197,30,10,21,31,2,100
1198,30,19,26,45,2,100
1199,30,7,24,31,2,100
1200,30,16,24,40,2,100
1201,30,63,112,175,2,100
1202,30,56,51,107,2,100
1203,30,43,127,170,2,100
1204,30,26,51,77,2,100
1205,30,35,40,75,2,100
1206,30,177,187,364,2,100
1207,30,10,20,30,2,100
1208,30,7,108,115,2,100
1209,30,30,43,73,2,100
1210,30,20,36,56,2,100
1211,30,30,34,64,2,100
1212,30,46,35,81,2,100
1213,30,11,53,64,2,100
1214,30,9,12,21,2,100
1215,30,47,51,98,2,100
1216,30,41,57,98,2,100
1217,30,126,246,372,2,100
1218,30,51,76,127,2,100
1219,30,18,19,37,2,100
1220,30,44,48,92,2,100
1221,30,32,52,84,2,100
1222,30,39,16,55,2,100
1223,30,9,12,21,2,100
1224,30,15,41,56,2,100
1225,30,72,49,121,2,100
1226,30,2,1,3,2,100
1227,30,16,26,42,2,100
1228,30,50,60,110,2,100
1229,30,55,48,103,2,100
1230,30,67,54,121,2,100
1231,30,50,41,91,2,100
1232,30,122,112,234,2,100
1233,30,17,29,46,2,100
1234,30,53,74,127,2,100
1235,30,50,70,120,2,100
1236,30,10,6,16,2,100
1237,30,31,70,101,2,100
1238,30,60,79,139,2,100
1239,30,23,11,34,2,100
1240,30,21,21,42,2,100
1241,30,28,12,40,2,100
1242,30,56,73,129,2,100
1243,30,64,202,266,2,100
1244,30,38,95,133,2,100
1245,30,32,29,61,2,100
1246,30,53,49,102,2,100
1247,30,61,60,121,2,100
1248,30,44,28,72,2,100
1249,30,33,10,43,2,100
1250,30,36,39,75,2,100
1251,30,30,30,60,2,100
1252,30,62,141,203,2,100
1253,30,11,7,18,2,100
1254,30,29,29,58,2,100
1255,30,6,7,13,2,100
1256,30,61,132,193,2,100
1257,30,27,23,50,2,100
1258,30,16,15,31,2,100
1259,30,93,97,190,2,100
1260,30,30,56,86,2,100
1261,30,20,72,92,2,100
1262,30,55,54,109,2,100
1263,30,60,91,151,2,100
1264,30,27,33,60,2,100
1265,30,14,14,28,2,100
1266,30,61,86,147,2,100
1267,30,82,73,155,2,100
1268,30,80,134,214,2,100
1269,30,61,88,149,2,100
1270,30,71,101,172,2,100
1271,30,24,60,84,2,100
1272,30,64,90,154,2,100
1273,30,41,45,86,2,100
1274,30,118,107,225,2,100
1275,30,125,81,206,2,100
1276,30,27,19,46,2,100
1277,30,20,23,43,2,100
1278,30,18,32,50,2,100
1279,30,35,41,76,2,100
1280,30,12,70,82,2,100
1281,30,47,39,86,2,100
1282,30,44,64,108,2,100
1283,30,19,56,75,2,100
1284,30,26,46,72,2,100
1285,30,24,47,71,2,100
1286,30,129,58,187,2,100
1287,30,14,22,36,2,100
1288,30,21,80,101,2,100
1289,30,19,51,70,2,100
1290,30,24,11,35,2,100
1291,30,52,75,127,2,100
1292,30,28,11,39,2,100
1293,30,64,99,163,2,100
1294,30,21,16,37,2,100
1295,30,96,232,328,2,100
1296,30,60,71,131,2,100
1297,30,55,14,69,2,100
1298,30,17,24,41,2,100
1299,30,17,40,57,2,100
1300,30,73,112,185,2,100
1301,30,5,12,17,2,100
1302,30,36,59,95,2,100
1303,30,12,14,26,2,100
1304,30,2,7,9,2,100
1305,30,10,20,30,2,100
1306,30,66,60,126,2,100
1307,30,7,0,7,2,100
1308,30,8,18,26,2,100
1309,30,16,18,34,2,100
1310,30,7,18,25,2,100
1311,30,20,43,63,2,100
1312,30,60,63,123,2,100
1313,30,22,52,74,2,100
1314,30,35,61,96,2,100
1315,30,10,11,21,2,100
1316,30,31,71,102,2,100
1317,30,17,25,42,2,100
1318,30,26,61,87,2,100
1319,30,77,74,151,2,100
1320,30,31,22,53,2,100
1321,30,50,85,135,2,100
1322,30,80,91,171,2,100
1323,30,45,111,156,2,100
1324,30,10,19,29,2,100
1325,30,36,66,102,2,100
1326,30,18,23,41,2,100
1327,30,43,77,120,2,100
1328,30,9,6,15,2,100
1329,30,3,12,15,2,100
1330,30,19,14,33,2,100
1331,30,21,78,99,2,100
1332,30,4,9,13,2,100
1333,30,17,26,43,2,100
1334,30,63,37,100,2,100
1335,30,52,79,131,2,100
1336,30,11,9,20,2,100
1337,30,36,32,68,2,100
1338,30,27,26,53,2,100
1339,30,71,74,145,2,100
1340,30,13,7,20,2,100
1341,30,44,76,120,2,100
1342,30,14,23,37,2,100
1343,30,18,33,51,2,100
1344,30,17,42,59,2,100
1345,30,12,31,43,2,100
1346,30,25,38,63,2,100
1347,30,6,14,20,2,100
1348,30,34,54,88,2,100
1349,30,9,14,23,2,100
1350,30,37,42,79,2,100
1351,30,64,82,146,2,100
1352,30,46,53,99,2,100
1353,30,35,29,64,2,100
1354,30,37,42,79,2,100
1355,30,111,170,281,2,100
1356,30,8,24,32,2,100
1357,30,25,36,61,2,100
1358,30,142,191,333,2,100
1359,30,79,138,217,2,100
1360,30,8,24,32,2,100
1361,30,23,31,54,2,100
1362,30,38,71,109,2,100
1363,30,4,3,7,2,100
1364,30,11,35,46,2,100
1365,30,31,24,55,2,100
1366,30,49,65,114,2,100
1367,30,59,56,115,2,100
1368,30,44,41,85,2,100
1369,30,58,83,141,2,100
1370,30,69,119,188,2,100
1371,30,43,56,99,2,100
1372,30,25,35,60,2,100
1373,30,54,84,138,2,100
1374,30,18,49,67,2,100
1375,30,50,42,92,2,100
1376,30,13,17,30,2,100
1377,30,17,8,25,2,100
1378,30,8,16,24,2,100
1379,30,7,10,17,2,100
1380,30,26,16,42,2,100
1381,30,34,46,80,2,100
1382,30,166,212,378,2,100
1383,30,21,18,39,2,100
1384,30,116,124,240,2,100
1385,30,68,61,129,2,100
1386,30,42,39,81,2,100
1387,30,28,41,69,2,100
1388,30,106,97,203,2,100
1389,30,17,29,46,2,100
1390,30,12,30,42,2,100
1391,30,20,19,39,2,100
1392,30,22,29,51,2,100
1393,30,90,89,179,2,100
1394,30,53,81,134,2,100
1395,30,49,54,103,2,100
1396,30,32,23,55,2,100
1397,30,72,110,182,2,100
1398,30,94,135,229,2,100
1399,30,185,273,458,2,100
1400,30,24,38,62,2,100
1401,30,39,89,128,2,100
1402,30,10,25,35,2,100
1403,30,23,18,41,2,100
1404,30,53,67,120,2,100
1405,30,79,68,147,2,100
1406,30,23,42,65,2,100
1407,30,94,110,204,2,100
1408,30,80,102,182,2,100
1409,30,23,30,53,2,100
1410,30,127,123,250,2,100
1411,30,43,50,93,2,100
1412,30,57,101,158,2,100
1413,30,55,66,121,2,100
1414,30,63,68,131,2,100
1415,30,2,7,9,2,100
1416,30,44,27,71,2,100
1417,30,38,58,96,2,100
1418,30,18,48,66,2,100
1419,30,58,109,167,2,100
1420,30,80,111,191,2,100
1421,30,49,34,83,2,100
1422,30,64,34,98,2,100
1423,30,89,100,189,2,100
1424,30,57,102,159,2,100
1425,30,76,93,169,2,100
1426,30,47,75,122,2,100
1427,30,15,30,45,2,100
1428,30,34,31,65,2,100
1429,30,28,31,59,2,100
1430,30,21,35,56,2,100
1431,30,50,37,87,2,100
1432,30,16,18,34,2,100
1433,30,51,30,81,2,100
1434,30,53,50,103,2,100
1435,30,46,43,89,2,100
1436,30,108,220,328,2,100
1437,30,60,66,126,2,100
1438,30,98,136,234,2,100
1439,30,30,44,74,2,100
1440,30,45,70,115,2,100
1441,30,22,41,63,2,100
1442,30,79,98,177,2,100
1443,30,11,21,32,2,100
1444,30,21,28,49,2,100
1445,30,48,79,127,2,100
1446,30,11,16,27,2,100
1447,30,26,38,64,2,100
1448,30,48,63,111,2,100
1449,30,4,35,39,2,100
1450,30,140,402,542,2,100
1451,30,6,78,84,2,100
1452,30,37,23,60,2,100
1453,30,40,17,57,2,100
1454,30,30,9,39,2,100
1455,30,45,65,110,2,100
1456,30,66,37,103,2,100
1457,30,37,35,72,2,100
1458,30,13,12,25,2,100
1459,30,13,16,29,2,100
1460,30,3,6,9,2,100
1461,30,33,19,52,2,100
1462,30,2,1,3,2,100
1463,30,55,78,133,2,100
1464,30,7,9,16,2,100
1465,30,5,11,16,2,100
1466,30,6,5,11,2,100
1467,30,40,34,74,2,100
1468,30,94,127,221,2,100
1469,30,64,85,149,2,100
1470,30,140,133,273,2,100
1471,30,40,53,93,2,100
1472,30,11,21,32,2,100
1473,30,55,79,134,2,100
1474,30,17,47,64,2,100
1475,30,14,13,27,2,100
1476,30,45,83,128,2,100
1477,30,64,55,119,2,100
1478,30,96,147,243,2,100
1479,30,50,43,93,2,100
1480,30,96,82,178,2,100
1481,30,15,24,39,2,100
1482,30,39,35,74,2,100
1483,30,34,54,88,2,100
1484,30,22,31,53,2,100
1485,30,12,36,48,2,100
1486,30,46,74,120,2,100
1487,30,114,93,207,2,100
1488,30,40,66,106,2,100
1489,30,105,59,164,2,100
1490,30,35,25,60,2,100
1491,30,7,11,18,2,100
1492,30,97,122,219,2,100
1493,30,38,51,89,2,100
1494,30,26,13,39,2,100
1495,30,67,66,133,2,100
1496,30,33,25,58,2,100
1497,30,60,82,142,2,100
1498,30,56,47,103,2,100
1499,30,61,59,120,2,100
1500,30,65,63,128,2,100
1501,30,29,30,59,2,100
1502,30,38,46,84,2,100
1503,30,7,15,22,2,100
1504,30,5,3,8,2,100
1505,30,78,99,177,2,100
1506,30,36,10,46,2,100
1507,30,15,30,45,2,100
1508,30,37,51,88,2,100
1509,30,9,4,13,2,100
1510,30,6,4,10,2,100
1511,30,71,105,176,2,100
1512,30,36,38,74,2,100
1513,30,10,25,35,2,100
1514,30,9,14,23,2,100
1515,30,93,113,206,2,100
1516,30,82,113,195,2,100
1517,30,94,96,190,2,100
1518,30,87,87,174,2,100
1519,30,37,57,94,2,100
1520,30,25,36,61,2,100
1521,30,9,42,51,2,100
1522,30,12,31,43,2,100
1523,30,47,49,96,2,100
1524,30,15,27,42,2,100
1525,30,108,120,228,2,100
1526,30,24,19,43,2,100
1527,30,36,37,73,2,100
1528,30,16,39,55,2,100
1529,30,50,124,174,2,100
1530,30,34,16,50,2,100
1531,30,33,48,81,2,100
1532,30,26,29,55,2,100
1533,30,54,23,77,2,100
1534,30,11,17,28,2,100
1535,30,19,33,52,2,100
1536,30,51,75,126,2,100
1537,30,7,6,13,2,100
1538,30,5,13,18,2,100
1539,30,41,13,54,2,100
1540,30,59,62,121,2,100
1541,30,91,80,171,2,100
1542,30,35,53,88,2,100
1543,30,41,44,85,2,100
1544,30,37,33,70,2,100
1545,30,40,16,56,2,100
1546,30,43,98,141,2,100
1547,30,50,44,94,2,100
1548,30,30,54,84,2,100
1549,30,12,15,27,2,100
1550,30,72,97,169,2,100
1551,30,56,44,100,2,100
1552,30,76,170,246,2,100
1553,30,18,25,43,2,100
1554,30,23,36,59,2,100
1555,30,93,125,218,2,100
1556,30,34,56,90,2,100
1557,30,47,80,127,2,100
1558,30,23,28,51,2,100
1559,30,16,34,50,2,100
1560,30,8,20,28,2,100
1561,30,51,105,156,2,100
1562,30,22,47,69,2,100
1563,40,106,121,227,2,100
1564,40,88,83,171,2,100
1565,40,48,57,105,2,100
1566,40,98,139,237,2,100
1567,40,129,120,249,2,100
1568,40,15,17,32,2,100
1569,40,29,102,131,2,100
1570,40,57,78,135,2,100
1571,40,52,70,122,2,100
1572,40,41,32,73,2,100
1573,40,39,30,69,2,100
1574,40,91,101,192,2,100
1575,40,118,173,291,2,100
1576,40,113,190,303,2,100
1577,40,169,298,467,2,100
1578,40,91,132,223,2,100
1579,40,263,550,813,2,100
1580,40,21,16,37,2,100
1581,40,32,29,61,2,100
1582,40,12,23,35,2,100
1583,40,84,130,214,2,100
1584,40,27,11,38,2,100
1585,40,19,30,49,2,100
1586,40,67,99,166,2,100
1587,40,154,141,295,2,100
1588,40,58,71,129,2,100
1589,40,156,140,296,2,100
1590,40,98,116,214,2,100
1591,40,117,130,247,2,100
1592,40,112,124,236,2,100
1593,40,66,44,110,2,100
1594,40,75,65,140,2,100
1595,40,39,54,93,2,100
1596,40,29,37,66,2,100
1597,40,60,76,136,2,100
1598,40,62,71,133,2,100
1599,40,202,262,464,2,100
1600,40,38,48,86,2,100
1601,40,72,133,205,2,100
1602,40,53,94,147,2,100
1603,40,66,96,162,2,100
1604,40,108,139,247,2,100
1605,40,90,69,159,2,100
1606,40,49,69,118,2,100
1607,40,91,127,218,2,100
1608,40,95,209,304,2,100
1609,40,105,114,219,2,100
1610,40,152,160,312,2,100
1611,40,138,137,275,2,100
1612,40,74,78,152,2,100
1613,40,96,124,220,2,100
1614,40,77,137,214,2,100
1615,40,136,257,393,2,100
1616,40,12,20,32,2,100
1617,40,46,40,86,2,100
1618,40,26,38,64,2,100
1619,40,36,18,54,2,100
1620,40,9,22,31,2,100
1621,40,40,75,115,2,100
1622,40,107,130,237,2,100
1623,40,144,167,311,2,100
1624,40,134,118,252,2,100
1625,40,17,13,30,2,100
1626,40,64,69,133,2,100
1627,40,25,26,51,2,100
1628,40,46,50,96,2,100
1629,40,105,151,256,2,100
1630,40,172,144,316,2,100
1631,40,37,34,71,2,100
1632,40,66,57,123,2,100
1633,40,78,73,151,2,100
1634,40,89,101,190,2,100
1635,40,10,20,30,2,100
1636,40,34,20,54,2,100
1637,40,94,176,270,2,100
1638,40,60,49,109,2,100
1639,40,16,13,29,2,100
1640,40,40,84,124,2,100
1641,40,29,26,55,2,100
1642,40,29,40,69,2,100
1643,40,15,35,50,2,100
1644,40,20,13,33,2,100
1645,40,71,54,125,2,100
1646,40,78,160,238,2,100
1647,40,193,222,415,2,100
1648,40,113,130,243,2,100
1649,40,15,21,36,2,100
1650,40,71,78,149,2,100
1651,40,77,111,188,2,100
1652,40,41,19,60,2,100
1653,40,54,64,118,2,100
1654,40,296,354,650,2,100
1655,40,63,121,184,2,100
1656,40,88,143,231,2,100
1657,40,53,66,119,2,100
1658,40,72,122,194,2,100
1659,40,371,325,696,2,100
1660,40,96,93,189,2,100
1661,40,25,22,47,2,100
1662,40,41,56,97,2,100
1663,40,55,82,137,2,100
1664,40,69,87,156,2,100
1665,40,54,64,118,2,100
1666,40,12,34,46,2,100
1667,40,69,127,196,2,100
1668,40,188,271,459,2,100
1669,40,51,84,135,2,100
1670,40,72,92,164,2,100
1671,40,64,66,130,2,100
1672,40,68,91,159,2,100
1673,40,54,62,116,2,100
1674,40,57,83,140,2,100
1675,40,103,146,249,2,100
1676,40,53,51,104,2,100
1677,40,26,30,56,2,100
1678,40,134,113,247,2,100
1679,40,35,76,111,2,100
1680,40,30,39,69,2,100
1681,40,72,66,138,2,100
1682,40,38,60,98,2,100
1683,40,121,145,266,2,100
1684,40,6,13,19,2,100
1685,40,60,37,97,2,100
1686,40,12,6,18,2,100
1687,40,48,94,142,2,100
1688,40,85,82,167,2,100
1689,40,59,64,123,2,100
1690,40,183,149,332,2,100
1691,40,91,133,224,2,100
1692,40,74,123,197,2,100
1693,40,53,78,131,2,100
1694,40,100,107,207,2,100
1695,40,37,38,75,2,100
1696,40,100,191,291,2,100
1697,40,55,66,121,2,100
1698,40,52,87,139,2,100
1699,40,54,70,124,2,100
1700,40,45,81,126,2,100
1701,40,148,174,322,2,100
1702,40,51,68,119,2,100
1703,40,67,74,141,2,100
1704,40,38,53,91,2,100
1705,40,14,61,75,2,100
1706,40,70,63,133,2,100
1707,40,34,34,68,2,100
1708,40,32,86,118,2,100
1709,40,35,32,67,2,100
1710,40,109,108,217,2,100
1711,40,46,86,132,2,100
1712,40,83,88,171,2,100
1713,40,50,48,98,2,100
1714,40,16,16,32,2,100
1715,40,87,90,177,2,100
1716,40,47,46,93,2,100
1717,40,78,84,162,2,100
1718,40,41,63,104,2,100
1719,40,26,12,38,2,100
1720,40,108,137,245,2,100
1721,40,18,23,41,2,100
1722,40,32,56,88,2,100
1723,40,22,30,52,2,100
1724,40,57,87,144,2,100
1725,40,28,52,80,2,100
1726,40,60,62,122,2,100
1727,40,60,82,142,2,100
1728,40,32,31,63,2,100
1729,40,109,145,254,2,100
1730,40,39,93,132,2,100
1731,40,3,7,10,2,100
1732,40,89,121,210,2,100
1733,40,70,90,160,2,100
1734,40,114,203,317,2,100
1735,40,96,173,269,2,100
1736,40,101,191,292,2,100
1737,40,51,51,102,2,100
1738,40,95,82,177,2,100
1739,40,34,71,105,2,100
1740,40,93,100,193,2,100
1741,40,98,168,266,2,100
1742,40,77,70,147,2,100
1743,40,48,73,121,2,100
1744,40,57,67,124,2,100
1745,40,32,48,80,2,100
1746,40,61,38,99,2,100
1747,40,36,63,99,2,100
1748,40,35,55,90,2,100
1749,40,110,145,255,2,100
1750,40,28,52,80,2,100
1751,40,146,114,260,2,100
1752,40,96,87,183,2,100
1753,40,106,130,236,2,100
1754,40,41,42,83,2,100
1755,40,49,54,103,2,100
1756,40,64,52,116,2,100
1757,40,73,144,217,2,100
1758,40,33,45,78,2,100
1759,40,109,163,272,2,100
1760,40,35,55,90,2,100
1761,40,55,51,106,2,100
1762,40,24,31,55,2,100
1763,40,37,33,70,2,100
1764,40,89,96,185,2,100
1765,40,102,93,195,2,100
1766,40,79,93,172,2,100
1767,40,90,103,193,2,100
1768,40,51,75,126,2,100
1769,40,62,64,126,2,100
1770,40,65,58,123,2,100
1771,40,82,106,188,2,100
1772,40,38,66,104,2,100
1773,40,52,97,149,2,100
1774,40,58,59,117,2,100
1775,40,58,76,134,2,100
1776,40,24,30,54,2,100
1777,40,30,48,78,2,100
1778,40,67,70,137,2,100
1779,40,51,77,128,2,100
1780,40,54,43,97,2,100
1781,40,62,59,121,2,100
1782,40,68,50,118,2,100
1783,40,53,137,190,2,100
1784,40,80,97,177,2,100
1785,40,115,168,283,2,100
1786,40,32,36,68,2,100
1787,40,14,33,47,2,100
1788,40,69,65,134,2,100
1789,40,44,76,120,2,100
1790,40,44,72,116,2,100
1791,40,48,46,94,2,100
1792,40,35,47,82,2,100
1793,40,76,67,143,2,100
1794,40,67,92,159,2,100
1795,40,55,114,169,2,100
1796,40,73,127,200,2,100
1797,40,48,81,129,2,100
1798,40,75,69,144,2,100
1799,40,127,131,258,2,100
1800,40,54,94,148,2,100
1801,40,97,72,169,2,100
1802,40,28,35,63,2,100
1803,40,44,50,94,2,100
1804,40,29,40,69,2,100
1805,40,89,107,196,2,100
1806,40,160,169,329,2,100
1807,40,84,120,204,2,100
1808,40,74,90,164,2,100
1809,40,61,136,197,2,100
1810,40,86,88,174,2,100
1811,40,107,93,200,2,100
1812,40,3,21,24,2,100
1813,40,44,64,108,2,100
1814,40,20,40,60,2,100
1815,40,63,68,131,2,100
1816,40,78,115,193,2,100
1817,40,59,30,89,2,100
1818,40,49,81,130,2,100
1819,40,52,62,114,2,100
1820,40,31,26,57,2,100
1821,40,49,83,132,2,100
1822,40,30,34,64,2,100
1823,40,47,106,153,2,100
1824,40,105,79,184,2,100
1825,40,84,127,211,2,100
1826,40,63,98,161,2,100
1827,40,45,83,128,2,100
1828,40,16,8,24,2,100
1829,40,79,57,136,2,100
1830,40,68,50,118,2,100
1831,40,127,113,240,2,100
1832,40,27,58,85,2,100
1833,40,79,102,181,2,100
1834,40,80,64,144,2,100
1835,40,67,91,158,2,100
1836,40,120,128,248,2,100
1837,40,86,123,209,2,100
1838,40,145,233,378,2,100
1839,40,92,150,242,2,100
1840,40,94,77,171,2,100
1841,40,39,21,60,2,100
1842,40,9,3,12,2,100
1843,40,41,89,130,2,100
1844,40,15,54,69,2,100
1845,40,101,132,233,2,100
1846,40,40,63,103,2,100
1847,40,73,77,150,2,100
1848,40,35,34,69,2,100
1849,40,150,130,280,2,100
1850,40,23,40,63,2,100
1851,40,85,128,213,2,100
1852,40,61,110,171,2,100
1853,40,162,317,479,2,100
1854,40,106,81,187,2,100
1855,40,61,117,178,2,100
1856,40,85,80,165,2,100
1857,40,19,50,69,2,100
1858,40,20,21,41,2,100
1859,40,76,61,137,2,100
1860,40,202,67,269,2,100
1861,40,59,53,112,2,100
1862,40,80,52,132,2,100
1863,40,42,51,93,2,100
1864,40,98,277,375,2,100
1865,40,74,38,112,2,100
1866,40,88,100,188,2,100
1867,40,48,65,113,2,100
1868,40,61,73,134,2,100
1869,40,20,20,40,2,100
1870,40,364,132,496,2,100
1871,40,67,93,160,2,100
1872,40,52,62,114,2,100
1873,40,146,193,339,2,100
1874,40,61,121,182,2,100
1875,40,31,23,54,2,100
1876,40,61,95,156,2,100
1877,40,64,60,124,2,100
1878,40,53,71,124,2,100
1879,40,72,113,185,2,100
1880,40,4,68,72,2,100
1881,40,68,63,131,2,100
1882,40,14,16,30,2,100
1883,40,20,37,57,2,100
1884,40,19,29,48,2,100
1885,40,30,51,81,2,100
1886,40,29,80,109,2,100
1887,40,8,17,25,2,100
1888,40,58,70,128,2,100
1889,40,68,103,171,2,100
1890,40,79,140,219,2,100
1891,40,34,90,124,2,100
1892,40,11,8,19,2,100
1893,40,54,67,121,2,100
1894,40,55,82,137,2,100
1895,40,73,80,153,2,100
1896,40,49,68,117,2,100
1897,40,16,33,49,2,100
1898,40,88,148,236,2,100
1899,40,40,51,91,2,100
1900,40,82,119,201,2,100
1901,40,48,89,137,2,100
1902,40,84,108,192,2,100
1903,40,92,124,216,2,100
1904,40,9,19,28,2,100
1905,40,44,105,149,2,100
1906,40,6,16,22,2,100
1907,40,78,109,187,2,100
1908,40,82,55,137,2,100
1909,40,39,94,133,2,100
1910,40,57,75,132,2,100
1911,40,21,12,33,2,100
1912,40,13,15,28,2,100
1913,40,41,12,53,2,100
1914,40,102,86,188,2,100
1915,40,12,28,40,2,100
1916,40,34,47,81,2,100
1917,40,27,33,60,2,100
1918,40,92,137,229,2,100
1919,40,64,109,173,2,100
1920,40,14,51,65,2,100
1921,40,71,85,156,2,100
1922,40,26,17,43,2,100
1923,40,0,0,0,2,100
1924,40,26,18,44,2,100
1925,40,78,122,200,2,100
1926,40,13,56,69,2,100
1927,40,10,17,27,2,100
1928,40,90,81,171,2,100
1929,40,66,83,149,2,100
1930,40,71,87,158,2,100
1931,40,32,58,90,2,100
1932,40,66,70,136,2,100
1933,40,63,68,131,2,100
1934,40,9,88,97,2,100
1935,40,56,48,104,2,100
1936,40,49,61,110,2,100
1937,40,68,99,167,2,100
1938,40,21,9,30,2,100
1939,40,45,43,88,2,100
1940,40,57,60,117,2,100
1941,40,43,52,95,2,100
1942,40,22,23,45,2,100
1943,40,35,59,94,2,100
1944,40,5,6,11,2,100
1945,40,24,30,54,2,100
1946,50,36,136,172,2,100
1947,50,56,102,158,2,100
1948,50,86,90,176,2,100
1949,50,120,147,267,2,100
1950,50,138,278,416,2,100
1951,50,86,163,249,2,100
1952,50,35,59,94,2,100
1953,50,38,73,111,2,100
1954,50,67,73,140,2,100
1955,50,40,56,96,2,100
1956,50,164,267,431,2,100
1957,50,127,127,254,2,100
1958,50,56,41,97,2,100
1959,50,139,56,195,2,100
1960,50,46,53,99,2,100
1961,50,138,135,273,2,100
1962,50,84,58,142,2,100
1963,50,69,94,163,2,100
1964,50,112,110,222,2,100
1965,50,127,177,304,2,100
1966,50,79,134,213,2,100
1967,50,85,127,212,2,100
1968,50,57,61,118,2,100
1969,50,76,146,222,2,100
1970,50,96,112,208,2,100
1971,50,59,102,161,2,100
1972,50,64,106,170,2,100
1973,50,26,51,77,2,100
1974,50,49,115,164,2,100
1975,50,20,25,45,2,100
1976,50,186,268,454,2,100
1977,50,33,232,265,2,100
1978,50,32,47,79,2,100
1979,50,68,68,136,2,100
1980,50,20,66,86,2,100
1981,50,105,149,254,2,100
1982,50,85,204,289,2,100
1983,50,64,92,156,2,100
1984,50,42,66,108,2,100
1985,50,91,142,233,2,100
1986,50,87,136,223,2,100
1987,50,61,103,164,2,100
1988,50,107,98,205,2,100
1989,50,76,75,151,2,100
1990,50,39,73,112,2,100
1991,50,46,99,145,2,100
1992,50,19,41,60,2,100
1993,50,17,34,51,2,100
1994,50,34,109,143,2,100
1995,50,36,24,60,2,100
1996,50,158,194,352,2,100
1997,50,175,178,353,2,100
1998,50,62,69,131,2,100
1999,50,28,53,81,2,100
2000,50,6,20,26,2,100
2001,50,59,104,163,2,100
2002,50,109,82,191,2,100
2003,50,63,90,153,2,100
2004,50,90,119,209,2,100
2005,50,110,104,214,2,100
2006,50,75,69,144,2,100
2007,50,69,74,143,2,100
2008,50,72,85,157,2,100
2009,50,108,96,204,2,100
2010,50,101,118,219,2,100
2011,50,40,63,103,2,100
2012,50,63,44,107,2,100
2013,50,98,116,214,2,100
2014,50,116,150,266,2,100
2015,50,42,59,101,2,100
2016,50,21,47,68,2,100
2017,50,53,80,133,2,100
2018,50,165,194,359,2,100
2019,50,105,156,261,2,100
2020,50,54,107,161,2,100
2021,50,52,54,106,2,100
2022,50,9,27,36,2,100
2023,50,24,30,54,2,100
2024,50,70,98,168,2,100
2025,50,119,246,365,2,100
2026,50,40,40,80,2,100
2027,50,143,168,311,2,100
2028,50,44,44,88,2,100
2029,50,149,199,348,2,100
2030,50,82,90,172,2,100
2031,50,39,55,94,2,100
2032,50,72,89,161,2,100
2033,50,82,78,160,2,100
2034,50,65,98,163,2,100
2035,50,29,43,72,2,100
2036,50,1,5,6,2,100
2037,50,9,2,11,2,100
2038,50,69,78,147,2,100
2039,50,21,91,112,2,100
2040,50,84,131,215,2,100
2041,50,22,39,61,2,100
2042,50,50,108,158,2,100
2043,50,46,60,106,2,100
2044,50,96,90,186,2,100
2045,50,111,170,281,2,100
2046,50,24,47,71,2,100
2047,50,10,52,62,2,100
2048,50,23,37,60,2,100
2049,50,16,41,57,2,100
2050,50,16,29,45,2,100
2051,50,76,137,213,2,100
2052,50,92,230,322,2,100
2053,50,107,150,257,2,100
2054,50,47,69,116,2,100
2055,50,21,19,40,2,100
2056,50,227,267,494,2,100
2057,50,68,89,157,2,100
2058,50,74,168,242,2,100
2059,50,68,46,114,2,100
2060,50,39,23,62,2,100
2061,50,100,141,241,2,100
2062,50,4,8,12,2,100
2063,50,97,123,220,2,100
2064,50,1,6,7,2,100
2065,50,51,104,155,2,100
2066,50,329,592,921,2,100
2067,50,170,182,352,2,100
2068,50,20,41,61,2,100
2069,50,145,175,320,2,100
2070,50,104,94,198,2,100
2071,50,73,90,163,2,100
2072,50,52,81,133,2,100
2073,50,52,124,176,2,100
2074,50,30,55,85,2,100
2075,50,79,117,196,2,100
2076,50,40,73,113,2,100
2077,50,1,4,5,2,100
2078,50,4,13,17,2,100
2079,50,6,13,19,2,100
2080,50,17,19,36,2,100
2081,50,19,43,62,2,100
2082,50,20,55,75,2,100
2083,50,46,40,86,2,100
2084,50,148,203,351,2,100
2085,50,107,147,254,2,100
2086,50,83,161,244,2,100
2087,50,52,90,142,2,100
2088,50,141,181,322,2,100
2089,50,16,34,50,2,100
2090,50,81,103,184,2,100
2091,50,63,103,166,2,100
2092,50,18,39,57,2,100
2093,50,18,41,59,2,100
2094,50,44,100,144,2,100
2095,50,45,109,154,2,100
2096,50,13,17,30,2,100
2097,50,22,37,59,2,100
2098,50,66,87,153,2,100
2099,50,38,83,121,2,100
2100,50,106,131,237,2,100
2101,50,31,66,97,2,100
2102,50,122,227,349,2,100
2103,50,15,15,30,2,100
2104,50,15,26,41,2,100
2105,50,9,28,37,2,100
2106,50,36,38,74,2,100
2107,50,22,54,76,2,100
2108,50,96,104,200,2,100
2109,50,28,73,101,2,100
2110,50,83,117,200,2,100
2111,50,25,32,57,2,100
2112,50,89,111,200,2,100
2113,50,95,125,220,2,100
2114,50,14,27,41,2,100
2115,50,91,169,260,2,100
2116,50,37,78,115,2,100
2117,50,42,68,110,2,100
2118,50,41,76,117,2,100
2119,50,25,47,72,2,100
2120,50,7,9,16,2,100
2121,50,9,30,39,2,100
2122,50,116,239,355,2,100
2123,50,65,82,147,2,100
2124,50,2,37,39,2,100
2125,50,38,46,84,2,100
2126,50,58,53,111,2,100
2127,50,23,8,31,2,100
2128,50,40,31,71,2,100
2129,50,82,88,170,2,100
2130,50,75,127,202,2,100
2131,50,37,68,105,2,100
2132,50,117,185,302,2,100
2133,50,54,89,143,2,100
2134,50,63,84,147,2,100
2135,50,7,24,31,2,100
2136,50,36,70,106,2,100
2137,50,3,1,4,2,100
2138,50,135,266,401,2,100
2139,50,162,207,369,2,100
2140,50,104,109,213,2,100
2141,50,59,65,124,2,100
2142,50,100,120,220,2,100
2143,50,53,32,85,2,100
2144,50,20,7,27,2,100
2145,50,44,121,165,2,100
2146,50,29,89,118,2,100
2147,50,54,41,95,2,100
2148,50,74,106,180,2,100
2149,50,48,48,96,2,100
2150,50,48,45,93,2,100
2151,50,62,103,165,2,100
2152,50,60,65,125,2,100
2153,50,54,91,145,2,100
2154,50,41,75,116,2,100
2155,50,13,18,31,2,100
2156,50,70,64,134,2,100
2157,50,21,41,62,2,100
2158,50,8,11,19,2,100
2159,50,58,90,148,2,100
2160,50,85,189,274,2,100
2161,50,93,116,209,2,100
2162,50,102,113,215,2,100
2163,50,159,77,236,2,100
2164,50,135,114,249,2,100
2165,50,78,96,174,2,100
2166,50,118,124,242,2,100
2167,50,70,113,183,2,100
2168,50,115,97,212,2,100
2169,50,146,227,373,2,100
2170,50,19,26,45,2,100
2171,50,73,53,126,2,100
2172,50,48,40,88,2,100
2173,50,4,23,27,2,100
2174,50,64,103,167,2,100
2175,50,142,165,307,2,100
2176,50,24,37,61,2,100
2177,50,45,71,116,2,100
2178,50,73,97,170,2,100
2179,50,11,11,22,2,100
2180,50,84,124,208,2,100
2181,50,71,203,274,2,100
2182,50,73,75,148,2,100
2183,50,84,78,162,2,100
2184,50,9,19,28,2,100
2185,50,120,148,268,2,100
2186,50,87,98,185,2,100
2187,50,205,290,495,2,100
2188,50,214,275,489,2,100
2189,50,146,194,340,2,100
2190,50,66,93,159,2,100
2191,50,25,41,66,2,100
2192,50,72,98,170,2,100
2193,50,83,127,210,2,100
2194,50,150,221,371,2,100
2195,50,64,102,166,2,100
2196,50,66,91,157,2,100
2197,50,115,206,321,2,100
2198,50,120,136,256,2,100
2199,50,64,105,169,2,100
2200,50,92,153,245,2,100
2201,50,26,29,55,2,100
2202,50,57,56,113,2,100
2203,50,91,81,172,2,100
2204,50,38,57,95,2,100
2205,50,141,216,357,2,100
2206,50,98,113,211,2,100
2207,50,68,99,167,2,100
2208,50,87,151,238,2,100
2209,50,36,54,90,2,100
2210,50,95,108,203,2,100
2211,50,26,17,43,2,100
2212,50,230,291,521,2,100
2213,50,105,175,280,2,100
2214,50,81,129,210,2,100
2215,50,68,103,171,2,100
2216,50,48,34,82,2,100
2217,50,57,102,159,2,100
2218,50,88,131,219,2,100
2219,50,50,88,138,2,100
2220,50,50,41,91,2,100
2221,50,63,136,199,2,100
2222,50,70,55,125,2,100
2223,50,48,87,135,2,100
2224,50,64,99,163,2,100
2225,50,52,48,100,2,100
2226,50,47,56,103,2,100
2227,50,63,70,133,2,100
2228,50,93,176,269,2,100
2229,50,77,28,105,2,100
2230,50,51,72,123,2,100
2231,50,146,201,347,2,100
2232,50,41,26,67,2,100
2233,50,124,100,224,2,100
2234,50,66,76,142,2,100
2235,50,101,200,301,2,100
2236,50,114,140,254,2,100
2237,50,59,64,123,2,100
2238,50,156,265,421,2,100
2239,50,94,214,308,2,100
2240,50,80,104,184,2,100
2241,50,80,104,184,2,100
2242,50,91,204,295,2,100
2243,50,62,111,173,2,100
2244,50,124,143,267,2,100
2245,50,8,16,24,2,100
2246,50,143,107,250,2,100
2247,50,39,87,126,2,100
2248,50,99,189,288,2,100
2249,50,31,51,82,2,100
2250,50,13,24,37,2,100
2251,50,65,156,221,2,100
2252,50,178,194,372,2,100
2253,50,72,100,172,2,100
2254,50,60,70,130,2,100
2255,50,30,42,72,2,100
2256,50,109,110,219,2,100
2257,50,83,210,293,2,100
2258,50,129,190,319,2,100
2259,50,8,15,23,2,100
2260,50,108,87,195,2,100
2261,50,48,117,165,2,100
2262,50,52,78,130,2,100
2263,50,195,195,390,2,100
2264,50,40,33,73,2,100
2265,50,97,125,222,2,100
2266,50,79,81,160,2,100
2267,50,47,121,168,2,100
2268,50,35,58,93,2,100
2269,50,39,85,124,2,100
2270,50,104,117,221,2,100
2271,50,43,71,114,2,100
2272,50,83,118,201,2,100
2273,50,89,31,120,2,100
2274,50,35,39,74,2,100
2275,50,145,235,380,2,100
2276,50,156,274,430,2,100
2277,50,23,50,73,2,100
2278,50,47,82,129,2,100
2279,50,29,60,89,2,100
2280,50,89,82,171,2,100
2281,50,130,248,378,2,100
2282,50,127,276,403,2,100
2283,50,101,141,242,2,100
2284,50,35,88,123,2,100
2285,50,115,195,310,2,100
2286,50,110,78,188,2,100
2287,50,17,36,53,2,100
2288,50,29,48,77,2,100
2289,50,121,110,231,2,100
2290,50,10,20,30,2,100
2291,50,117,198,315,2,100
2292,50,168,231,399,2,100
2293,50,96,150,246,2,100
2294,50,132,224,356,2,100
2295,50,185,507,692,2,100
2296,50,56,59,115,2,100
2297,50,93,118,211,2,100
2298,50,116,193,309,2,100
2299,50,138,207,345,2,100
2300,50,66,43,109,2,100
2301,60,60,63,123,2,100
2302,60,82,70,152,2,100
2303,60,102,184,286,2,100
2304,60,77,64,141,2,100
2305,60,69,162,231,2,100
2306,60,62,148,210,2,100
2307,60,51,63,114,2,100
2308,60,108,202,310,2,100
2309,60,181,198,379,2,100
2310,60,93,210,303,2,100
2311,60,67,121,188,2,100
2312,60,50,101,151,2,100
2313,60,75,100,175,2,100
2314,60,53,44,97,2,100
2315,60,56,91,147,2,100
2316,60,146,142,288,2,100
2317,60,141,144,285,2,100
2318,60,16,37,53,2,100
2319,60,206,190,396,2,100
2320,60,90,83,173,2,100
2321,60,38,57,95,2,100
2322,60,10,22,32,2,100
2323,60,70,151,221,2,100
2324,60,102,81,183,2,100
2325,60,80,229,309,2,100
2326,60,105,157,262,2,100
2327,60,119,71,190,2,100
2328,60,68,95,163,2,100
2329,60,107,172,279,2,100
2330,60,68,122,190,2,100
2331,60,73,52,125,2,100
2332,60,57,83,140,2,100
2333,60,201,188,389,2,100
2334,60,8,21,29,2,100
2335,60,12,12,24,2,100
2336,60,8,31,39,2,100
2337,60,39,44,83,2,100
2338,60,64,40,104,2,100
2339,60,37,67,104,2,100
2340,60,32,48,80,2,100
2341,60,111,171,282,2,100
2342,60,73,86,159,2,100
2343,60,101,139,240,2,100
2344,60,51,76,127,2,100
2345,60,100,110,210,2,100
2346,60,84,78,162,2,100
2347,60,47,49,96,2,100
2348,60,88,112,200,2,100
2349,60,10,49,59,2,100
2350,60,57,91,148,2,100
2351,60,71,124,195,2,100
2352,60,65,102,167,2,100
2353,60,25,58,83,2,100
2354,60,59,112,171,2,100
2355,60,21,38,59,2,100
2356,60,6,25,31,2,100
2357,60,4,12,16,2,100
2358,60,54,117,171,2,100
2359,60,97,227,324,2,100
2360,60,144,131,275,2,100
2361,60,68,80,148,2,100
2362,60,138,231,369,2,100
2363,60,91,174,265,2,100
2364,60,125,234,359,2,100
2365,60,24,23,47,2,100
2366,60,64,102,166,2,100
2367,60,30,72,102,2,100
2368,60,36,29,65,2,100
2369,60,164,165,329,2,100
2370,60,49,171,220,2,100
2371,60,19,15,34,2,100
2372,60,148,186,334,2,100
2373,60,92,112,204,2,100
2374,60,125,94,219,2,100
2375,60,116,137,253,2,100
2376,60,62,114,176,2,100
2377,60,137,137,274,2,100
2378,60,11,30,41,2,100
2379,60,155,291,446,2,100
2380,60,35,30,65,2,100
2381,60,58,106,164,2,100
2382,60,133,161,294,2,100
2383,60,85,144,229,2,100
2384,60,39,96,135,2,100
2385,60,25,75,100,2,100
2386,60,32,33,65,2,100
2387,60,5,16,21,2,100
2388,60,88,68,156,2,100
2389,60,26,50,76,2,100
2390,60,158,88,246,2,100
2391,60,132,159,291,2,100
2392,60,158,305,463,2,100
2393,60,36,62,98,2,100
2394,60,130,159,289,2,100
2395,60,68,95,163,2,100
2396,60,26,79,105,2,100
2397,60,45,85,130,2,100
2398,60,30,76,106,2,100
2399,60,18,11,29,2,100
2400,60,107,85,192,2,100
2401,60,59,91,150,2,100
2402,60,95,161,256,2,100
2403,60,45,88,133,2,100
2404,60,65,40,105,2,100
2405,60,188,308,496,2,100
2406,60,139,167,306,2,100
2407,60,124,185,309,2,100
2408,60,133,181,314,2,100
2409,60,80,103,183,2,100
2410,60,93,122,215,2,100
2411,60,72,117,189,2,100
2412,60,64,101,165,2,100
2413,60,48,37,85,2,100
2414,60,13,29,42,2,100
2415,60,74,87,161,2,100
2416,60,99,194,293,2,100
2417,60,125,171,296,2,100
2418,60,83,114,197,2,100
2419,60,54,112,166,2,100
2420,60,93,112,205,2,100
2421,60,93,157,250,2,100
2422,60,88,109,197,2,100
2423,60,79,108,187,2,100
2424,60,46,95,141,2,100
2425,60,37,53,90,2,100
2426,60,38,70,108,2,100
2427,60,39,63,102,2,100
2428,60,18,42,60,2,100
2429,60,112,136,248,2,100
2430,60,53,64,117,2,100
2431,60,96,125,221,2,100
2432,60,89,192,281,2,100
2433,60,29,40,69,2,100
2434,60,33,49,82,2,100
2435,60,62,65,127,2,100
2436,60,35,102,137,2,100
2437,60,33,19,52,2,100
2438,60,25,55,80,2,100
2439,60,21,40,61,2,100
2440,60,138,258,396,2,100
2441,60,53,66,119,2,100
2442,60,98,114,212,2,100
2443,60,118,175,293,2,100
2444,60,243,361,604,2,100
2445,60,64,106,170,2,100
2446,60,103,177,280,2,100
2447,60,200,356,556,2,100
2448,60,153,350,503,2,100
2449,60,10,79,89,2,100
2450,60,33,51,84,2,100
2451,60,43,71,114,2,100
2452,60,60,142,202,2,100
2453,60,134,352,486,2,100
2454,60,11,19,30,2,100
2455,60,65,80,145,2,100
2456,60,139,221,360,2,100
2457,60,102,175,277,2,100
2458,60,75,127,202,2,100
2459,60,9,21,30,2,100
2460,60,113,165,278,2,100
2461,60,32,68,100,2,100
2462,60,62,84,146,2,100
2463,60,38,22,60,2,100
2464,60,58,94,152,2,100
2465,60,81,173,254,2,100
2466,60,88,173,261,2,100
2467,60,37,112,149,2,100
2468,60,101,157,258,2,100
2469,60,66,84,150,2,100
2470,60,66,163,229,2,100
2471,60,19,17,36,2,100
2472,60,44,84,128,2,100
2473,60,38,84,122,2,100
2474,60,9,35,44,2,100
2475,60,88,121,209,2,100
2476,60,18,37,55,2,100
2477,60,110,138,248,2,100
2478,60,161,332,493,2,100
2479,60,64,78,142,2,100
2480,60,16,67,83,2,100
2481,60,64,85,149,2,100
2482,60,88,128,216,2,100
2483,60,141,250,391,2,100
2484,60,130,147,277,2,100
2485,60,37,61,98,2,100
2486,60,77,125,202,2,100
2487,60,63,139,202,2,100
2488,60,49,127,176,2,100
2489,60,158,217,375,2,100
2490,60,62,75,137,2,100
2491,60,17,7,24,2,100
2492,60,137,171,308,2,100
2493,60,28,72,100,2,100
2494,60,39,67,106,2,100
2495,60,58,101,159,2,100
2496,60,60,123,183,2,100
2497,60,53,110,163,2,100
2498,60,145,166,311,2,100
2499,60,35,66,101,2,100
2500,60,41,75,116,2,100
2501,60,42,52,94,2,100
2502,60,109,115,224,2,100
2503,60,88,146,234,2,100
2504,60,21,38,59,2,100
2505,60,60,81,141,2,100
2506,60,15,57,72,2,100
2507,60,17,41,58,2,100
2508,60,139,223,362,2,100
2509,60,59,43,102,2,100
2510,60,98,154,252,2,100
2511,60,9,7,16,2,100
2512,60,20,48,68,2,100
2513,60,64,68,132,2,100
2514,60,48,88,136,2,100
2515,60,57,80,137,2,100
2516,60,58,105,163,2,100
2517,60,50,81,131,2,100
2518,60,84,103,187,2,100
2519,60,16,11,27,2,100
2520,60,58,84,142,2,100
2521,60,48,103,151,2,100
2522,60,123,151,274,2,100
2523,60,57,89,146,2,100
2524,60,67,142,209,2,100
2525,60,132,138,270,2,100
2526,60,79,116,195,2,100
2527,60,114,144,258,2,100
2528,60,71,91,162,2,100
2529,60,57,125,182,2,100
2530,60,38,93,131,2,100
2531,60,176,126,302,2,100
2532,60,33,120,153,2,100
2533,60,56,97,153,2,100
2534,60,83,127,210,2,100
2535,60,65,28,93,2,100
2536,60,53,105,158,2,100
2537,60,76,103,179,2,100
2538,60,29,63,92,2,100
2539,60,62,102,164,2,100
2540,60,157,216,373,2,100
2541,60,188,188,376,2,100
2542,60,17,42,59,2,100
2543,60,90,152,242,2,100
2544,60,120,179,299,2,100
2545,60,72,129,201,2,100
2546,60,70,111,181,2,100
2547,60,29,65,94,2,100
2548,60,42,49,91,2,100
2549,60,89,81,170,2,100
2550,60,30,37,67,2,100
2551,60,91,82,173,2,100
2552,60,54,91,145,2,100
2553,60,51,154,205,2,100
2554,60,81,147,228,2,100
2555,60,39,86,125,2,100
2556,60,75,139,214,2,100
2557,60,157,245,402,2,100
2558,60,60,110,170,2,100
2559,60,122,242,364,2,100
2560,60,122,216,338,2,100
2561,60,14,38,52,2,100
2562,60,15,40,55,2,100
2563,60,113,123,236,2,100
2564,60,119,158,277,2,100
2565,60,42,118,160,2,100
2566,60,70,79,149,2,100
2567,60,104,151,255,2,100
2568,60,47,119,166,2,100
2569,60,128,221,349,2,100
2570,60,62,98,160,2,100
2571,60,148,150,298,2,100
2572,60,147,323,470,2,100
2573,60,116,190,306,2,100
2574,60,76,111,187,2,100
2575,60,19,29,48,2,100
2576,60,72,57,129,2,100
2577,60,87,111,198,2,100
2578,60,69,68,137,2,100
2579,60,18,47,65,2,100
2580,60,159,159,318,2,100
2581,60,49,76,125,2,100
2582,60,248,349,597,2,100
2583,60,0,9,9,2,100
2584,60,74,74,148,2,100
2585,60,45,74,119,2,100
2586,60,81,147,228,2,100
2587,60,122,187,309,2,100
2588,60,56,75,131,2,100
2589,60,57,54,111,2,100
2590,60,91,136,227,2,100
2591,60,68,120,188,2,100
2592,60,75,115,190,2,100
2593,60,155,197,352,2,100
2594,60,72,78,150,2,100
2595,60,69,70,139,2,100
2596,60,39,66,105,2,100
2597,60,83,48,131,2,100
2598,60,63,84,147,2,100
2599,60,22,18,40,2,100
2600,60,77,149,226,2,100
2601,60,68,74,142,2,100
2602,60,56,74,130,2,100
2603,60,89,77,166,2,100
2604,60,92,96,188,2,100
2605,60,65,96,161,2,100
2606,60,95,76,171,2,100
2607,60,86,130,216,2,100
2608,60,131,274,405,2,100
2609,60,78,104,182,2,100
2610,60,54,66,120,2,100
2611,60,142,114,256,2,100
2612,60,56,124,180,2,100
2613,60,94,169,263,2,100
2614,60,37,70,107,2,100
2615,60,8,21,29,2,100
2616,60,43,80,123,2,100
2617,60,73,169,242,2,100
2618,60,26,36,62,2,100
2619,60,75,160,235,2,100
2620,60,56,40,96,2,100
2621,60,86,186,272,2,100
2622,60,27,26,53,2,100
2623,60,73,167,240,2,100
2624,60,25,55,80,2,100
2625,60,12,25,37,2,100
2626,60,123,177,300,2,100
2627,60,113,168,281,2,100
2628,60,85,126,211,2,100
2629,60,57,100,157,2,100
2630,60,61,126,187,2,100
2631,60,16,34,50,2,100
2632,60,69,110,179,2,100
2633,60,74,117,191,2,100
2634,60,70,49,119,2,100
2635,60,48,84,132,2,100
2636,60,30,49,79,2,100
2637,60,148,234,382,2,100
2638,60,134,284,418,2,100
2639,60,38,41,79,2,100
2640,60,40,87,127,2,100
2641,60,151,244,395,2,100
2642,60,22,48,70,2,100
2643,60,111,169,280,2,100
2644,60,76,244,320,2,100
2645,60,82,80,162,2,100
2646,60,65,112,177,2,100
2647,60,142,282,424,2,100
2648,60,149,214,363,2,100
2649,60,131,136,267,2,100
2650,60,135,202,337,2,100
2651,60,85,81,166,2,100
2652,60,65,57,122,2,100
2653,60,20,50,70,2,100
2654,60,85,243,328,2,100
2655,60,97,219,316,2,100
2656,60,44,64,108,2,100
2657,60,34,45,79,2,100
2658,60,53,54,107,2,100
2659,60,14,17,31,2,100
2660,60,28,61,89,2,100
2661,60,16,36,52,2,100
2662,60,63,70,133,2,100
2663,60,55,68,123,2,100
2664,60,11,48,59,2,100
2665,60,111,144,255,2,100
2666,60,134,211,345,2,100
2667,60,57,77,134,2,100
2668,60,51,49,100,2,100
2669,60,179,255,434,2,100
2670,60,122,198,320,2,100
2671,60,31,29,60,2,100
2672,60,55,80,135,2,100
2673,60,3,4,7,2,100
2674,60,10,18,28,2,100
2675,60,46,81,127,2,100
2676,60,27,41,68,2,100
2677,60,199,356,555,2,100
2678,60,70,153,223,2,100
2679,60,100,166,266,2,100
2680,60,140,201,341,2,100
2681,60,37,50,87,2,100
2682,60,185,270,455,2,100
2683,60,23,28,51,2,100
2684,60,24,88,112,2,100
2685,60,162,203,365,2,100
2686,60,98,210,308,2,100
2687,60,139,225,364,2,100
2688,60,51,74,125,2,100
2689,60,87,190,277,2,100
2690,60,45,82,127,2,100
2691,60,54,104,158,2,100
2692,60,72,141,213,2,100
2693,60,73,116,189,2,100
2694,60,31,38,69,2,100
2695,60,39,73,112,2,100
2696,60,60,57,117,2,100
2697,60,62,84,146,2,100
2698,60,35,60,95,2,100
2699,60,84,127,211,2,100
2700,60,66,60,126,2,100
2701,60,154,114,268,2,100
2702,60,64,120,184,2,100
2703,60,127,107,234,2,100
2704,60,85,66,151,2,100
2705,60,25,66,91,2,100
2706,75,42,77,119,2,100
2707,75,33,84,117,2,100
2708,75,23,69,92,2,100
2709,75,44,78,122,2,100
2710,75,34,66,100,2,100
2711,75,55,74,129,2,100
2712,75,85,190,275,2,100
2713,75,75,64,139,2,100
2714,75,49,23,72,2,100
2715,75,173,267,440,2,100
2716,75,77,160,237,2,100
2717,75,346,360,706,2,100
2718,75,218,241,459,2,100
2719,75,182,281,463,2,100
2720,75,26,47,73,2,100
2721,75,35,14,49,2,100
2722,75,81,168,249,2,100
2723,75,4,11,15,2,100
2724,75,88,253,341,2,100
2725,75,114,241,355,2,100
2726,75,61,108,169,2,100
2727,75,105,268,373,2,100
2728,75,121,230,351,2,100
2729,75,127,205,332,2,100
2730,75,174,379,553,2,100
2731,75,36,99,135,2,100
2732,75,47,53,100,2,100
2733,75,6,29,35,2,100
2734,75,9,43,52,2,100
2735,75,135,215,350,2,100
2736,75,153,213,366,2,100
2737,75,42,96,138,2,100
2738,75,223,296,519,2,100
2739,75,62,134,196,2,100
2740,75,84,135,219,2,100
2741,75,74,126,200,2,100
2742,75,46,73,119,2,100
2743,75,132,167,299,2,100
2744,75,210,266,476,2,100
2745,75,120,115,235,2,100
2746,75,168,257,425,2,100
2747,75,111,164,275,2,100
2748,75,68,127,195,2,100
2749,75,81,137,218,2,100
2750,75,78,186,264,2,100
2751,75,30,35,65,2,100
2752,75,38,40,78,2,100
2753,75,26,37,63,2,100
2754,75,102,209,311,2,100
2755,75,18,59,77,2,100
2756,75,60,113,173,2,100
2757,75,219,272,491,2,100
2758,75,83,161,244,2,100
2759,75,226,175,401,2,100
2760,75,64,135,199,2,100
2761,75,184,234,418,2,100
2762,75,147,210,357,2,100
2763,75,108,244,352,2,100
2764,75,24,81,105,2,100
2765,75,134,156,290,2,100
2766,75,50,94,144,2,100
2767,75,18,98,116,2,100
2768,75,45,87,132,2,100
2769,75,38,81,119,2,100
2770,75,325,470,795,2,100
2771,75,30,84,114,2,100
2772,75,49,72,121,2,100
2773,75,56,110,166,2,100
2774,75,129,222,351,2,100
2775,75,57,107,164,2,100
2776,75,13,25,38,2,100
2777,75,64,90,154,2,100
2778,75,31,47,78,2,100
2779,75,64,95,159,2,100
2780,75,38,52,90,2,100
2781,75,59,92,151,2,100
2782,75,3,11,14,2,100
2783,75,73,162,235,2,100
2784,75,31,78,109,2,100
2785,75,69,109,178,2,100
2786,75,92,194,286,2,100
2787,75,77,264,341,2,100
2788,75,145,286,431,2,100
2789,75,121,325,446,2,100
2790,75,105,181,286,2,100
2791,75,69,146,215,2,100
2792,75,6,4,10,2,100
2793,75,36,48,84,2,100
2794,75,7,8,15,2,100
2795,75,46,46,92,2,100
2796,75,19,8,27,2,100
2797,75,102,283,385,2,100
2798,75,90,229,319,2,100
2799,75,48,80,128,2,100
2800,75,69,128,197,2,100
2801,75,125,240,365,2,100
2802,75,91,177,268,2,100
2803,75,68,107,175,2,100
2804,75,130,210,340,2,100
2805,75,129,272,401,2,100
2806,75,115,272,387,2,100
2807,75,126,348,474,2,100
2808,75,36,51,87,2,100
2809,75,73,157,230,2,100
2810,75,83,71,154,2,100
2811,75,61,69,130,2,100
2812,75,100,175,275,2,100
2813,75,126,179,305,2,100
2814,75,17,73,90,2,100
2815,75,99,238,337,2,100
2816,75,96,142,238,2,100
2817,75,51,124,175,2,100
2818,75,104,195,299,2,100
2819,75,138,193,331,2,100
2820,75,130,189,319,2,100
2821,75,146,245,391,2,100
2822,75,102,63,165,2,100
2823,75,114,300,414,2,100
2824,75,133,200,333,2,100
2825,75,72,138,210,2,100
2826,75,84,172,256,2,100
2827,75,51,129,180,2,100
2828,75,67,47,114,2,100
2829,75,16,38,54,2,100
2830,75,27,103,130,2,100
2831,75,20,46,66,2,100
2832,75,110,216,326,2,100
2833,75,55,206,261,2,100
2834,75,73,75,148,2,100
2835,75,65,179,244,2,100
2836,75,78,193,271,2,100
2837,75,108,284,392,2,100
2838,75,26,62,88,2,100
2839,75,67,209,276,2,100
2840,75,83,189,272,2,100
2841,75,108,117,225,2,100
2842,75,130,146,276,2,100
2843,75,44,94,138,2,100
2844,75,83,118,201,2,100
2845,75,42,55,97,2,100
2846,75,19,54,73,2,100
2847,75,23,25,48,2,100
2848,75,106,86,192,2,100
2849,75,154,134,288,2,100
2850,75,204,246,450,2,100
2851,75,108,107,215,2,100
2852,75,68,88,156,2,100
2853,75,199,403,602,2,100
2854,75,128,225,353,2,100
2855,75,83,123,206,2,100
2856,75,36,108,144,2,100
2857,75,68,139,207,2,100
2858,75,125,141,266,2,100
2859,75,47,123,170,2,100
2860,75,40,113,153,2,100
2861,75,45,88,133,2,100
2862,75,27,48,75,2,100
2863,75,49,82,131,2,100
2864,75,79,144,223,2,100
2865,75,36,78,114,2,100
2866,75,128,255,383,2,100
2867,75,117,257,374,2,100
2868,75,44,35,79,2,100
2869,75,141,247,388,2,100
2870,75,70,201,271,2,100
2871,75,139,214,353,2,100
2872,75,97,165,262,2,100
2873,75,69,171,240,2,100
2874,75,50,62,112,2,100
2875,75,75,149,224,2,100
2876,75,20,39,59,2,100
2877,75,32,50,82,2,100
2878,75,269,288,557,2,100
2879,75,63,135,198,2,100
2880,75,46,72,118,2,100
2881,75,140,306,446,2,100
2882,75,110,203,313,2,100
2883,75,54,87,141,2,100
2884,75,172,247,419,2,100
2885,75,17,21,38,2,100
2886,75,21,33,54,2,100
2887,75,73,139,212,2,100
2888,75,50,110,160,2,100
2889,75,56,88,144,2,100
2890,75,95,103,198,2,100
2891,75,58,84,142,2,100
2892,75,32,60,92,2,100
2893,75,111,100,211,2,100
2894,75,108,211,319,2,100
2895,75,67,76,143,2,100
2896,75,69,120,189,2,100
2897,75,56,149,205,2,100
2898,75,45,83,128,2,100
2899,75,95,114,209,2,100
2900,75,71,143,214,2,100
2901,75,64,91,155,2,100
2902,75,22,66,88,2,100
2903,75,10,77,87,2,100
2904,75,117,232,349,2,100
2905,75,96,166,262,2,100
2906,75,92,176,268,2,100
2907,75,97,201,298,2,100
2908,75,38,59,97,2,100
2909,75,53,60,113,2,100
2910,75,127,244,371,2,100
2911,75,63,156,219,2,100
2912,75,126,233,359,2,100
2913,75,76,186,262,2,100
2914,75,102,250,352,2,100
2915,75,85,165,250,2,100
2916,75,6,21,27,2,100
2917,75,2,6,8,2,100
2918,75,4,17,21,2,100
2919,75,10,30,40,2,100
2920,75,7,23,30,2,100
2921,75,2,0,2,2,100
2922,75,0,0,0,2,100
2923,75,5,8,13,2,100
2924,75,2,1,3,2,100
2925,75,101,148,249,2,100
2926,75,74,222,296,2,100
2927,75,90,198,288,2,100
2928,75,46,54,100,2,100
2929,75,78,243,321,2,100
2930,75,44,105,149,2,100
2931,75,142,189,331,2,100
2932,75,108,90,198,2,100
2933,75,65,190,255,2,100
2934,75,128,225,353,2,100
2935,75,46,86,132,2,100
2936,75,114,169,283,2,100
2937,75,36,67,103,2,100
2938,75,109,101,210,2,100
2939,75,95,142,237,2,100
2940,75,48,97,145,2,100
2941,75,31,57,88,2,100
2942,75,148,233,381,2,100
2943,75,102,128,230,2,100
2944,75,29,125,154,2,100
2945,75,498,549,1047,2,100
2946,75,156,218,374,2,100
2947,75,153,138,291,2,100
2948,75,83,182,265,2,100
2949,75,86,122,208,2,100
2950,75,149,162,311,2,100
2951,75,109,183,292,2,100
2952,75,54,71,125,2,100
2953,75,44,99,143,2,100
2954,75,43,114,157,2,100
2955,75,10,19,29,2,100
2956,75,50,150,200,2,100
2957,75,95,201,296,2,100
2958,75,98,155,253,2,100
2959,75,60,164,224,2,100
2960,75,116,177,293,2,100
2961,75,68,94,162,2,100
2962,75,119,245,364,2,100
2963,75,66,60,126,2,100
2964,75,148,212,360,2,100
2965,75,75,88,163,2,100
2966,75,83,191,274,2,100
2967,75,10,56,66,2,100
2968,75,126,240,366,2,100
2969,75,51,77,128,2,100
2970,75,111,200,311,2,100
2971,75,54,75,129,2,100
2972,75,162,170,332,2,100
2973,75,53,90,143,2,100
2974,75,81,228,309,2,100
2975,75,77,123,200,2,100
2976,75,184,359,543,2,100
2977,75,151,157,308,2,100
2978,75,63,107,170,2,100
2979,75,37,35,72,2,100
2980,75,18,54,72,2,100
2981,75,70,130,200,2,100
2982,75,79,181,260,2,100
2983,75,69,174,243,2,100
2984,75,11,24,35,2,100
2985,75,18,38,56,2,100
2986,75,148,226,374,2,100
2987,75,108,219,327,2,100
2988,75,142,294,436,2,100
2989,75,251,481,732,2,100
2990,75,31,111,142,2,100
2991,75,73,162,235,2,100
2992,75,20,33,53,2,100
2993,75,66,127,193,2,100
2994,75,66,144,210,2,100
2995,75,83,160,243,2,100
2996,75,24,44,68,2,100
2997,75,13,112,125,2,100
2998,75,155,319,474,2,100
2999,75,198,344,542,2,100
3000,75,103,262,365,2,100
3001,75,52,130,182,2,100
3002,75,96,50,146,2,100
3003,75,82,177,259,2,100
3004,75,56,106,162,2,100
3005,75,178,172,350,2,100
3006,75,81,121,202,2,100
3007,75,36,56,92,2,100
3008,75,121,176,297,2,100
3009,75,29,78,107,2,100
3010,75,59,91,150,2,100
3011,75,36,93,129,2,100
3012,75,112,223,335,2,100
3013,75,48,70,118,2,100
3014,75,121,231,352,2,100
3015,75,151,246,397,2,100
3016,75,47,112,159,2,100
3017,75,156,369,525,2,100
3018,75,69,140,209,2,100
3019,75,69,173,242,2,100
3020,75,28,106,134,2,100
3021,75,66,104,170,2,100
3022,75,66,167,233,2,100
3023,75,33,92,125,2,100
3024,75,20,25,45,2,100
3025,75,36,45,81,2,100
3026,75,76,123,199,2,100
3027,75,55,149,204,2,100
3028,75,66,210,276,2,100
3029,75,86,188,274,2,100
3030,75,74,156,230,2,100
3031,75,30,20,50,2,100
3032,75,167,290,457,2,100
3033,75,58,86,144,2,100
3034,75,39,28,67,2,100
3035,75,40,50,90,2,100
3036,75,15,56,71,2,100
3037,75,81,97,178,2,100
3038,75,64,127,191,2,100
3039,75,113,171,284,2,100
3040,75,85,128,213,2,100
3041,75,123,198,321,2,100
3042,75,235,229,464,2,100
3043,75,104,245,349,2,100
3044,75,136,261,397,2,100
3045,75,35,48,83,2,100
3046,75,146,231,377,2,100
3047,75,30,37,67,2,100
3048,75,173,271,444,2,100
3049,75,26,42,68,2,100
3050,75,18,36,54,2,100
3051,75,48,149,197,2,100
3052,75,60,87,147,2,100
3053,75,129,287,416,2,100
3054,75,78,81,159,2,100
3055,75,169,211,380,2,100
3056,75,103,197,300,2,100
3057,75,47,140,187,2,100
3058,75,57,56,113,2,100
3059,75,86,138,224,2,100
3060,75,78,101,179,2,100
3061,75,48,121,169,2,100
3062,75,84,200,284,2,100
3063,75,14,69,83,2,100
3064,75,232,340,572,2,100
3065,75,21,77,98,2,100
3066,75,29,101,130,2,100
3067,75,24,31,55,2,100
3068,75,25,70,95,2,100
3069,75,83,112,195,2,100
3070,75,83,114,197,2,100
3071,75,168,218,386,2,100
3072,75,54,113,167,2,100
3073,75,77,143,220,2,100
3074,75,50,67,117,2,100
3075,75,35,51,86,2,100
3076,75,26,51,77,2,100
3077,75,165,243,408,2,100
3078,75,37,65,102,2,100
3079,75,63,80,143,2,100
3080,75,52,19,71,2,100
3081,75,67,115,182,2,100
3082,75,51,37,88,2,100
3083,75,77,133,210,2,100
3084,75,238,235,473,2,100
3085,75,194,165,359,2,100
3086,75,52,58,110,2,100
3087,75,163,77,240,2,100
3088,75,120,114,234,2,100
3089,75,79,103,182,2,100
3090,75,44,93,137,2,100
3091,75,75,113,188,2,100
3092,75,34,28,62,2,100
3093,75,99,241,340,2,100
3094,75,53,93,146,2,100
3095,75,342,183,525,2,100
3096,75,77,85,162,2,100
3097,75,132,151,283,2,100
3098,75,7,31,38,2,100
3099,75,36,57,93,2,100
3100,75,78,120,198,2,100
3101,75,82,169,251,2,100
3102,75,73,159,232,2,100
3103,75,44,84,128,2,100
3104,75,64,139,203,2,100
3105,75,63,132,195,2,100
3106,75,12,40,52,2,100
3107,75,25,34,59,2,100
3108,75,54,73,127,2,100
3109,75,32,60,92,2,100
3110,75,100,137,237,2,100
3111,75,70,145,215,2,100
3112,75,90,112,202,2,100
3113,75,101,177,278,2,100
3114,75,88,267,355,2,100
3115,75,69,128,197,2,100
3116,75,120,177,297,2,100
3117,75,36,116,152,2,100
3118,75,104,205,309,2,100
3119,75,122,132,254,2,100
3120,75,84,136,220,2,100
3121,75,15,55,70,2,100
3122,90,143,232,375,2,100
3123,90,101,152,253,2,100
3124,90,30,126,156,2,100
3125,90,68,135,203,2,100
3126,90,40,84,124,2,100
3127,90,132,83,215,2,100
3128,90,80,69,149,2,100
3129,90,164,215,379,2,100
3130,90,64,136,200,2,100
3131,90,166,226,392,2,100
3132,90,89,113,202,2,100
3133,90,51,79,130,2,100
3134,90,82,207,289,2,100
3135,90,183,317,500,2,100
3136,90,69,132,201,2,100
3137,90,235,291,526,2,100
3138,90,81,194,275,2,100
3139,90,9,50,59,2,100
3140,90,32,120,152,2,100
3141,90,155,276,431,2,100
3142,90,32,71,103,2,100
3143,90,78,151,229,2,100
3144,90,95,110,205,2,100
3145,90,37,63,100,2,100
3146,90,131,294,425,2,100
3147,90,122,349,471,2,100
3148,90,128,238,366,2,100
3149,90,123,257,380,2,100
3150,90,56,110,166,2,100
3151,90,113,179,292,2,100
3152,90,104,158,262,2,100
3153,90,71,196,267,2,100
3154,90,15,18,33,2,100
3155,90,85,121,206,2,100
3156,90,68,106,174,2,100
3157,90,140,239,379,2,100
3158,90,102,266,368,2,100
3159,90,63,91,154,2,100
3160,90,100,126,226,2,100
3161,90,81,132,213,2,100
3162,90,79,116,195,2,100
3163,90,60,72,132,2,100
3164,90,103,329,432,2,100
3165,90,58,111,169,2,100
3166,90,165,154,319,2,100
3167,90,140,310,450,2,100
3168,90,63,81,144,2,100
3169,90,70,47,117,2,100
3170,90,117,181,298,2,100
3171,90,75,114,189,2,100
3172,90,36,124,160,2,100
3173,90,193,277,470,2,100
3174,90,242,424,666,2,100
3175,90,189,253,442,2,100
3176,90,104,222,326,2,100
3177,90,119,202,321,2,100
3178,90,223,210,433,2,100
3179,90,48,171,219,2,100
3180,90,71,186,257,2,100
3181,90,91,281,372,2,100
3182,90,165,190,355,2,100
3183,90,42,41,83,2,100
3184,90,52,107,159,2,100
3185,90,62,79,141,2,100
3186,90,160,233,393,2,100
3187,90,138,202,340,2,100
3188,90,169,400,569,2,100
3189,90,74,137,211,2,100
3190,90,93,150,243,2,100
3191,90,66,128,194,2,100
3192,90,91,72,163,2,100
3193,90,71,114,185,2,100
3194,90,70,142,212,2,100
3195,90,134,228,362,2,100
3196,90,81,188,269,2,100
3197,90,72,67,139,2,100
3198,90,32,51,83,2,100
3199,90,61,74,135,2,100
3200,90,66,95,161,2,100
3201,90,76,129,205,2,100
3202,90,42,94,136,2,100
3203,90,211,196,407,2,100
3204,90,121,240,361,2,100
3205,90,42,148,190,2,100
3206,90,117,180,297,2,100
3207,90,130,233,363,2,100
3208,90,94,170,264,2,100
3209,90,29,50,79,2,100
3210,90,187,272,459,2,100
3211,90,120,278,398,2,100
3212,90,136,161,297,2,100
3213,90,170,340,510,2,100
3214,90,92,129,221,2,100
3215,90,66,89,155,2,100
3216,90,39,66,105,2,100
3217,90,64,105,169,2,100
3218,90,92,146,238,2,100
3219,90,93,159,252,2,100
3220,90,120,204,324,2,100
3221,90,126,241,367,2,100
3222,90,101,203,304,2,100
3223,90,149,302,451,2,100
3224,90,60,125,185,2,100
3225,90,31,34,65,2,100
3226,90,75,125,200,2,100
3227,90,108,143,251,2,100
3228,90,321,404,725,2,100
3229,90,151,258,409,2,100
3230,90,89,111,200,2,100
3231,90,75,108,183,2,100
3232,90,64,94,158,2,100
3233,90,84,119,203,2,100
3234,90,63,154,217,2,100
3235,90,51,67,118,2,100
3236,90,53,81,134,2,100
3237,90,47,77,124,2,100
3238,90,90,126,216,2,100
3239,90,12,33,45,2,100
3240,90,109,178,287,2,100
3241,90,58,123,181,2,100
3242,90,111,96,207,2,100
3243,90,144,154,298,2,100
3244,90,122,165,287,2,100
3245,90,129,218,347,2,100
3246,90,50,81,131,2,100
3247,90,215,364,579,2,100
3248,90,29,41,70,2,100
3249,90,105,271,376,2,100
3250,90,131,221,352,2,100
3251,90,54,97,151,2,100
3252,90,159,241,400,2,100
3253,90,84,182,266,2,100
3254,90,44,99,143,2,100
3255,90,18,50,68,2,100
3256,90,139,226,365,2,100
3257,90,234,479,713,2,100
3258,90,216,542,758,2,100
3259,90,94,167,261,2,100
3260,90,89,126,215,2,100
3261,90,107,140,247,2,100
3262,90,187,415,602,2,100
3263,90,128,143,271,2,100
3264,90,69,219,288,2,100
3265,90,65,178,243,2,100
3266,90,10,18,28,2,100
3267,90,105,240,345,2,100
3268,90,189,327,516,2,100
3269,90,119,140,259,2,100
3270,90,71,90,161,2,100
3271,90,48,150,198,2,100
3272,90,228,349,577,2,100
3273,90,43,118,161,2,100
3274,90,51,130,181,2,100
3275,90,136,283,419,2,100
3276,90,58,123,181,2,100
3277,90,27,32,59,2,100
3278,90,161,222,383,2,100
3279,90,146,144,290,2,100
3280,90,37,107,144,2,100
3281,90,52,90,142,2,100
3282,90,79,183,262,2,100
3283,90,37,125,162,2,100
3284,90,34,70,104,2,100
3285,90,17,25,42,2,100
3286,90,107,211,318,2,100
3287,90,24,18,42,2,100
3288,90,82,113,195,2,100
3289,90,264,402,666,2,100
3290,90,76,71,147,2,100
3291,90,89,211,300,2,100
3292,90,86,107,193,2,100
3293,90,93,109,202,2,100
3294,90,52,134,186,2,100
3295,90,108,186,294,2,100
3296,90,149,97,246,2,100
3297,90,28,79,107,2,100
3298,90,62,124,186,2,100
3299,90,11,77,88,2,100
3300,90,35,36,71,2,100
3301,90,62,76,138,2,100
3302,90,139,342,481,2,100
3303,90,203,276,479,2,100
3304,90,19,35,54,2,100
3305,90,220,389,609,2,100
3306,90,35,95,130,2,100
3307,90,72,167,239,2,100
3308,90,54,83,137,2,100
3309,90,38,36,74,2,100
3310,90,59,84,143,2,100
3311,90,99,291,390,2,100
3312,90,191,361,552,2,100
3313,90,129,198,327,2,100
3314,90,86,133,219,2,100
3315,90,144,153,297,2,100
3316,90,176,220,396,2,100
3317,90,159,311,470,2,100
3318,90,76,158,234,2,100
3319,90,38,44,82,2,100
3320,90,34,98,132,2,100
3321,90,66,149,215,2,100
3322,90,93,201,294,2,100
3323,90,172,266,438,2,100
3324,90,68,125,193,2,100
3325,90,125,282,407,2,100
3326,90,66,143,209,2,100
3327,90,99,200,299,2,100
3328,90,63,151,214,2,100
3329,90,37,125,162,2,100
3330,90,189,353,542,2,100
3331,90,66,63,129,2,100
3332,90,123,132,255,2,100
3333,90,286,472,758,2,100
3334,90,97,79,176,2,100
3335,90,134,233,367,2,100
3336,90,124,125,249,2,100
3337,90,173,257,430,2,100
3338,90,149,197,346,2,100
3339,90,68,83,151,2,100
3340,90,78,132,210,2,100
3341,90,54,163,217,2,100
3342,90,52,107,159,2,100
3343,90,42,112,154,2,100
3344,90,80,139,219,2,100
3345,90,156,330,486,2,100
3346,90,115,202,317,2,100
3347,90,154,284,438,2,100
3348,90,96,135,231,2,100
3349,90,172,292,464,2,100
3350,90,100,252,352,2,100
3351,90,68,121,189,2,100
3352,90,103,185,288,2,100
3353,90,133,195,328,2,100
3354,90,42,90,132,2,100
3355,90,75,199,274,2,100
3356,90,15,38,53,2,100
3357,90,367,598,965,2,100
3358,90,51,89,140,2,100
3359,90,73,98,171,2,100
3360,90,107,133,240,2,100
3361,90,345,597,942,2,100
3362,90,63,132,195,2,100
3363,90,74,92,166,2,100
3364,90,36,92,128,2,100
3365,90,19,44,63,2,100
3366,90,27,63,90,2,100
3367,90,11,53,64,2,100
3368,90,110,271,381,2,100
3369,90,14,31,45,2,100
3370,90,78,118,196,2,100
3371,90,116,163,279,2,100
3372,90,6,0,6,2,100
3373,90,28,38,66,2,100
3374,90,48,85,133,2,100
3375,90,197,305,502,2,100
3376,90,22,121,143,2,100
3377,90,99,190,289,2,100
3378,90,116,191,307,2,100
3379,90,82,161,243,2,100
3380,90,75,149,224,2,100
3381,90,31,98,129,2,100
3382,90,86,141,227,2,100
3383,90,192,296,488,2,100
3384,90,29,40,69,2,100
3385,90,97,206,303,2,100
3386,90,87,193,280,2,100
3387,90,65,156,221,2,100
3388,90,77,126,203,2,100
3389,90,26,78,104,2,100
3390,90,62,120,182,2,100
3391,90,95,111,206,2,100
3392,90,193,303,496,2,100
3393,90,162,161,323,2,100
3394,90,148,197,345,2,100
3395,90,17,49,66,2,100
3396,90,149,228,377,2,100
3397,90,45,98,143,2,100
3398,90,63,65,128,2,100
3399,90,46,73,119,2,100
3400,90,62,68,130,2,100
3401,90,47,138,185,2,100
3402,90,5,8,13,2,100
3403,90,171,243,414,2,100
3404,90,98,226,324,2,100
3405,90,119,192,311,2,100
3406,90,112,247,359,2,100
3407,90,110,181,291,2,100
3408,90,151,438,589,2,100
3409,90,80,125,205,2,100
3410,90,92,330,422,2,100
3411,90,24,37,61,2,100
3412,90,70,71,141,2,100
3413,90,41,40,81,2,100
3414,90,37,60,97,2,100
3415,90,101,164,265,2,100
3416,90,116,230,346,2,100
3417,90,26,60,86,2,100
3418,90,76,209,285,2,100
3419,90,140,196,336,2,100
3420,90,88,182,270,2,100
3421,90,105,207,312,2,100
3422,90,79,120,199,2,100
3423,90,122,205,327,2,100
3424,90,33,88,121,2,100
3425,90,58,122,180,2,100
3426,90,91,142,233,2,100
3427,90,99,153,252,2,100
3428,90,48,199,247,2,100
3429,90,133,199,332,2,100
3430,90,78,148,226,2,100
3431,90,55,59,114,2,100
3432,90,15,96,111,2,100
3433,90,140,185,325,2,100
3434,90,76,109,185,2,100
3435,90,37,60,97,2,100
3436,90,12,12,24,2,100
3437,90,82,176,258,2,100
3438,90,45,114,159,2,100
3439,90,53,127,180,2,100
3440,90,77,111,188,2,100
3441,90,99,147,246,2,100
3442,90,103,207,310,2,100
3443,90,71,121,192,2,100
3444,90,93,292,385,2,100
3445,90,41,77,118,2,100
3446,90,48,122,170,2,100
3447,90,13,17,30,2,100
3448,90,129,178,307,2,100
3449,90,131,249,380,2,100
3450,90,176,196,372,2,100
3451,90,67,96,163,2,100
3452,90,121,132,253,2,100
3453,90,85,119,204,2,100
3454,90,88,125,213,2,100
3455,90,60,110,170,2,100
3456,90,86,129,215,2,100
3457,90,44,77,121,2,100
3458,90,11,40,51,2,100
3459,90,67,66,133,2,100
3460,90,101,90,191,2,100
3461,90,71,157,228,2,100
3462,90,72,143,215,2,100
3463,90,95,166,261,2,100
3464,90,129,266,395,2,100
3465,90,73,118,191,2,100
3466,90,127,200,327,2,100
3467,90,96,140,236,2,100
3468,90,108,218,326,2,100
3469,90,95,187,282,2,100
3470,90,52,104,156,2,100
3471,90,41,90,131,2,100
3472,90,41,65,106,2,100
3473,90,28,125,153,2,100
3474,120,79,137,216,2,100
3475,120,69,171,240,2,100
3476,120,135,272,407,2,100
3477,120,149,206,355,2,100
3478,120,105,176,281,2,100
3479,120,99,236,335,2,100
3480,120,89,216,305,2,100
3481,120,133,225,358,2,100
3482,120,70,93,163,2,100
3483,120,74,225,299,2,100
3484,120,58,82,140,2,100
3485,120,83,160,243,2,100
3486,120,120,170,290,2,100
3487,120,115,118,233,2,100
3488,120,171,184,355,2,100
3489,120,145,241,386,2,100
3490,120,118,156,274,2,100
3491,120,26,64,90,2,100
3492,120,44,86,130,2,100
3493,120,40,67,107,2,100
3494,120,68,196,264,2,100
3495,120,46,85,131,2,100
3496,120,31,64,95,2,100
3497,120,89,74,163,2,100
3498,120,151,169,320,2,100
3499,120,90,121,211,2,100
3500,120,100,104,204,2,100
3501,120,76,206,282,2,100
3502,120,41,130,171,2,100
3503,120,55,122,177,2,100
3504,120,104,184,288,2,100
3505,120,78,52,130,2,100
3506,120,61,63,124,2,100
3507,120,112,189,301,2,100
3508,120,67,86,153,2,100
3509,120,50,94,144,2,100
3510,120,24,23,47,2,100
3511,120,70,125,195,2,100
3512,120,46,51,97,2,100
3513,120,75,68,143,2,100
3514,120,65,77,142,2,100
3515,120,29,18,47,2,100
3516,120,21,38,59,2,100
3517,120,84,188,272,2,100
3518,120,72,120,192,2,100
3519,120,49,68,117,2,100
3520,120,144,130,274,2,100
3521,120,128,225,353,2,100
3522,120,106,167,273,2,100
3523,120,91,112,203,2,100
3524,120,101,124,225,2,100
3525,120,70,165,235,2,100
3526,120,14,26,40,2,100
3527,120,51,79,130,2,100
3528,120,160,275,435,2,100
3529,120,155,206,361,2,100
3530,120,131,288,419,2,100
3531,120,63,147,210,2,100
3532,120,192,304,496,2,100
3533,120,7,26,33,2,100
3534,120,69,132,201,2,100
3535,120,40,98,138,2,100
3536,120,65,84,149,2,100
3537,120,84,183,267,2,100
3538,120,24,71,95,2,100
3539,120,25,88,113,2,100
3540,120,50,77,127,2,100
3541,120,43,74,117,2,100
3542,120,84,64,148,2,100
3543,120,26,22,48,2,100
3544,120,72,178,250,2,100
3545,120,59,165,224,2,100
3546,120,223,508,731,2,100
3547,120,87,163,250,2,100
3548,120,83,228,311,2,100
3549,120,112,122,234,2,100
3550,120,69,98,167,2,100
3551,120,48,70,118,2,100
3552,120,65,92,157,2,100
3553,120,89,123,212,2,100
3554,120,33,212,245,2,100
3555,120,118,144,262,2,100
3556,120,99,177,276,2,100
3557,120,47,126,173,2,100
3558,120,72,66,138,2,100
3559,120,44,121,165,2,100
3560,120,39,88,127,2,100
3561,120,106,165,271,2,100
3562,120,50,110,160,2,100
3563,120,59,105,164,2,100
3564,120,106,169,275,2,100
3565,120,132,219,351,2,100
3566,120,68,136,204,2,100
3567,120,67,19,86,2,100
3568,120,31,53,84,2,100
3569,120,119,159,278,2,100
3570,120,27,89,116,2,100
3571,120,28,80,108,2,100
3572,120,72,70,142,2,100
3573,120,41,87,128,2,100
3574,120,56,140,196,2,100
3575,120,143,83,226,2,100
3576,120,74,100,174,2,100
3577,120,90,186,276,2,100
3578,120,135,231,366,2,100
3579,120,163,253,416,2,100
3580,120,65,88,153,2,100
3581,120,73,116,189,2,100
3582,120,49,103,152,2,100
3583,120,40,116,156,2,100
3584,120,202,281,483,2,100
3585,120,152,222,374,2,100
3586,120,45,93,138,2,100
3587,120,27,56,83,2,100
3588,120,68,172,240,2,100
3589,120,61,88,149,2,100
3590,120,156,317,473,2,100
3591,120,85,149,234,2,100
3592,120,84,121,205,2,100
3593,120,63,130,193,2,100
3594,120,65,91,156,2,100
3595,120,185,198,383,2,100
3596,120,185,269,454,2,100
3597,120,52,130,182,2,100
3598,120,35,76,111,2,100
3599,120,18,27,45,2,100
3600,120,185,303,488,2,100
3601,120,115,228,343,2,100
3602,120,139,306,445,2,100
3603,120,125,222,347,2,100
3604,120,77,178,255,2,100
3605,120,89,177,266,2,100
3606,120,30,46,76,2,100
3607,120,102,162,264,2,100
3608,120,34,122,156,2,100
3609,120,15,57,72,2,100
3610,120,66,133,199,2,100
3611,120,39,141,180,2,100
3612,120,53,113,166,2,100
3613,120,60,137,197,2,100
3614,120,128,208,336,2,100
3615,120,95,193,288,2,100
3616,120,82,181,263,2,100
3617,120,84,189,273,2,100
3618,120,8,46,54,2,100
3619,120,63,149,212,2,100
3620,120,16,74,90,2,100
3621,120,43,125,168,2,100
3622,120,4,11,15,2,100
3623,120,57,113,170,2,100
3624,120,34,75,109,2,100
3625,120,75,171,246,2,100
3626,120,36,47,83,2,100
3627,120,72,76,148,2,100
3628,120,102,152,254,2,100
3629,120,57,94,151,2,100
3630,120,36,42,78,2,100
3631,120,126,181,307,2,100
3632,120,59,106,165,2,100
3633,120,55,97,152,2,100
3634,120,1,1,2,2,100
3635,120,40,86,126,2,100
3636,120,44,126,170,2,100
3637,120,27,67,94,2,100
3638,120,71,119,190,2,100
3639,120,81,118,199,2,100
3640,120,41,90,131,2,100
3641,120,42,123,165,2,100
3642,120,35,54,89,2,100
3643,120,54,163,217,2,100
3644,120,82,133,215,2,100
3645,120,6,3,9,2,100
3646,120,45,70,115,2,100
3647,120,28,65,93,2,100
3648,120,88,186,274,2,100
3649,120,61,98,159,2,100
3650,120,31,88,119,2,100
3651,120,69,175,244,2,100
3652,120,84,18,102,2,100
3653,120,76,103,179,2,100
3654,120,38,3,41,2,100
3655,120,102,144,246,2,100
3656,120,16,31,47,2,100
3657,120,18,60,78,2,100
3658,120,87,270,357,2,100
3659,120,122,225,347,2,100
3660,120,97,174,271,2,100
3661,120,58,157,215,2,100
3662,120,55,146,201,2,100
3663,120,52,85,137,2,100
3664,120,63,129,192,2,100
3665,120,144,375,519,2,100
3666,120,79,99,178,2,100
3667,120,176,260,436,2,100
3668,120,91,212,303,2,100
3669,120,48,154,202,2,100
3670,120,147,332,479,2,100
3671,120,77,140,217,2,100
3672,120,182,437,619,2,100
3673,120,190,347,537,2,100
3674,120,100,183,283,2,100
3675,120,106,229,335,2,100
3676,120,132,275,407,2,100
3677,120,117,227,344,2,100
3678,120,63,139,202,2,100
3679,120,54,159,213,2,100
3680,120,26,56,82,2,100
3681,120,33,25,58,2,100
3682,120,24,65,89,2,100
3683,120,44,105,149,2,100
3684,120,25,73,98,2,100
3685,120,81,112,193,2,100
3686,120,85,133,218,2,100
3687,120,64,81,145,2,100
3688,120,211,260,471,2,100
3689,120,128,187,315,2,100
3690,120,77,108,185,2,100
3691,120,91,111,202,2,100
3692,120,59,89,148,2,100
3693,120,104,196,300,2,100
3694,120,62,133,195,2,100
3695,120,71,130,201,2,100
3696,120,94,246,340,2,100
3697,120,72,302,374,2,100
3698,120,31,64,95,2,100
3699,120,26,85,111,2,100
3700,120,61,20,81,2,100
3701,120,41,30,71,2,100
3702,120,139,272,411,2,100
3703,120,53,157,210,2,100
3704,120,78,100,178,2,100
3705,120,102,100,202,2,100
3706,120,74,252,326,2,100
3707,120,43,142,185,2,100
3708,120,45,128,173,2,100
3709,120,112,145,257,2,100
3710,120,73,80,153,2,100
3711,120,15,38,53,2,100
3712,120,119,239,358,2,100
3713,120,75,148,223,2,100
3714,120,66,253,319,2,100
3715,120,88,223,311,2,100
3716,120,116,147,263,2,100
3717,120,90,221,311,2,100
3718,120,132,122,254,2,100
3719,120,139,243,382,2,100
3720,120,36,65,101,2,100
3721,120,51,139,190,2,100
3722,120,38,65,103,2,100
3723,120,70,181,251,2,100
3724,120,142,260,402,2,100
3725,120,75,164,239,2,100
3726,120,97,142,239,2,100
3727,120,199,286,485,2,100
3728,120,89,164,253,2,100
3729,120,36,105,141,2,100
3730,120,54,96,150,2,100
3731,120,83,166,249,2,100
3732,120,63,171,234,2,100
3733,120,97,138,235,2,100
3734,120,57,99,156,2,100
3735,120,124,170,294,2,100
3736,120,84,105,189,2,100
3737,120,70,93,163,2,100
3738,120,122,192,314,2,100
3739,120,109,139,248,2,100
3740,120,101,204,305,2,100
3741,120,26,63,89,2,100
3742,120,38,31,69,2,100
3743,120,51,87,138,2,100
3744,120,129,223,352,2,100
3745,120,154,185,339,2,100
3746,120,32,86,118,2,100
3747,120,82,119,201,2,100
3748,120,166,175,341,2,100
3749,120,58,93,151,2,100
3750,120,79,109,188,2,100
3751,120,51,107,158,2,100
3752,120,183,204,387,2,100
3753,120,37,72,109,2,100
3754,120,263,556,819,2,100
3755,120,40,56,96,2,100
3756,120,36,25,61,2,100
3757,120,3,21,24,2,100
3758,120,98,167,265,2,100
3759,120,105,95,200,2,100
3760,120,21,66,87,2,100
3761,120,179,150,329,2,100
3762,120,87,136,223,2,100
3763,120,93,185,278,2,100
3764,120,72,124,196,2,100
3765,120,89,108,197,2,100
3766,120,113,66,179,2,100
3767,120,78,103,181,2,100
3768,120,33,63,96,2,100
3769,120,30,35,65,2,100
3770,120,149,251,400,2,100
3771,120,190,279,469,2,100
3772,120,43,87,130,2,100
3773,120,225,123,348,2,100
3774,120,33,94,127,2,100
3775,120,153,177,330,2,100
3776,120,153,194,347,2,100
3777,120,120,127,247,2,100
3778,120,144,184,328,2,100
3779,120,83,119,202,2,100
3780,120,126,248,374,2,100
3781,120,124,143,267,2,100
3782,120,70,121,191,2,100
3783,120,111,171,282,2,100
3784,120,186,392,578,2,100
3785,120,102,175,277,2,100
3786,120,93,129,222,2,100
3787,120,165,231,396,2,100
3788,120,88,126,214,2,100
3789,120,38,112,150,2,100
3790,120,96,96,192,2,100
3791,120,46,46,92,2,100
3792,120,46,109,155,2,100
3793,120,30,49,79,2,100
3794,120,20,62,82,2,100
3795,120,42,64,106,2,100
3796,120,25,32,57,2,100
3797,120,32,21,53,2,100
3798,120,92,122,214,2,100
3799,120,42,85,127,2,100
3800,120,53,93,146,2,100
3801,120,110,201,311,2,100
3802,120,30,85,115,2,100
3803,120,89,106,195,2,100
3804,120,48,178,226,2,100
3805,120,55,79,134,2,100
3806,120,73,106,179,2,100
3807,120,16,28,44,2,100
3808,120,56,130,186,2,100
3809,120,48,64,112,2,100
3810,120,111,220,331,2,100
3811,120,161,196,357,2,100
3812,120,112,239,351,2,100
3813,120,297,294,591,2,100
3814,120,133,179,312,2,100
3815,120,65,150,215,2,100
3816,120,216,204,420,2,100
3817,120,180,258,438,2,100
3818,120,110,94,204,2,100
3819,120,80,113,193,2,100
3820,120,109,204,313,2,100
3821,120,67,161,228,2,100
3822,120,39,84,123,2,100
3823,120,80,104,184,2,100
3824,120,64,111,175,2,100
3825,120,147,177,324,2,100
3826,120,57,79,136,2,100
3827,120,53,138,191,2,100
3828,120,92,120,212,2,100
3829,120,95,86,181,2,100
3830,120,114,135,249,2,100
3831,120,31,102,133,2,100
3832,120,12,44,56,2,100
3833,120,22,32,54,2,100
3834,120,20,45,65,2,100
3835,120,26,41,67,2,100
3836,120,55,103,158,2,100
3837,120,101,107,208,2,100
3838,120,64,87,151,2,100
3839,120,76,142,218,2,100
3840,120,152,272,424,2,100
3841,120,119,168,287,2,100
3842,120,61,129,190,2,100
3843,120,81,151,232,2,100
3844,120,71,80,151,2,100
3845,120,80,194,274,2,100
3846,120,58,88,146,2,100
3847,120,45,72,117,2,100
3848,120,43,104,147,2,100
3849,120,90,107,197,2,100
3850,120,135,174,309,2,100
3851,120,8,6,14,2,100
3852,120,83,175,258,2,100
3853,120,34,37,71,2,100
3854,150,30,33,63,2,100
3855,150,49,71,120,2,100
3856,150,89,152,241,2,100
3857,150,40,65,105,2,100
3858,150,41,76,117,2,100
3859,150,46,52,98,2,100
3860,150,47,38,85,2,100
3861,150,38,100,138,2,100
3862,150,40,95,135,2,100
3863,150,56,108,164,2,100
3864,150,30,56,86,2,100
3865,150,12,29,41,2,100
3866,150,118,156,274,2,100
3867,150,13,22,35,2,100
3868,150,134,253,387,2,100
3869,150,69,125,194,2,100
3870,150,39,42,81,2,100
3871,150,16,27,43,2,100
3872,150,64,121,185,2,100
3873,150,67,118,185,2,100
3874,150,9,22,31,2,100
3875,150,35,75,110,2,100
3876,150,48,42,90,2,100
3877,150,34,50,84,2,100
3878,150,59,59,118,2,100
3879,150,30,46,76,2,100
3880,150,9,12,21,2,100
3881,150,0,0,0,2,100
3882,150,13,29,42,2,100
3883,150,28,47,75,2,100
3884,150,0,0,0,2,100
3885,150,55,79,134,2,100
3886,150,36,49,85,2,100
3887,150,24,46,70,2,100
3888,150,77,89,166,2,100
3889,150,150,231,381,2,100
3890,150,114,198,312,2,100
3891,150,28,26,54,2,100
3892,150,3,11,14,2,100
3893,150,80,163,243,2,100
3894,150,54,133,187,2,100
3895,150,4,5,9,2,100
3896,150,32,60,92,2,100
3897,150,14,16,30,2,100
3898,150,25,36,61,2,100
3899,150,17,23,40,2,100
3900,150,17,49,66,2,100
3901,150,36,77,113,2,100
3902,150,68,102,170,2,100
3903,150,76,93,169,2,100
3904,150,43,65,108,2,100
3905,150,59,64,123,2,100
3906,150,26,31,57,2,100
3907,150,54,62,116,2,100
3908,150,41,72,113,2,100
3909,150,12,13,25,2,100
3910,150,46,91,137,2,100
3911,150,5,7,12,2,100
3912,150,91,87,178,2,100
3913,150,101,204,305,2,100
3914,150,36,57,93,2,100
3915,150,95,134,229,2,100
3916,150,114,287,401,2,100
3917,150,50,122,172,2,100
3918,150,60,289,349,2,100
3919,150,45,63,108,2,100
3920,150,71,72,143,2,100
3921,150,27,40,67,2,100
3922,150,38,74,112,2,100
3923,150,37,76,113,2,100
3924,150,12,27,39,2,100
3925,150,60,35,95,2,100
3926,150,34,39,73,2,100
3927,150,31,36,67,2,100
3928,150,36,62,98,2,100
3929,150,58,66,124,2,100
3930,150,39,31,70,2,100
3931,150,36,63,99,2,100
3932,150,9,29,38,2,100
3933,150,82,141,223,2,100
3934,150,57,110,167,2,100
3935,150,27,43,70,2,100
3936,150,26,39,65,2,100
3937,150,43,76,119,2,100
3938,150,37,68,105,2,100
3939,150,86,148,234,2,100
3940,150,5,29,34,2,100
3941,150,90,146,236,2,100
3942,150,52,94,146,2,100
3943,150,49,88,137,2,100
3944,150,84,113,197,2,100
3945,150,36,121,157,2,100
3946,150,66,109,175,2,100
3947,150,48,97,145,2,100
3948,150,92,91,183,2,100
3949,150,29,31,60,2,100
3950,150,41,54,95,2,100
3951,150,41,52,93,2,100
3952,150,46,87,133,2,100
3953,150,99,184,283,2,100
3954,150,22,65,87,2,100
3955,150,86,109,195,2,100
3956,150,59,121,180,2,100
3957,150,110,97,207,2,100
3958,150,71,122,193,2,100
3959,150,26,59,85,2,100
3960,150,56,161,217,2,100
3961,150,138,217,355,2,100
3962,150,139,171,310,2,100
3963,150,138,172,310,2,100
3964,150,76,203,279,2,100
3965,150,106,233,339,2,100
3966,150,88,163,251,2,100
3967,150,83,150,233,2,100
3968,150,75,80,155,2,100
3969,150,84,123,207,2,100
3970,150,31,74,105,2,100
3971,150,124,168,292,2,100
3972,150,70,135,205,2,100
3973,150,19,30,49,2,100
3974,150,75,150,225,2,100
3975,150,56,133,189,2,100
3976,150,76,142,218,2,100
3977,150,153,203,356,2,100
3978,150,43,91,134,2,100
3979,150,61,153,214,2,100
3980,150,128,183,311,2,100
3981,150,33,37,70,2,100
3982,150,32,64,96,2,100
3983,150,7,10,17,2,100
3984,150,109,82,191,2,100
3985,150,106,148,254,2,100
3986,150,44,67,111,2,100
3987,150,75,174,249,2,100
3988,150,43,52,95,2,100
3989,150,113,195,308,2,100
3990,150,41,102,143,2,100
3991,150,95,121,216,2,100
3992,150,26,46,72,2,100
3993,150,92,147,239,2,100
3994,150,29,79,108,2,100
3995,150,61,103,164,2,100
3996,150,38,65,103,2,100
3997,150,47,78,125,2,100
3998,150,97,98,195,2,100
3999,150,38,60,98,2,100
4000,150,40,76,116,2,100
4001,150,44,84,128,2,100
4002,150,47,100,147,2,100
4003,150,72,96,168,2,100
4004,150,20,59,79,2,100
4005,150,69,124,193,2,100
4006,150,74,114,188,2,100
4007,150,64,137,201,2,100
4008,150,36,51,87,2,100
4009,150,128,130,258,2,100
4010,150,43,94,137,2,100
4011,150,96,140,236,2,100
4012,150,59,93,152,2,100
4013,150,82,205,287,2,100
4014,150,27,74,101,2,100
4015,150,62,102,164,2,100
4016,150,113,293,406,2,100
4017,150,79,97,176,2,100
4018,150,72,85,157,2,100
4019,150,70,120,190,2,100
4020,150,111,249,360,2,100
4021,150,84,147,231,2,100
4022,150,53,85,138,2,100
4023,150,79,107,186,2,100
4024,150,67,108,175,2,100
4025,150,88,138,226,2,100
4026,150,56,66,122,2,100
4027,150,153,295,448,2,100
4028,150,115,232,347,2,100
4029,150,83,127,210,2,100
4030,150,126,194,320,2,100
4031,150,64,166,230,2,100
4032,150,104,169,273,2,100
4033,150,121,172,293,2,100
4034,150,30,62,92,2,100
4035,150,3,22,25,2,100
4036,150,50,64,114,2,100
4037,150,86,170,256,2,100
4038,150,54,79,133,2,100
4039,150,5,11,16,2,100
4040,150,62,104,166,2,100
4041,150,96,194,290,2,100
4042,150,30,44,74,2,100
4043,150,104,106,210,2,100
4044,150,31,60,91,2,100
4045,150,218,248,466,2,100
4046,150,113,148,261,2,100
4047,150,51,96,147,2,100
4048,150,44,108,152,2,100
4049,150,103,151,254,2,100
4050,150,65,136,201,2,100
4051,150,119,161,280,2,100
4052,150,73,223,296,2,100
4053,150,98,132,230,2,100
4054,150,2,6,8,2,100
4055,150,27,58,85,2,100
4056,150,43,55,98,2,100
4057,150,55,89,144,2,100
4058,150,54,76,130,2,100
4059,150,75,94,169,2,100
4060,150,62,119,181,2,100
4061,150,41,107,148,2,100
4062,150,76,173,249,2,100
4063,150,117,91,208,2,100
4064,150,67,133,200,2,100
4065,150,9,14,23,2,100
4066,150,34,38,72,2,100
4067,150,55,64,119,2,100
4068,150,115,69,184,2,100
4069,150,34,43,77,2,100
4070,150,21,18,39,2,100
4071,150,56,125,181,2,100
4072,150,71,131,202,2,100
4073,150,50,111,161,2,100
4074,150,117,205,322,2,100
4075,150,64,28,92,2,100
4076,150,73,136,209,2,100
4077,150,110,212,322,2,100
4078,150,56,108,164,2,100
4079,150,6,30,36,2,100
4080,150,74,105,179,2,100
4081,150,20,63,83,2,100
4082,150,80,111,191,2,100
4083,150,85,121,206,2,100
4084,150,5,1,6,2,100
4085,150,19,36,55,2,100
4086,150,25,73,98,2,100
4087,150,41,81,122,2,100
4088,150,56,77,133,2,100
4089,150,39,61,100,2,100
4090,150,65,98,163,2,100
4091,150,38,50,88,2,100
4092,150,68,90,158,2,100
4093,150,3,27,30,2,100
4094,150,61,127,188,2,100
4095,150,10,19,29,2,100
4096,150,100,111,211,2,100
4097,150,4,17,21,2,100
4098,150,14,20,34,2,100
4099,150,3,17,20,2,100
4100,150,31,42,73,2,100
4101,150,29,42,71,2,100
4102,150,32,43,75,2,100
4103,150,75,75,150,2,100
4104,150,87,92,179,2,100
4105,150,72,60,132,2,100
4106,150,52,104,156,2,100
4107,150,54,60,114,2,100
4108,150,36,45,81,2,100
4109,150,75,122,197,2,100
4110,150,91,99,190,2,100
4111,150,107,125,232,2,100
4112,150,39,59,98,2,100
4113,150,12,24,36,2,100
4114,150,8,3,11,2,100
4115,150,38,90,128,2,100
4116,150,106,172,278,2,100
4117,150,117,193,310,2,100
4118,150,116,84,200,2,100
4119,150,85,102,187,2,100
4120,150,21,62,83,2,100
4121,150,22,20,42,2,100
4122,150,45,64,109,2,100
4123,150,53,100,153,2,100
4124,150,27,29,56,2,100
4125,150,20,44,64,2,100
4126,150,52,105,157,2,100
4127,150,60,136,196,2,100
4128,150,32,65,97,2,100
4129,150,41,42,83,2,100
4130,150,35,48,83,2,100
4131,150,49,49,98,2,100
4132,150,93,161,254,2,100
4133,150,31,48,79,2,100
4134,150,39,99,138,2,100
4135,150,115,170,285,2,100
4136,150,11,172,183,2,100
4137,150,40,18,58,2,100
4138,150,61,58,119,2,100
4139,150,56,89,145,2,100
4140,150,91,84,175,2,100
4141,150,54,93,147,2,100
4142,150,39,36,75,2,100
4143,150,41,54,95,2,100
4144,150,70,108,178,2,100
4145,150,63,74,137,2,100
4146,150,30,79,109,2,100
4147,150,40,33,73,2,100
4148,150,21,24,45,2,100
4149,150,94,172,266,2,100
4150,150,36,34,70,2,100
4151,150,133,156,289,2,100
4152,150,79,113,192,2,100
4153,150,121,107,228,2,100
4154,150,52,82,134,2,100
4155,150,48,69,117,2,100
4156,150,67,77,144,2,100
4157,150,42,76,118,2,100
4158,150,148,250,398,2,100
4159,150,43,63,106,2,100
4160,150,113,140,253,2,100
4161,150,34,53,87,2,100
4162,150,46,140,186,2,100
4163,150,41,83,124,2,100
4164,150,23,18,41,2,100
4165,150,43,97,140,2,100
4166,150,51,92,143,2,100
4167,150,19,25,44,2,100
4168,150,63,98,161,2,100
4169,150,86,148,234,2,100
4170,150,54,91,145,2,100
4171,150,47,74,121,2,100
4172,150,12,27,39,2,100
4173,150,20,46,66,2,100
4174,150,32,53,85,2,100
4175,150,30,38,68,2,100
4176,150,7,22,29,2,100
4177,150,61,106,167,2,100
4178,150,93,194,287,2,100
4179,150,52,46,98,2,100
4180,150,51,48,99,2,100
4181,150,66,72,138,2,100
4182,150,132,140,272,2,100
4183,150,138,218,356,2,100
4184,150,65,178,243,2,100
4185,150,84,143,227,2,100
4186,150,240,261,501,2,100
4187,150,82,115,197,2,100
4188,150,33,50,83,2,100
4189,150,3,11,14,2,100
4190,150,46,62,108,2,100
4191,150,270,242,512,2,100
4192,150,100,101,201,2,100
4193,150,80,100,180,2,100
4194,150,62,66,128,2,100
4195,150,85,77,162,2,100
4196,150,42,52,94,2,100
4197,150,111,73,184,2,100
4198,150,68,91,159,2,100
4199,150,15,8,23,2,100
4200,150,117,134,251,2,100
4201,150,21,47,68,2,100
4202,150,142,258,400,2,100
4203,150,83,134,217,2,100
4204,150,53,51,104,2,100
4205,150,167,301,468,2,100
4206,150,144,235,379,2,100
4207,150,34,57,91,2,100
4208,150,46,86,132,2,100
4209,150,85,156,241,2,100
4210,150,76,111,187,2,100
4211,150,82,24,106,2,100
4212,150,17,18,35,2,100
4213,150,66,185,251,2,100
4214,150,14,15,29,2,100
4215,150,120,231,351,2,100
4216,150,66,140,206,2,100
4217,150,105,127,232,2,100
4218,150,82,162,244,2,100
4219,150,66,103,169,2,100
4220,150,34,93,127,2,100
4221,150,23,17,40,2,100
4222,150,107,189,296,2,100
4223,150,54,53,107,2,100
4224,150,58,124,182,2,100
4225,150,36,21,57,2,100
4226,150,46,87,133,2,100
4227,150,16,24,40,2,100
4228,150,42,93,135,2,100
4229,150,55,74,129,2,100
4230,150,141,136,277,2,100
4231,150,88,121,209,2,100
4232,150,153,258,411,2,100
4233,150,23,48,71,2,100
4234,150,84,129,213,2,100
4235,150,54,127,181,2,100
4236,150,25,65,90,2,100
4237,150,21,2,23,2,100
4238,150,203,278,481,2,100
4239,150,113,186,299,2,100
4240,150,170,169,339,2,100
4241,150,213,312,525,2,100
4242,150,78,165,243,2,100
4243,150,191,325,516,2,100
4244,150,72,156,228,2,100
4245,150,51,108,159,2,100
4246,150,33,83,116,2,100
4247,180,46,57,103,2,100
4248,180,43,60,103,2,100
4249,180,45,12,57,2,100
4250,180,63,86,149,2,100
4251,180,27,45,72,2,100
4252,180,66,103,169,2,100
4253,180,75,148,223,2,100
4254,180,55,85,140,2,100
4255,180,100,90,190,2,100
4256,180,39,64,103,2,100
4257,180,56,124,180,2,100
4258,180,25,36,61,2,100
4259,180,67,73,140,2,100
4260,180,59,98,157,2,100
4261,180,59,68,127,2,100
4262,180,103,163,266,2,100
4263,180,45,144,189,2,100
4264,180,243,240,483,2,100
4265,180,47,90,137,2,100
4266,180,49,63,112,2,100
4267,180,78,159,237,2,100
4268,180,30,38,68,2,100
4269,180,37,57,94,2,100
4270,180,86,130,216,2,100
4271,180,39,68,107,2,100
4272,180,41,40,81,2,100
4273,180,20,8,28,2,100
4274,180,45,43,88,2,100
4275,180,2,3,5,2,100
4276,180,72,93,165,2,100
4277,180,125,199,324,2,100
4278,180,14,27,41,2,100
4279,180,81,196,277,2,100
4280,180,28,49,77,2,100
4281,180,58,108,166,2,100
4282,180,55,97,152,2,100
4283,180,105,144,249,2,100
4284,180,29,86,115,2,100
4285,180,34,48,82,2,100
4286,180,8,14,22,2,100
4287,180,20,76,96,2,100
4288,180,94,150,244,2,100
4289,180,58,101,159,2,100
4290,180,46,90,136,2,100
4291,180,114,148,262,2,100
4292,180,62,109,171,2,100
4293,180,40,42,82,2,100
4294,180,97,147,244,2,100
4295,180,69,84,153,2,100
4296,180,53,101,154,2,100
4297,180,42,161,203,2,100
4298,180,30,40,70,2,100
4299,180,47,68,115,2,100
4300,180,118,216,334,2,100
4301,180,27,51,78,2,100
4302,180,18,87,105,2,100
4303,180,50,94,144,2,100
4304,180,86,70,156,2,100
4305,180,180,262,442,2,100
4306,180,84,107,191,2,100
4307,180,89,143,232,2,100
4308,180,24,102,126,2,100
4309,180,63,86,149,2,100
4310,180,54,217,271,2,100
4311,180,108,189,297,2,100
4312,180,40,73,113,2,100
4313,180,27,154,181,2,100
4314,180,75,181,256,2,100
4315,180,133,200,333,2,100
4316,180,43,40,83,2,100
4317,180,27,41,68,2,100
4318,180,179,274,453,2,100
4319,180,144,338,482,2,100
4320,180,63,76,139,2,100
4321,180,62,104,166,2,100
4322,180,167,326,493,2,100
4323,180,30,49,79,2,100
4324,180,168,194,362,2,100
4325,180,92,122,214,2,100
4326,180,76,114,190,2,100
4327,180,74,57,131,2,100
4328,180,99,156,255,2,100
4329,180,63,71,134,2,100
4330,180,94,157,251,2,100
4331,180,259,356,615,2,100
4332,180,80,85,165,2,100
4333,180,47,111,158,2,100
4334,180,50,119,169,2,100
4335,180,83,98,181,2,100
4336,180,50,78,128,2,100
4337,180,37,64,101,2,100
4338,180,85,80,165,2,100
4339,180,8,16,24,2,100
4340,180,45,69,114,2,100
4341,180,22,40,62,2,100
4342,180,41,63,104,2,100
4343,180,20,40,60,2,100
4344,180,32,46,78,2,100
4345,180,107,173,280,2,100
4346,180,111,185,296,2,100
4347,180,113,124,237,2,100
4348,180,82,148,230,2,100
4349,180,25,61,86,2,100
4350,180,98,207,305,2,100
4351,180,52,69,121,2,100
4352,180,71,52,123,2,100
4353,180,126,139,265,2,100
4354,180,84,199,283,2,100
4355,180,37,55,92,2,100
4356,180,36,41,77,2,100
4357,180,64,155,219,2,100
4358,180,28,72,100,2,100
4359,180,65,99,164,2,100
4360,180,97,86,183,2,100
4361,180,50,69,119,2,100
4362,180,101,126,227,2,100
4363,180,53,65,118,2,100
4364,180,56,104,160,2,100
4365,180,128,264,392,2,100
4366,180,80,127,207,2,100
4367,180,35,28,63,2,100
4368,180,52,49,101,2,100
4369,180,22,62,84,2,100
4370,180,11,15,26,2,100
4371,180,0,9,9,2,100
4372,180,186,226,412,2,100
4373,180,91,197,288,2,100
4374,180,69,100,169,2,100
4375,180,123,192,315,2,100
4376,180,106,226,332,2,100
4377,180,81,97,178,2,100
4378,180,56,88,144,2,100
4379,180,30,50,80,2,100
4380,180,17,40,57,2,100
4381,180,59,179,238,2,100
4382,180,140,194,334,2,100
4383,180,49,39,88,2,100
4384,180,61,66,127,2,100
4385,180,120,181,301,2,100
4386,180,58,34,92,2,100
4387,180,183,250,433,2,100
4388,180,44,85,129,2,100
4389,180,130,176,306,2,100
4390,180,103,204,307,2,100
4391,180,51,112,163,2,100
4392,180,45,53,98,2,100
4393,180,60,104,164,2,100
4394,180,57,61,118,2,100
4395,180,122,122,244,2,100
4396,180,13,34,47,2,100
4397,180,50,111,161,2,100
4398,180,49,128,177,2,100
4399,180,176,328,504,2,100
4400,180,164,306,470,2,100
4401,180,112,114,226,2,100
4402,180,86,135,221,2,100
4403,180,133,182,315,2,100
4404,180,35,58,93,2,100
4405,180,29,53,82,2,100
4406,180,124,77,201,2,100
4407,180,50,99,149,2,100
4408,180,108,143,251,2,100
4409,180,87,116,203,2,100
4410,180,63,78,141,2,100
4411,180,69,167,236,2,100
4412,180,91,141,232,2,100
4413,180,76,76,152,2,100
4414,180,80,127,207,2,100
4415,180,36,82,118,2,100
4416,180,46,163,209,2,100
4417,180,68,158,226,2,100
4418,180,52,79,131,2,100
4419,180,70,86,156,2,100
4420,180,62,167,229,2,100
4421,180,69,74,143,2,100
4422,180,38,95,133,2,100
4423,180,98,253,351,2,100
4424,180,121,250,371,2,100
4425,180,30,30,60,2,100
4426,180,73,182,255,2,100
4427,180,29,34,63,2,100
4428,180,74,88,162,2,100
4429,180,69,83,152,2,100
4430,180,74,95,169,2,100
4431,180,98,116,214,2,100
4432,180,57,88,145,2,100
4433,180,41,56,97,2,100
4434,180,70,203,273,2,100
4435,180,87,88,175,2,100
4436,180,80,133,213,2,100
4437,180,33,78,111,2,100
4438,180,41,38,79,2,100
4439,180,86,150,236,2,100
4440,180,19,44,63,2,100
4441,180,99,85,184,2,100
4442,180,95,174,269,2,100
4443,180,48,97,145,2,100
4444,180,49,78,127,2,100
4445,180,22,21,43,2,100
4446,180,41,87,128,2,100
4447,180,84,147,231,2,100
4448,180,87,154,241,2,100
4449,180,32,66,98,2,100
4450,180,26,28,54,2,100
4451,180,12,32,44,2,100
4452,180,66,149,215,2,100
4453,180,24,30,54,2,100
4454,180,8,18,26,2,100
4455,180,8,6,14,2,100
4456,180,91,98,189,2,100
4457,180,18,36,54,2,100
4458,180,7,21,28,2,100
4459,180,24,39,63,2,100
4460,180,131,73,204,2,100
4461,180,82,100,182,2,100
4462,180,57,117,174,2,100
4463,180,24,61,85,2,100
4464,180,43,103,146,2,100
4465,180,25,47,72,2,100
4466,180,11,20,31,2,100
4467,180,42,76,118,2,100
4468,180,52,65,117,2,100
4469,180,67,94,161,2,100
4470,180,18,55,73,2,100
4471,180,54,64,118,2,100
4472,180,19,25,44,2,100
4473,180,6,7,13,2,100
4474,180,30,33,63,2,100
4475,180,24,41,65,2,100
4476,180,25,21,46,2,100
4477,180,42,89,131,2,100
4478,180,15,39,54,2,100
4479,180,66,117,183,2,100
4480,180,14,27,41,2,100
4481,180,31,74,105,2,100
4482,180,58,119,177,2,100
4483,180,35,57,92,2,100
4484,180,49,58,107,2,100
4485,180,72,88,160,2,100
4486,180,32,25,57,2,100
4487,180,10,31,41,2,100
4488,180,67,86,153,2,100
4489,180,12,21,33,2,100
4490,180,57,107,164,2,100
4491,180,78,122,200,2,100
4492,180,74,143,217,2,100
4493,180,85,110,195,2,100
4494,180,44,69,113,2,100
4495,180,59,100,159,2,100
4496,180,27,45,72,2,100
4497,180,36,31,67,2,100
4498,180,1,7,8,2,100
4499,180,88,118,206,2,100
4500,180,22,34,56,2,100
4501,180,38,76,114,2,100
4502,180,54,73,127,2,100
4503,180,46,54,100,2,100
4504,180,86,154,240,2,100
4505,180,122,188,310,2,100
4506,180,120,142,262,2,100
4507,180,49,179,228,2,100
4508,180,111,141,252,2,100
4509,180,47,70,117,2,100
4510,180,29,58,87,2,100
4511,180,142,125,267,2,100
4512,180,14,30,44,2,100
4513,180,167,187,354,2,100
4514,180,77,161,238,2,100
4515,180,105,149,254,2,100
4516,180,84,100,184,2,100
4517,180,33,68,101,2,100
4518,180,117,190,307,2,100
4519,180,112,127,239,2,100
4520,180,20,22,42,2,100
4521,180,111,220,331,2,100
4522,180,34,52,86,2,100
4523,180,18,30,48,2,100
4524,180,45,49,94,2,100
4525,180,75,76,151,2,100
4526,180,18,33,51,2,100
4527,180,59,114,173,2,100
4528,180,164,245,409,2,100
4529,180,74,131,205,2,100
4530,180,51,79,130,2,100
4531,180,172,235,407,2,100
4532,180,61,130,191,2,100
4533,180,117,251,368,2,100
4534,180,72,126,198,2,100
4535,180,57,79,136,2,100
4536,180,83,133,216,2,100
4537,180,118,226,344,2,100
4538,180,80,143,223,2,100
4539,180,139,198,337,2,100
4540,180,17,19,36,2,100
4541,180,2,8,10,2,100
4542,180,13,50,63,2,100
4543,180,12,47,59,2,100
4544,180,54,78,132,2,100
4545,180,55,83,138,2,100
4546,180,84,108,192,2,100
4547,180,69,114,183,2,100
4548,180,75,142,217,2,100
4549,180,40,64,104,2,100
4550,180,107,99,206,2,100
4551,180,142,171,313,2,100
4552,180,46,47,93,2,100
4553,180,46,40,86,2,100
4554,180,128,103,231,2,100
4555,180,19,30,49,2,100
4556,180,9,22,31,2,100
4557,180,3,14,17,2,100
4558,180,96,359,455,2,100
4559,180,41,176,217,2,100
4560,180,74,177,251,2,100
4561,180,97,163,260,2,100
4562,180,67,114,181,2,100
4563,180,92,163,255,2,100
4564,180,50,75,125,2,100
4565,180,42,54,96,2,100
4566,180,143,163,306,2,100
4567,180,25,56,81,2,100
4568,180,52,104,156,2,100
4569,180,85,187,272,2,100
4570,180,54,136,190,2,100
4571,180,87,126,213,2,100
4572,180,133,220,353,2,100
4573,180,42,113,155,2,100
4574,180,80,114,194,2,100
4575,180,95,197,292,2,100
4576,180,50,132,182,2,100
4577,180,123,201,324,2,100
4578,180,61,106,167,2,100
4579,180,86,150,236,2,100
4580,180,146,184,330,2,100
4581,180,41,45,86,2,100
4582,180,79,94,173,2,100
4583,180,57,71,128,2,100
4584,180,69,89,158,2,100
4585,180,73,119,192,2,100
4586,180,24,29,53,2,100
4587,180,99,138,237,2,100
4588,180,68,116,184,2,100
4589,180,73,126,199,2,100
4590,180,103,122,225,2,100
4591,180,52,96,148,2,100
4592,180,41,65,106,2,100
4593,180,12,13,25,2,100
4594,180,65,28,93,2,100
4595,180,33,81,114,2,100
4596,180,61,120,181,2,100
4597,180,110,172,282,2,100
4598,180,46,145,191,2,100
4599,180,160,293,453,2,100
4600,180,54,117,171,2,100
4601,180,90,99,189,2,100
4602,180,63,22,85,2,100
4603,180,50,101,151,2,100
4604,180,197,306,503,2,100
4605,180,18,62,80,2,100
4606,180,99,154,253,2,100
4607,180,87,140,227,2,100
4608,180,29,41,70,2,100
4609,180,65,77,142,2,100
4610,180,61,123,184,2,100
4611,180,53,112,165,2,100
4612,180,67,93,160,2,100
4613,180,55,85,140,2,100
4614,180,99,166,265,2,100
4615,180,42,59,101,2,100
4616,180,44,72,116,2,100
4617,180,193,284,477,2,100
4618,180,40,96,136,2,100
4619,180,58,107,165,2,100
4620,180,67,124,191,2,100
4621,180,34,69,103,2,100
4622,180,14,59,73,2,100
4623,180,10,39,49,2,100
4624,180,87,87,174,2,100
4625,180,59,74,133,2,100
4626,180,143,219,362,2,100
4627,180,126,192,318,2,100
4628,180,197,311,508,2,100
4629,180,105,133,238,2,100
4630,180,55,110,165,2,100
4631,180,47,87,134,2,100
4632,180,54,88,142,2,100
4633,180,110,172,282,2,100
4634,180,28,63,91,2,100
4635,180,83,156,239,2,100
4636,180,54,112,166,2,100
4637,180,87,134,221,2,100
4638,180,109,193,302,2,100
4639,180,66,104,170,2,100
4640,180,97,122,219,2,100
4641,180,104,188,292,2,100
4642,180,33,46,79,2,100
4643,180,54,58,112,2,100
4644,180,26,61,87,2,100
4645,180,31,48,79,2,100
4646,180,38,30,68,2,100
4647,180,18,10,28,2,100
0,0,23,99,122,3,0
1,0,12,7,19,3,0
2,0,9,26,35,3,0
3,0,22,121,143,3,0
4,0,12,25,37,3,0
5,0,18,29,47,3,0
6,0,37,152,189,3,0
7,0,7,16,23,3,0
8,0,14,53,67,3,0
9,0,29,120,149,3,0
10,0,22,46,68,3,0
11,0,13,40,53,3,0
12,0,24,42,66,3,0
13,0,25,69,94,3,0
14,0,20,16,36,3,0
15,0,8,12,20,3,0
16,0,18,60,78,3,0
17,0,13,29,42,3,0
18,0,22,31,53,3,0
19,0,63,91,154,3,0
20,0,42,70,112,3,0
21,0,90,144,234,3,0
22,0,10,29,39,3,0
23,0,45,68,113,3,0
24,0,28,85,113,3,0
25,0,10,87,97,3,0
26,0,20,44,64,3,0
27,0,28,124,152,3,0
28,0,10,6,16,3,0
29,0,33,24,57,3,0
30,0,24,46,70,3,0
31,0,3,25,28,3,0
32,0,16,24,40,3,0
33,0,16,33,49,3,0
34,0,11,17,28,3,0
35,0,2,12,14,3,0
36,0,1,18,19,3,0
37,0,3,7,10,3,0
38,0,22,43,65,3,0
39,0,7,27,34,3,0
40,0,48,144,192,3,0
41,0,42,61,103,3,0
42,0,27,45,72,3,0
43,0,3,5,8,3,0
44,0,0,4,4,3,0
45,0,1,10,11,3,0
46,0,39,79,118,3,0
47,0,34,80,114,3,0
48,0,23,40,63,3,0
49,0,41,146,187,3,0
50,0,55,111,166,3,0
51,0,41,24,65,3,0
52,0,16,3,19,3,0
53,0,48,94,142,3,0
54,0,20,54,74,3,0
55,0,26,40,66,3,0
56,0,11,8,19,3,0
57,0,8,18,26,3,0
58,0,19,62,81,3,0
59,0,9,46,55,3,0
60,0,4,9,13,3,0
61,0,10,23,33,3,0
62,0,9,11,20,3,0
63,0,4,3,7,3,0
64,0,47,74,121,3,0
65,0,8,25,33,3,0
66,0,25,26,51,3,0
67,0,20,58,78,3,0
68,0,45,65,110,3,0
69,0,38,116,154,3,0
70,0,54,80,134,3,0
71,0,19,36,55,3,0
72,0,30,112,142,3,0
73,0,15,23,38,3,0
74,0,64,115,179,3,0
75,0,12,13,25,3,0
76,0,37,79,116,3,0
77,0,15,35,50,3,0
78,0,30,47,77,3,0
79,0,36,36,72,3,0
80,0,14,16,30,3,0
81,0,34,53,87,3,0
82,0,0,3,3,3,0
83,0,1,3,4,3,0
84,0,2,15,17,3,0
85,0,44,59,103,3,0
86,0,47,56,103,3,0
87,0,34,71,105,3,0
88,0,76,117,193,3,0
89,0,13,44,57,3,0
90,0,55,119,174,3,0
91,0,25,90,115,3,0
92,0,41,96,137,3,0
93,0,31,79,110,3,0
94,0,41,85,126,3,0
95,0,7,12,19,3,0
96,0,15,32,47,3,0
97,0,8,15,23,3,0
98,0,41,77,118,3,0
99,0,15,22,37,3,0
100,0,1,8,9,3,0
101,0,3,6,9,3,0
102,0,11,24,35,3,0
103,0,53,53,106,3,0
104,0,11,37,48,3,0
105,0,110,203,313,3,0
106,0,28,47,75,3,0
107,0,17,118,135,3,0
108,0,73,216,289,3,0
109,0,48,140,188,3,0
110,0,8,43,51,3,0
111,0,37,90,127,3,0
112,0,16,18,34,3,0
113,0,11,40,51,3,0
114,0,30,49,79,3,0
115,0,7,16,23,3,0
116,0,32,50,82,3,0
117,0,15,48,63,3,0
118,0,26,78,104,3,0
119,0,25,47,72,3,0
120,0,85,119,204,3,0
121,0,38,57,95,3,0
122,0,65,133,198,3,0
123,0,24,74,98,3,0
124,0,26,42,68,3,0
125,0,39,101,140,3,0
126,0,45,113,158,3,0
127,0,29,83,112,3,0
128,0,20,15,35,3,0
129,0,39,66,105,3,0
130,0,55,101,156,3,0
131,0,7,31,38,3,0
132,0,6,22,28,3,0
133,0,3,32,35,3,0
134,0,11,35,46,3,0
135,0,63,101,164,3,0
136,0,5,8,13,3,0
137,0,116,167,283,3,0
138,0,12,37,49,3,0
139,0,32,142,174,3,0
140,0,43,90,133,3,0
141,0,13,69,82,3,0
142,0,52,118,170,3,0
143,0,5,9,14,3,0
144,0,23,31,54,3,0
145,0,15,53,68,3,0
146,0,18,49,67,3,0
147,0,13,21,34,3,0
148,0,0,4,4,3,0
149,0,2,12,14,3,0
150,0,3,9,12,3,0
151,0,18,91,109,3,0
152,0,13,41,54,3,0
153,0,46,95,141,3,0
154,0,29,104,133,3,0
155,0,67,151,218,3,0
156,0,35,23,58,3,0
157,0,24,67,91,3,0
158,0,2,5,7,3,0
159,0,16,16,32,3,0
160,0,14,65,79,3,0
161,0,9,4,13,3,0
162,0,9,33,42,3,0
163,0,13,24,37,3,0
164,0,12,17,29,3,0
165,0,6,11,17,3,0
166,0,13,28,41,3,0
167,0,24,71,95,3,0
168,0,16,25,41,3,0
169,0,5,9,14,3,0
170,0,31,48,79,3,0
171,0,44,93,137,3,0
172,0,29,45,74,3,0
173,0,24,67,91,3,0
174,0,14,24,38,3,0
175,0,34,51,85,3,0
176,0,21,38,59,3,0
177,0,37,84,121,3,0
178,0,27,44,71,3,0
179,0,3,2,5,3,0
180,0,6,14,20,3,0
181,0,37,56,93,3,0
182,0,19,31,50,3,0
183,0,5,9,14,3,0
184,0,7,6,13,3,0
185,0,19,52,71,3,0
186,0,12,42,54,3,0
187,0,23,72,95,3,0
188,0,13,20,33,3,0
189,0,15,46,61,3,0
190,0,20,44,64,3,0
191,0,13,31,44,3,0
192,0,19,37,56,3,0
193,0,16,27,43,3,0
194,0,22,41,63,3,0
195,0,15,31,46,3,0
196,0,5,8,13,3,0
197,0,9,23,32,3,0
198,0,7,9,16,3,0
199,0,8,10,18,3,0
200,0,15,37,52,3,0
201,0,44,33,77,3,0
202,0,12,48,60,3,0
203,0,14,47,61,3,0
204,0,5,12,17,3,0
205,0,43,87,130,3,0
206,0,6,27,33,3,0
207,0,46,74,120,3,0
208,0,24,91,115,3,0
209,0,22,45,67,3,0
210,0,4,9,13,3,0
211,0,9,17,26,3,0
212,0,3,21,24,3,0
213,0,0,0,0,3,0
214,0,15,12,27,3,0
215,0,5,12,17,3,0
216,0,10,36,46,3,0
217,0,6,15,21,3,0
218,0,17,54,71,3,0
219,0,3,26,29,3,0
220,0,17,28,45,3,0
221,0,14,30,44,3,0
222,0,24,75,99,3,0
223,0,17,18,35,3,0
224,0,13,25,38,3,0
225,0,19,41,60,3,0
226,0,30,99,129,3,0
227,0,21,32,53,3,0
228,0,8,39,47,3,0
229,0,6,7,13,3,0
230,0,49,146,195,3,0
231,0,42,66,108,3,0
232,0,29,66,95,3,0
233,0,22,63,85,3,0
234,0,1,3,4,3,0
235,0,37,107,144,3,0
236,0,7,26,33,3,0
237,0,85,166,251,3,0
238,0,6,14,20,3,0
239,0,5,23,28,3,0
240,0,8,31,39,3,0
241,0,4,9,13,3,0
242,0,6,13,19,3,0
243,0,2,12,14,3,0
244,0,30,86,116,3,0
245,0,15,18,33,3,0
246,0,8,35,43,3,0
247,0,54,91,145,3,0
248,0,17,50,67,3,0
249,0,35,93,128,3,0
250,0,20,46,66,3,0
251,0,28,109,137,3,0
252,0,22,77,99,3,0
253,0,11,27,38,3,0
254,0,6,8,14,3,0
255,0,12,28,40,3,0
256,0,23,63,86,3,0
257,0,13,19,32,3,0
258,0,12,26,38,3,0
259,0,13,28,41,3,0
260,0,5,15,20,3,0
261,0,7,14,21,3,0
262,0,10,9,19,3,0
263,0,9,19,28,3,0
264,0,31,67,98,3,0
265,0,24,47,71,3,0
266,0,20,32,52,3,0
267,0,22,92,114,3,0
268,0,64,96,160,3,0
269,0,46,93,139,3,0
270,0,6,7,13,3,0
271,0,21,49,70,3,0
272,0,34,89,123,3,0
273,0,36,57,93,3,0
274,0,23,15,38,3,0
275,0,31,44,75,3,0
276,0,26,92,118,3,0
277,0,14,33,47,3,0
278,0,6,8,14,3,0
279,0,50,52,102,3,0
280,0,17,15,32,3,0
281,0,10,16,26,3,0
282,0,15,41,56,3,0
283,0,32,71,103,3,0
284,0,45,35,80,3,0
285,0,19,22,41,3,0
286,0,32,44,76,3,0
287,0,12,32,44,3,0
288,0,71,71,142,3,0
289,0,15,22,37,3,0
290,0,35,34,69,3,0
291,0,40,49,89,3,0
292,0,20,34,54,3,0
293,0,30,43,73,3,0
294,0,14,32,46,3,0
295,0,12,27,39,3,0
296,0,17,14,31,3,0
297,0,2,5,7,3,0
298,0,50,108,158,3,0
299,0,38,66,104,3,0
300,0,18,41,59,3,0
301,0,42,95,137,3,0
302,0,15,20,35,3,0
303,0,85,148,233,3,0
304,0,23,59,82,3,0
305,0,17,44,61,3,0
306,0,26,61,87,3,0
307,0,10,16,26,3,0
308,0,9,36,45,3,0
309,0,19,40,59,3,0
310,0,32,71,103,3,0
311,0,16,29,45,3,0
312,0,12,14,26,3,0
313,0,12,41,53,3,0
314,0,26,104,130,3,0
315,0,6,11,17,3,0
316,0,20,34,54,3,0
317,0,4,8,12,3,0
318,0,13,40,53,3,0
319,0,14,31,45,3,0
320,0,43,70,113,3,0
321,0,18,50,68,3,0
322,0,19,64,83,3,0
323,0,20,118,138,3,0
324,0,1,10,11,3,0
325,0,29,60,89,3,0
326,0,15,27,42,3,0
327,0,36,85,121,3,0
328,0,1,22,23,3,0
329,0,1,6,7,3,0
330,0,32,79,111,3,0
331,0,42,85,127,3,0
332,0,47,51,98,3,0
333,0,8,30,38,3,0
334,0,43,77,120,3,0
335,0,6,28,34,3,0
336,0,47,74,121,3,0
337,0,8,20,28,3,0
338,0,28,37,65,3,0
339,0,61,129,190,3,0
340,0,47,59,106,3,0
341,0,22,29,51,3,0
342,0,11,17,28,3,0
343,0,12,18,30,3,0
344,0,13,11,24,3,0
345,0,30,77,107,3,0
346,0,23,8,31,3,0
347,0,2,18,20,3,0
348,0,18,35,53,3,0
349,0,21,39,60,3,0
350,0,14,40,54,3,0
351,0,30,55,85,3,0
352,0,71,131,202,3,0
353,0,21,40,61,3,0
354,0,41,71,112,3,0
355,0,17,70,87,3,0
356,0,20,57,77,3,0
357,0,10,26,36,3,0
358,0,20,44,64,3,0
359,0,23,41,64,3,0
360,0,3,21,24,3,0
361,0,1,2,3,3,0
362,0,7,19,26,3,0
363,0,44,48,92,3,0
364,0,3,13,16,3,0
365,0,7,37,44,3,0
366,0,16,29,45,3,0
367,0,12,11,23,3,0
368,0,31,80,111,3,0
369,0,11,44,55,3,0
370,0,42,110,152,3,0
371,0,42,91,133,3,0
372,0,30,97,127,3,0
373,0,58,100,158,3,0
374,0,19,52,71,3,0
375,0,10,10,20,3,0
376,0,25,75,100,3,0
377,0,5,4,9,3,0
378,0,19,37,56,3,0
379,0,7,11,18,3,0
380,0,2,20,22,3,0
381,0,7,7,14,3,0
382,0,6,10,16,3,0
383,0,27,68,95,3,0
384,0,31,41,72,3,0
385,0,8,40,48,3,0
386,0,6,26,32,3,0
387,0,44,84,128,3,0
388,0,42,105,147,3,0
389,0,46,80,126,3,0
390,0,22,44,66,3,0
391,0,57,106,163,3,0
392,0,23,39,62,3,0
393,0,12,17,29,3,0
394,0,16,72,88,3,0
395,0,8,23,31,3,0
396,0,33,49,82,3,0
397,0,7,25,32,3,0
398,0,3,6,9,3,0
399,0,18,34,52,3,0
400,0,26,45,71,3,0
401,0,8,27,35,3,0
402,0,5,28,33,3,0
403,0,23,43,66,3,0
404,0,28,43,71,3,0
405,0,11,31,42,3,0
406,0,19,41,60,3,0
407,0,23,37,60,3,0
408,0,47,50,97,3,0
409,0,25,81,106,3,0
410,0,7,21,28,3,0
411,0,5,4,9,3,0
412,0,10,6,16,3,0
413,0,12,14,26,3,0
414,0,17,6,23,3,0
415,0,0,0,0,3,0
416,0,19,81,100,3,0
417,0,7,21,28,3,0
418,0,21,63,84,3,0
419,0,22,80,102,3,0
420,0,3,17,20,3,0
421,0,21,39,60,3,0
422,0,35,40,75,3,0
423,0,5,22,27,3,0
424,0,55,101,156,3,0
425,0,22,25,47,3,0
426,0,58,78,136,3,0
427,0,3,13,16,3,0
428,0,3,19,22,3,0
429,0,7,20,27,3,0
430,0,1,20,21,3,0
431,0,21,14,35,3,0
432,0,43,55,98,3,0
433,0,22,35,57,3,0
434,0,16,24,40,3,0
435,0,11,42,53,3,0
436,0,35,80,115,3,0
437,0,27,57,84,3,0
438,0,12,25,37,3,0
439,0,28,52,80,3,0
440,0,17,33,50,3,0
441,0,13,16,29,3,0
442,0,12,17,29,3,0
443,0,7,7,14,3,0
444,0,25,31,56,3,0
445,0,4,9,13,3,0
446,0,10,20,30,3,0
447,0,39,93,132,3,0
448,0,21,68,89,3,0
449,0,17,27,44,3,0
450,0,9,24,33,3,0
451,0,35,104,139,3,0
452,0,17,68,85,3,0
453,0,9,19,28,3,0
454,0,23,63,86,3,0
455,0,15,23,38,3,0
456,0,15,31,46,3,0
457,0,0,13,13,3,0
458,0,8,27,35,3,0
459,0,25,45,70,3,0
460,0,16,47,63,3,0
461,0,7,22,29,3,0
462,0,7,9,16,3,0
463,0,32,52,84,3,0
464,0,19,52,71,3,0
465,0,70,80,150,3,0
466,0,44,72,116,3,0
467,0,43,99,142,3,0
468,0,4,8,12,3,0
469,0,8,16,24,3,0
470,0,28,71,99,3,0
471,0,38,57,95,3,0
472,0,15,27,42,3,0
473,0,30,29,59,3,0
474,0,19,50,69,3,0
475,0,14,34,48,3,0
476,0,11,35,46,3,0
477,0,31,22,53,3,0
478,0,39,55,94,3,0
479,0,4,11,15,3,0
480,0,23,36,59,3,0
481,0,5,15,20,3,0
482,0,35,65,100,3,0
483,0,11,36,47,3,0
484,0,39,54,93,3,0
485,0,18,30,48,3,0
486,0,13,17,30,3,0
487,0,11,27,38,3,0
488,0,27,27,54,3,0
489,0,3,19,22,3,0
490,0,9,20,29,3,0
491,0,11,29,40,3,0
492,0,12,10,22,3,0
493,0,4,20,24,3,0
494,10,32,41,73,3,100
495,10,11,4,15,3,100
496,10,25,57,82,3,100
497,10,20,22,42,3,100
498,10,39,47,86,3,100
499,10,8,58,66,3,100
500,10,26,44,70,3,100
501,10,51,62,113,3,100
502,10,31,67,98,3,100
503,10,25,23,48,3,100
504,10,12,14,26,3,100
505,10,27,50,77,3,100
506,10,19,62,81,3,100
507,10,21,46,67,3,100
508,10,41,39,80,3,100
509,10,56,123,179,3,100
510,10,44,67,111,3,100
511,10,17,12,29,3,100
512,10,40,88,128,3,100
513,10,24,43,67,3,100
514,10,27,36,63,3,100
515,10,15,27,42,3,100
516,10,11,16,27,3,100
517,10,37,54,91,3,100
518,10,34,40,74,3,100
519,10,59,77,136,3,100
520,10,19,22,41,3,100
521,10,65,131,196,3,100
522,10,42,41,83,3,100
523,10,28,44,72,3,100
524,10,54,72,126,3,100
525,10,31,27,58,3,100
526,10,12,12,24,3,100
527,10,7,11,18,3,100
528,10,8,10,18,3,100
529,10,34,71,105,3,100
530,10,97,140,237,3,100
531,10,15,36,51,3,100
532,10,28,79,107,3,100
533,10,41,89,130,3,100
534,10,37,75,112,3,100
535,10,37,99,136,3,100
536,10,45,100,145,3,100
537,10,3,21,24,3,100
538,10,24,57,81,3,100
539,10,38,72,110,3,100
540,10,20,34,54,3,100
541,10,34,36,70,3,100
542,10,16,23,39,3,100
543,10,9,33,42,3,100
544,10,22,32,54,3,100
545,10,10,35,45,3,100
546,10,14,34,48,3,100
547,10,10,28,38,3,100
548,10,16,21,37,3,100
549,10,10,33,43,3,100
550,10,39,63,102,3,100
551,10,18,27,45,3,100
552,10,9,22,31,3,100
553,10,11,14,25,3,100
554,10,21,27,48,3,100
555,10,4,24,28,3,100
556,10,26,33,59,3,100
557,10,18,19,37,3,100
558,10,15,23,38,3,100
559,10,50,129,179,3,100
560,10,19,37,56,3,100
561,10,34,60,94,3,100
562,10,50,41,91,3,100
563,10,17,36,53,3,100
564,10,4,6,10,3,100
565,10,27,37,64,3,100
566,10,71,75,146,3,100
567,10,22,63,85,3,100
568,10,37,43,80,3,100
569,10,22,35,57,3,100
570,10,10,23,33,3,100
571,10,21,43,64,3,100
572,10,15,55,70,3,100
573,10,41,49,90,3,100
574,10,36,80,116,3,100
575,10,64,76,140,3,100
576,10,27,77,104,3,100
577,10,22,39,61,3,100
578,10,23,33,56,3,100
579,10,5,10,15,3,100
580,10,19,26,45,3,100
581,10,28,46,74,3,100
582,10,11,22,33,3,100
583,10,10,13,23,3,100
584,10,15,34,49,3,100
585,10,31,50,81,3,100
586,10,57,120,177,3,100
587,10,21,51,72,3,100
588,10,31,81,112,3,100
589,10,43,77,120,3,100
590,10,19,17,36,3,100
591,10,20,22,42,3,100
592,10,27,38,65,3,100
593,10,6,8,14,3,100
594,10,37,80,117,3,100
595,10,9,15,24,3,100
596,10,37,89,126,3,100
597,10,14,48,62,3,100
598,10,27,43,70,3,100
599,10,24,75,99,3,100
600,10,41,87,128,3,100
601,10,25,84,109,3,100
602,10,110,185,295,3,100
603,10,8,34,42,3,100
604,10,23,49,72,3,100
605,10,21,54,75,3,100
606,10,12,11,23,3,100
607,10,18,26,44,3,100
608,10,15,27,42,3,100
609,10,24,34,58,3,100
610,10,27,38,65,3,100
611,10,7,22,29,3,100
612,10,8,27,35,3,100
613,10,3,9,12,3,100
614,10,34,62,96,3,100
615,10,12,26,38,3,100
616,10,19,44,63,3,100
617,10,31,31,62,3,100
618,10,13,14,27,3,100
619,10,13,26,39,3,100
620,10,10,8,18,3,100
621,10,9,30,39,3,100
622,10,14,21,35,3,100
623,10,23,67,90,3,100
624,10,26,32,58,3,100
625,10,53,80,133,3,100
626,10,31,47,78,3,100
627,10,12,12,24,3,100
628,10,40,74,114,3,100
629,10,25,14,39,3,100
630,10,29,49,78,3,100
631,10,14,20,34,3,100
632,10,53,118,171,3,100
633,10,30,71,101,3,100
634,10,8,28,36,3,100
635,10,27,63,90,3,100
636,10,21,42,63,3,100
637,10,6,31,37,3,100
638,10,5,17,22,3,100
639,10,20,31,51,3,100
640,10,13,12,25,3,100
641,10,26,45,71,3,100
642,10,30,35,65,3,100
643,10,27,46,73,3,100
644,10,22,40,62,3,100
645,10,48,68,116,3,100
646,10,15,14,29,3,100
647,10,9,12,21,3,100
648,10,14,13,27,3,100
649,10,12,15,27,3,100
650,10,3,3,6,3,100
651,10,13,21,34,3,100
652,10,8,11,19,3,100
653,10,5,1,6,3,100
654,10,7,15,22,3,100
655,10,1,4,5,3,100
656,10,19,33,52,3,100
657,10,8,14,22,3,100
658,10,16,26,42,3,100
659,10,16,60,76,3,100
660,10,28,74,102,3,100
661,10,31,69,100,3,100
662,10,7,24,31,3,100
663,10,45,64,109,3,100
664,10,144,315,459,3,100
665,10,4,10,14,3,100
666,10,32,56,88,3,100
667,10,5,11,16,3,100
668,10,13,14,27,3,100
669,10,1,20,21,3,100
670,10,3,1,4,3,100
671,10,8,23,31,3,100
672,10,2,27,29,3,100
673,10,13,27,40,3,100
674,10,38,49,87,3,100
675,10,22,49,71,3,100
676,10,3,3,6,3,100
677,10,14,19,33,3,100
678,10,13,53,66,3,100
679,10,2,8,10,3,100
680,10,24,43,67,3,100
681,10,15,38,53,3,100
682,10,10,11,21,3,100
683,10,10,14,24,3,100
684,10,14,27,41,3,100
685,10,7,21,28,3,100
686,10,5,4,9,3,100
687,10,3,15,18,3,100
688,10,12,13,25,3,100
689,10,23,25,48,3,100
690,10,10,17,27,3,100
691,10,7,21,28,3,100
692,10,6,14,20,3,100
693,10,12,18,30,3,100
694,10,15,18,33,3,100
695,10,2,10,12,3,100
696,10,21,34,55,3,100
697,10,7,25,32,3,100
698,10,26,53,79,3,100
699,10,3,22,25,3,100
700,10,3,2,5,3,100
701,10,17,28,45,3,100
702,10,1,8,9,3,100
703,10,12,16,28,3,100
704,10,42,26,68,3,100
705,10,15,19,34,3,100
706,10,32,25,57,3,100
707,10,7,21,28,3,100
708,10,16,47,63,3,100
709,10,20,26,46,3,100
710,10,16,31,47,3,100
711,10,9,15,24,3,100
712,10,6,8,14,3,100
713,10,4,6,10,3,100
714,10,8,23,31,3,100
715,10,1,8,9,3,100
716,10,9,13,22,3,100
717,10,18,28,46,3,100
718,10,0,0,0,3,100
719,10,19,32,51,3,100
720,10,4,13,17,3,100
721,10,41,48,89,3,100
722,10,72,113,185,3,100
723,10,15,25,40,3,100
724,10,41,70,111,3,100
725,10,81,149,230,3,100
726,10,8,27,35,3,100
727,10,26,66,92,3,100
728,10,22,25,47,3,100
729,10,23,37,60,3,100
730,10,16,17,33,3,100
731,10,15,30,45,3,100
732,10,5,11,16,3,100
733,10,15,17,32,3,100
734,10,12,24,36,3,100
735,10,11,37,48,3,100
736,10,21,39,60,3,100
737,10,36,72,108,3,100
738,10,25,42,67,3,100
739,10,15,28,43,3,100
740,10,51,52,103,3,100
741,10,17,32,49,3,100
742,10,24,67,91,3,100
743,10,27,69,96,3,100
744,10,18,37,55,3,100
745,10,6,8,14,3,100
746,10,3,3,6,3,100
747,10,19,10,29,3,100
748,10,1,1,2,3,100
749,10,39,27,66,3,100
750,10,29,77,106,3,100
751,10,4,17,21,3,100
752,10,17,9,26,3,100
753,10,28,24,52,3,100
754,10,26,33,59,3,100
755,10,29,48,77,3,100
756,10,39,61,100,3,100
757,10,35,118,153,3,100
758,10,20,47,67,3,100
759,10,18,22,40,3,100
760,10,11,32,43,3,100
761,10,30,45,75,3,100
762,10,26,30,56,3,100
763,10,64,92,156,3,100
764,10,14,38,52,3,100
765,10,9,13,22,3,100
766,10,11,21,32,3,100
767,10,1,8,9,3,100
768,10,29,73,102,3,100
769,10,27,48,75,3,100
770,10,26,61,87,3,100
771,10,20,39,59,3,100
772,10,10,49,59,3,100
773,10,37,63,100,3,100
774,10,33,79,112,3,100
775,10,15,35,50,3,100
776,10,17,52,69,3,100
777,10,8,15,23,3,100
778,10,15,45,60,3,100
779,10,43,85,128,3,100
780,10,10,29,39,3,100
781,10,25,34,59,3,100
782,10,44,74,118,3,100
783,10,34,39,73,3,100
784,10,6,11,17,3,100
785,10,7,11,18,3,100
786,10,6,8,14,3,100
787,10,36,27,63,3,100
788,10,21,70,91,3,100
789,10,45,73,118,3,100
790,10,21,52,73,3,100
791,10,39,18,57,3,100
792,10,38,83,121,3,100
793,10,52,69,121,3,100
794,10,23,45,68,3,100
795,10,20,22,42,3,100
796,10,4,43,47,3,100
797,10,21,60,81,3,100
798,10,38,64,102,3,100
799,10,27,22,49,3,100
800,10,6,24,30,3,100
801,10,24,23,47,3,100
802,10,24,61,85,3,100
803,10,30,36,66,3,100
804,10,83,139,222,3,100
805,10,46,49,95,3,100
806,10,42,65,107,3,100
807,10,28,30,58,3,100
808,10,10,7,17,3,100
809,10,9,5,14,3,100
810,10,19,20,39,3,100
811,10,23,49,72,3,100
812,10,19,42,61,3,100
813,10,48,95,143,3,100
814,10,13,51,64,3,100
815,10,3,42,45,3,100
816,10,102,190,292,3,100
817,10,41,78,119,3,100
818,10,28,44,72,3,100
819,10,26,52,78,3,100
820,10,7,16,23,3,100
821,10,22,10,32,3,100
822,10,0,0,0,3,100
823,10,5,13,18,3,100
824,10,2,8,10,3,100
825,10,23,59,82,3,100
826,10,34,76,110,3,100
827,10,33,58,91,3,100
828,10,11,30,41,3,100
829,10,36,86,122,3,100
830,10,33,29,62,3,100
831,10,29,69,98,3,100
832,10,36,59,95,3,100
833,10,17,17,34,3,100
834,10,46,55,101,3,100
835,10,9,8,17,3,100
836,10,7,23,30,3,100
837,10,24,43,67,3,100
838,10,20,29,49,3,100
839,10,25,33,58,3,100
840,10,32,22,54,3,100
841,10,22,52,74,3,100
842,10,9,16,25,3,100
843,10,65,91,156,3,100
844,10,27,43,70,3,100
845,10,12,49,61,3,100
846,10,44,42,86,3,100
847,10,17,74,91,3,100
848,10,25,86,111,3,100
849,10,58,90,148,3,100
850,10,7,15,22,3,100
851,10,23,42,65,3,100
852,10,7,10,17,3,100
853,10,8,12,20,3,100
854,10,6,17,23,3,100
855,10,13,8,21,3,100
856,10,16,11,27,3,100
857,10,16,29,45,3,100
858,10,25,64,89,3,100
859,10,28,22,50,3,100
860,10,30,87,117,3,100
861,10,47,89,136,3,100
862,10,35,74,109,3,100
863,10,64,108,172,3,100
864,10,22,33,55,3,100
865,10,23,71,94,3,100
866,10,7,24,31,3,100
867,10,2,2,4,3,100
868,10,15,27,42,3,100
869,10,28,26,54,3,100
870,10,17,32,49,3,100
871,10,12,13,25,3,100
872,10,8,24,32,3,100
873,10,30,50,80,3,100
874,10,64,86,150,3,100
875,10,20,16,36,3,100
876,10,77,87,164,3,100
877,10,19,66,85,3,100
878,10,19,37,56,3,100
879,10,44,125,169,3,100
880,10,35,72,107,3,100
881,10,20,43,63,3,100
882,10,33,38,71,3,100
883,10,21,53,74,3,100
884,10,37,109,146,3,100
885,10,32,61,93,3,100
886,10,6,15,21,3,100
887,10,7,28,35,3,100
888,10,37,64,101,3,100
889,10,9,13,22,3,100
890,10,43,109,152,3,100
891,10,23,111,134,3,100
892,10,35,69,104,3,100
893,10,25,67,92,3,100
894,10,52,53,105,3,100
895,10,45,61,106,3,100
896,10,28,53,81,3,100
897,10,10,21,31,3,100
898,10,12,40,52,3,100
899,10,20,34,54,3,100
900,10,10,10,20,3,100
901,10,10,12,22,3,100
902,10,21,33,54,3,100
903,10,24,54,78,3,100
904,10,2,20,22,3,100
905,10,52,88,140,3,100
906,10,30,64,94,3,100
907,10,39,104,143,3,100
908,10,44,85,129,3,100
909,10,13,47,60,3,100
910,10,37,46,83,3,100
911,10,26,51,77,3,100
912,10,33,124,157,3,100
913,10,33,48,81,3,100
914,10,32,46,78,3,100
915,10,18,29,47,3,100
916,10,45,102,147,3,100
917,10,56,131,187,3,100
918,10,17,68,85,3,100
919,10,31,99,130,3,100
920,10,64,52,116,3,100
921,10,11,23,34,3,100
922,10,44,53,97,3,100
923,10,22,31,53,3,100
924,10,25,38,63,3,100
925,10,19,20,39,3,100
926,10,18,26,44,3,100
927,10,7,28,35,3,100
928,10,85,99,184,3,100
929,10,36,36,72,3,100
930,10,2,17,19,3,100
931,10,31,51,82,3,100
932,10,38,54,92,3,100
933,10,23,37,60,3,100
934,10,10,52,62,3,100
935,10,54,97,151,3,100
936,20,7,8,15,3,100
937,20,30,34,64,3,100
938,20,91,80,171,3,100
939,20,19,92,111,3,100
940,20,42,46,88,3,100
941,20,7,35,42,3,100
942,20,49,71,120,3,100
943,20,69,69,138,3,100
944,20,118,110,228,3,100
945,20,141,271,412,3,100
946,20,26,41,67,3,100
947,20,51,80,131,3,100
948,20,3,13,16,3,100
949,20,26,53,79,3,100
950,20,34,60,94,3,100
951,20,8,4,12,3,100
952,20,92,91,183,3,100
953,20,82,54,136,3,100
954,20,32,72,104,3,100
955,20,58,162,220,3,100
956,20,63,75,138,3,100
957,20,73,93,166,3,100
958,20,44,67,111,3,100
959,20,82,128,210,3,100
960,20,26,42,68,3,100
961,20,16,25,41,3,100
962,20,41,39,80,3,100
963,20,7,12,19,3,100
964,20,14,14,28,3,100
965,20,2,11,13,3,100
966,20,78,90,168,3,100
967,20,93,144,237,3,100
968,20,49,78,127,3,100
969,20,101,129,230,3,100
970,20,22,68,90,3,100
971,20,61,33,94,3,100
972,20,358,313,671,3,100
973,20,13,23,36,3,100
974,20,22,35,57,3,100
975,20,23,30,53,3,100
976,20,55,108,163,3,100
977,20,12,18,30,3,100
978,20,29,44,73,3,100
979,20,8,22,30,3,100
980,20,17,20,37,3,100
981,20,41,35,76,3,100
982,20,25,35,60,3,100
983,20,9,15,24,3,100
984,20,23,30,53,3,100
985,20,38,40,78,3,100
986,20,76,120,196,3,100
987,20,44,95,139,3,100
988,20,25,31,56,3,100
989,20,74,123,197,3,100
990,20,44,115,159,3,100
991,20,47,85,132,3,100
992,20,34,46,80,3,100
993,20,56,58,114,3,100
994,20,127,203,330,3,100
995,20,32,28,60,3,100
996,20,0,0,0,3,100
997,20,5,31,36,3,100
998,20,14,48,62,3,100
999,20,27,70,97,3,100
1000,20,25,31,56,3,100
1001,20,53,71,124,3,100
1002,20,30,40,70,3,100
1003,20,37,46,83,3,100
1004,20,32,77,109,3,100
1005,20,39,32,71,3,100
1006,20,34,88,122,3,100
1007,20,17,20,37,3,100
1008,20,4,9,13,3,100
1009,20,73,105,178,3,100
1010,20,71,142,213,3,100
1011,20,21,45,66,3,100
1012,20,1,4,5,3,100
1013,20,14,40,54,3,100
1014,20,81,122,203,3,100
1015,20,20,46,66,3,100
1016,20,168,190,358,3,100
1017,20,86,168,254,3,100
1018,20,78,135,213,3,100
1019,20,61,236,297,3,100
1020,20,16,46,62,3,100
1021,20,31,49,80,3,100
1022,20,11,13,24,3,100
1023,20,32,116,148,3,100
1024,20,60,42,102,3,100
1025,20,57,34,91,3,100
1026,20,2,22,24,3,100
1027,20,24,50,74,3,100
1028,20,8,14,22,3,100
1029,20,14,36,50,3,100
1030,20,65,146,211,3,100
1031,20,47,81,128,3,100
1032,20,15,37,52,3,100
1033,20,51,77,128,3,100
1034,20,32,59,91,3,100
1035,20,28,46,74,3,100
1036,20,31,60,91,3,100
1037,20,11,34,45,3,100
1038,20,23,28,51,3,100
1039,20,50,95,145,3,100
1040,20,58,199,257,3,100
1041,20,12,7,19,3,100
1042,20,24,34,58,3,100
1043,20,26,37,63,3,100
1044,20,24,56,80,3,100
1045,20,17,25,42,3,100
1046,20,13,10,23,3,100
1047,20,3,5,8,3,100
1048,20,24,18,42,3,100
1049,20,32,54,86,3,100
1050,20,21,43,64,3,100
1051,20,11,19,30,3,100
1052,20,3,3,6,3,100
1053,20,20,22,42,3,100
1054,20,5,12,17,3,100
1055,20,10,7,17,3,100
1056,20,8,28,36,3,100
1057,20,30,26,56,3,100
1058,20,44,27,71,3,100
1059,20,45,45,90,3,100
1060,20,40,36,76,3,100
1061,20,41,63,104,3,100
1062,20,52,125,177,3,100
1063,20,16,11,27,3,100
1064,20,17,41,58,3,100
1065,20,32,23,55,3,100
1066,20,40,53,93,3,100
1067,20,25,29,54,3,100
1068,20,25,27,52,3,100
1069,20,12,19,31,3,100
1070,20,44,58,102,3,100
1071,20,19,27,46,3,100
1072,20,37,63,100,3,100
1073,20,35,32,67,3,100
1074,20,54,53,107,3,100
1075,20,25,37,62,3,100
1076,20,19,44,63,3,100
1077,20,54,56,110,3,100
1078,20,91,99,190,3,100
1079,20,32,43,75,3,100
1080,20,58,69,127,3,100
1081,20,38,50,88,3,100
1082,20,31,18,49,3,100
1083,20,10,13,23,3,100
1084,20,47,39,86,3,100
1085,20,31,38,69,3,100
1086,20,79,93,172,3,100
1087,20,52,71,123,3,100
1088,20,21,39,60,3,100
1089,20,69,166,235,3,100
1090,20,72,101,173,3,100
1091,20,1,3,4,3,100
1092,20,0,4,4,3,100
1093,20,5,10,15,3,100
1094,20,15,33,48,3,100
1095,20,30,40,70,3,100
1096,20,17,20,37,3,100
1097,20,63,86,149,3,100
1098,20,30,71,101,3,100
1099,20,30,25,55,3,100
1100,20,23,33,56,3,100
1101,20,59,77,136,3,100
1102,20,44,52,96,3,100
1103,20,35,52,87,3,100
1104,20,38,53,91,3,100
1105,20,24,22,46,3,100
1106,20,21,28,49,3,100
1107,20,40,31,71,3,100
1108,20,3,9,12,3,100
1109,20,4,13,17,3,100
1110,20,29,46,75,3,100
1111,20,8,9,17,3,100
1112,20,45,55,100,3,100
1113,20,17,29,46,3,100
1114,20,34,57,91,3,100
1115,20,71,131,202,3,100
1116,20,24,31,55,3,100
1117,20,15,32,47,3,100
1118,20,28,33,61,3,100
1119,20,60,87,147,3,100
1120,20,15,26,41,3,100
1121,20,57,39,96,3,100
1122,20,12,19,31,3,100
1123,20,3,37,40,3,100
1124,20,15,7,22,3,100
1125,20,22,16,38,3,100
1126,20,0,0,0,3,100
1127,20,11,17,28,3,100
1128,20,25,43,68,3,100
1129,20,15,10,25,3,100
1130,20,23,33,56,3,100
1131,20,45,42,87,3,100
1132,20,13,22,35,3,100
1133,20,47,71,118,3,100
1134,20,14,40,54,3,100
1135,20,19,33,52,3,100
1136,20,13,21,34,3,100
1137,20,16,27,43,3,100
1138,20,9,12,21,3,100
1139,20,31,63,94,3,100
1140,20,36,51,87,3,100
1141,20,16,26,42,3,100
1142,20,25,60,85,3,100
1143,20,15,31,46,3,100
1144,20,43,53,96,3,100
1145,20,48,44,92,3,100
1146,20,19,37,56,3,100
1147,20,9,13,22,3,100
1148,20,3,11,14,3,100
1149,20,42,79,121,3,100
1150,20,4,7,11,3,100
1151,20,19,39,58,3,100
1152,20,79,127,206,3,100
1153,20,11,16,27,3,100
1154,20,3,20,23,3,100
1155,20,33,74,107,3,100
1156,20,12,32,44,3,100
1157,20,27,90,117,3,100
1158,20,43,85,128,3,100
1159,20,13,24,37,3,100
1160,20,23,25,48,3,100
1161,20,34,51,85,3,100
1162,20,41,59,100,3,100
1163,20,45,56,101,3,100
1164,20,52,64,116,3,100
1165,20,81,142,223,3,100
1166,20,52,119,171,3,100
1167,20,64,119,183,3,100
1168,20,29,23,52,3,100
1169,20,34,49,83,3,100
1170,20,71,50,121,3,100
1171,20,26,47,73,3,100
1172,20,25,53,78,3,100
1173,20,38,38,76,3,100
1174,20,34,64,98,3,100
1175,20,38,52,90,3,100
1176,20,56,89,145,3,100
1177,20,47,50,97,3,100
1178,20,29,32,61,3,100
1179,20,120,158,278,3,100
1180,20,29,38,67,3,100
1181,20,33,34,67,3,100
1182,20,37,77,114,3,100
1183,20,11,35,46,3,100
1184,20,29,106,135,3,100
1185,20,25,27,52,3,100
1186,20,3,11,14,3,100
1187,20,43,102,145,3,100
1188,20,90,70,160,3,100
1189,20,3,2,5,3,100
1190,20,71,105,176,3,100
1191,20,40,104,144,3,100
1192,20,71,101,172,3,100
1193,20,79,86,165,3,100
1194,20,47,107,154,3,100
1195,20,37,41,78,3,100
1196,20,17,16,33,3,100
1197,20,23,41,64,3,100
1198,20,43,37,80,3,100
1199,20,47,30,77,3,100
1200,20,76,94,170,3,100
1201,20,36,27,63,3,100
1202,20,23,33,56,3,100
1203,20,106,155,261,3,100
1204,20,10,40,50,3,100
1205,20,29,18,47,3,100
1206,20,122,201,323,3,100
1207,20,12,12,24,3,100
1208,20,42,44,86,3,100
1209,20,3,17,20,3,100
1210,20,56,39,95,3,100
1211,20,42,56,98,3,100
1212,20,7,10,17,3,100
1213,20,4,23,27,3,100
1214,20,18,13,31,3,100
1215,20,59,40,99,3,100
1216,20,32,70,102,3,100
1217,20,78,92,170,3,100
1218,20,72,78,150,3,100
1219,20,28,72,100,3,100
1220,20,40,90,130,3,100
1221,20,25,49,74,3,100
1222,20,38,70,108,3,100
1223,20,42,53,95,3,100
1224,20,42,53,95,3,100
1225,20,12,18,30,3,100
1226,20,25,18,43,3,100
1227,20,17,18,35,3,100
1228,20,53,83,136,3,100
1229,20,16,6,22,3,100
1230,20,53,72,125,3,100
1231,20,52,62,114,3,100
1232,20,31,45,76,3,100
1233,20,66,46,112,3,100
1234,20,15,42,57,3,100
1235,20,87,114,201,3,100
1236,20,26,28,54,3,100
1237,20,22,50,72,3,100
1238,20,21,21,42,3,100
1239,20,164,252,416,3,100
1240,20,32,88,120,3,100
1241,20,31,41,72,3,100
1242,20,57,68,125,3,100
1243,20,38,71,109,3,100
1244,20,36,62,98,3,100
1245,20,46,116,162,3,100
1246,20,27,60,87,3,100
1247,20,89,129,218,3,100
1248,20,49,97,146,3,100
1249,20,34,56,90,3,100
1250,20,30,26,56,3,100
1251,20,8,31,39,3,100
1252,20,24,38,62,3,100
1253,20,38,66,104,3,100
1254,20,16,35,51,3,100
1255,20,4,11,15,3,100
1256,20,3,10,13,3,100
1257,20,13,16,29,3,100
1258,20,11,27,38,3,100
1259,20,12,28,40,3,100
1260,20,19,25,44,3,100
1261,20,87,95,182,3,100
1262,20,16,13,29,3,100
1263,20,70,132,202,3,100
1264,20,15,39,54,3,100
1265,20,30,61,91,3,100
1266,20,58,177,235,3,100
1267,20,15,37,52,3,100
1268,20,62,45,107,3,100
1269,20,12,29,41,3,100
1270,20,12,14,26,3,100
1271,20,39,44,83,3,100
1272,20,10,7,17,3,100
1273,20,43,39,82,3,100
1274,20,32,54,86,3,100
1275,20,10,34,44,3,100
1276,20,51,62,113,3,100
1277,20,12,32,44,3,100
1278,20,52,50,102,3,100
1279,20,7,65,72,3,100
1280,20,53,68,121,3,100
1281,20,21,21,42,3,100
1282,20,31,55,86,3,100
1283,20,53,94,147,3,100
1284,20,10,7,17,3,100
1285,20,24,29,53,3,100
1286,20,60,47,107,3,100
1287,20,22,38,60,3,100
1288,20,20,28,48,3,100
1289,20,10,24,34,3,100
1290,20,8,29,37,3,100
1291,20,10,10,20,3,100
1292,20,42,37,79,3,100
1293,20,15,14,29,3,100
1294,20,5,3,8,3,100
1295,20,37,30,67,3,100
1296,20,4,7,11,3,100
1297,20,17,27,44,3,100
1298,20,30,34,64,3,100
1299,20,74,130,204,3,100
1300,20,31,39,70,3,100
1301,20,28,40,68,3,100
1302,20,63,55,118,3,100
1303,20,36,57,93,3,100
1304,20,47,39,86,3,100
1305,20,53,87,140,3,100
1306,20,35,20,55,3,100
1307,20,54,42,96,3,100
1308,20,43,100,143,3,100
1309,20,10,15,25,3,100
1310,20,14,24,38,3,100
1311,20,6,12,18,3,100
1312,20,30,39,69,3,100
1313,20,13,37,50,3,100
1314,20,71,90,161,3,100
1315,20,8,8,16,3,100
1316,20,38,41,79,3,100
1317,20,24,73,97,3,100
1318,20,49,72,121,3,100
1319,20,91,74,165,3,100
1320,20,49,105,154,3,100
1321,20,1,6,7,3,100
1322,20,31,53,84,3,100
1323,20,8,24,32,3,100
1324,20,26,31,57,3,100
1325,20,80,90,170,3,100
1326,20,31,59,90,3,100
1327,20,45,59,104,3,100
1328,20,3,9,12,3,100
1329,20,26,40,66,3,100
1330,20,42,68,110,3,100
1331,20,55,85,140,3,100
1332,20,19,32,51,3,100
1333,20,17,13,30,3,100
1334,20,57,76,133,3,100
1335,20,46,56,102,3,100
1336,20,7,9,16,3,100
1337,20,16,29,45,3,100
1338,20,18,13,31,3,100
1339,20,2,2,4,3,100
1340,20,41,48,89,3,100
1341,20,57,61,118,3,100
1342,20,38,37,75,3,100
1343,20,3,17,20,3,100
1344,20,17,32,49,3,100
1345,20,9,15,24,3,100
1346,20,19,12,31,3,100
1347,20,28,53,81,3,100
1348,20,47,59,106,3,100
1349,20,23,52,75,3,100
1350,20,50,45,95,3,100
1351,20,41,28,69,3,100
1352,20,45,76,121,3,100
1353,20,48,52,100,3,100
1354,20,55,67,122,3,100
1355,20,56,50,106,3,100
1356,20,17,27,44,3,100
1357,20,28,57,85,3,100
1358,20,5,7,12,3,100
1359,20,18,45,63,3,100
1360,20,39,65,104,3,100
1361,20,32,26,58,3,100
1362,20,62,76,138,3,100
1363,20,20,21,41,3,100
1364,20,20,20,40,3,100
1365,20,59,124,183,3,100
1366,20,19,51,70,3,100
1367,20,63,74,137,3,100
1368,20,39,27,66,3,100
1369,20,73,67,140,3,100
1370,20,8,20,28,3,100
1371,20,53,38,91,3,100
1372,20,20,25,45,3,100
1373,20,34,48,82,3,100
1374,20,41,61,102,3,100
1375,20,130,155,285,3,100
1376,20,32,76,108,3,100
1377,20,42,50,92,3,100
1378,20,73,116,189,3,100
1379,20,38,59,97,3,100
1380,20,50,52,102,3,100
1381,20,57,40,97,3,100
1382,20,10,6,16,3,100
1383,20,65,73,138,3,100
1384,20,29,21,50,3,100
1385,20,6,13,19,3,100
1386,30,30,51,81,3,100
1387,30,22,31,53,3,100
1388,30,38,45,83,3,100
1389,30,39,47,86,3,100
1390,30,31,71,102,3,100
1391,30,27,50,77,3,100
1392,30,75,96,171,3,100
1393,30,44,76,120,3,100
1394,30,55,105,160,3,100
1395,30,145,159,304,3,100
1396,30,57,33,90,3,100
1397,30,62,83,145,3,100
1398,30,54,62,116,3,100
1399,30,90,82,172,3,100
1400,30,26,10,36,3,100
1401,30,21,26,47,3,100
1402,30,3,24,27,3,100
1403,30,4,8,12,3,100
1404,30,20,33,53,3,100
1405,30,100,119,219,3,100
1406,30,68,57,125,3,100
1407,30,60,116,176,3,100
1408,30,61,124,185,3,100
1409,30,56,100,156,3,100
1410,30,65,83,148,3,100
1411,30,23,47,70,3,100
1412,30,44,71,115,3,100
1413,30,31,40,71,3,100
1414,30,17,25,42,3,100
1415,30,25,61,86,3,100
1416,30,32,28,60,3,100
1417,30,33,35,68,3,100
1418,30,16,14,30,3,100
1419,30,57,87,144,3,100
1420,30,78,148,226,3,100
1421,30,53,76,129,3,100
1422,30,57,60,117,3,100
1423,30,65,73,138,3,100
1424,30,147,157,304,3,100
1425,30,51,60,111,3,100
1426,30,75,73,148,3,100
1427,30,49,57,106,3,100
1428,30,55,67,122,3,100
1429,30,71,59,130,3,100
1430,30,21,17,38,3,100
1431,30,22,17,39,3,100
1432,30,42,54,96,3,100
1433,30,15,15,30,3,100
1434,30,5,13,18,3,100
1435,30,14,26,40,3,100
1436,30,30,28,58,3,100
1437,30,80,114,194,3,100
1438,30,31,37,68,3,100
1439,30,23,43,66,3,100
1440,30,48,28,76,3,100
1441,30,36,117,153,3,100
1442,30,69,117,186,3,100
1443,30,19,48,67,3,100
1444,30,66,63,129,3,100
1445,30,42,90,132,3,100
1446,30,20,44,64,3,100
1447,30,54,65,119,3,100
1448,30,23,18,41,3,100
1449,30,102,93,195,3,100
1450,30,38,17,55,3,100
1451,30,26,64,90,3,100
1452,30,55,48,103,3,100
1453,30,3,22,25,3,100
1454,30,2,8,10,3,100
1455,30,45,60,105,3,100
1456,30,22,18,40,3,100
1457,30,2,7,9,3,100
1458,30,37,43,80,3,100
1459,30,71,125,196,3,100
1460,30,16,20,36,3,100
1461,30,60,64,124,3,100
1462,30,16,22,38,3,100
1463,30,45,73,118,3,100
1464,30,31,21,52,3,100
1465,30,11,22,33,3,100
1466,30,12,16,28,3,100
1467,30,50,86,136,3,100
1468,30,58,59,117,3,100
1469,30,29,107,136,3,100
1470,30,35,65,100,3,100
1471,30,43,31,74,3,100
1472,30,10,24,34,3,100
1473,30,35,61,96,3,100
1474,30,22,44,66,3,100
1475,30,4,1,5,3,100
1476,30,25,26,51,3,100
1477,30,141,67,208,3,100
1478,30,87,185,272,3,100
1479,30,85,123,208,3,100
1480,30,45,75,120,3,100
1481,30,23,31,54,3,100
1482,30,49,58,107,3,100
1483,30,21,48,69,3,100
1484,30,6,14,20,3,100
1485,30,25,28,53,3,100
1486,30,7,15,22,3,100
1487,30,27,38,65,3,100
1488,30,47,49,96,3,100
1489,30,59,132,191,3,100
1490,30,73,116,189,3,100
1491,30,59,66,125,3,100
1492,30,104,91,195,3,100
1493,30,110,104,214,3,100
1494,30,34,55,89,3,100
1495,30,19,21,40,3,100
1496,30,53,83,136,3,100
1497,30,62,56,118,3,100
1498,30,37,47,84,3,100
1499,30,8,5,13,3,100
1500,30,7,13,20,3,100
1501,30,48,33,81,3,100
1502,30,16,19,35,3,100
1503,30,12,32,44,3,100
1504,30,101,144,245,3,100
1505,30,44,45,89,3,100
1506,30,8,36,44,3,100
1507,30,52,27,79,3,100
1508,30,81,120,201,3,100
1509,30,25,36,61,3,100
1510,30,2,3,5,3,100
1511,30,42,50,92,3,100
1512,30,27,50,77,3,100
1513,30,17,63,80,3,100
1514,30,23,25,48,3,100
1515,30,4,7,11,3,100
1516,30,1,6,7,3,100
1517,30,22,26,48,3,100
1518,30,73,37,110,3,100
1519,30,12,5,17,3,100
1520,30,17,18,35,3,100
1521,30,7,14,21,3,100
1522,30,65,48,113,3,100
1523,30,57,89,146,3,100
1524,30,57,129,186,3,100
1525,30,59,54,113,3,100
1526,30,62,64,126,3,100
1527,30,42,39,81,3,100
1528,30,50,83,133,3,100
1529,30,55,63,118,3,100
1530,30,81,80,161,3,100
1531,30,31,27,58,3,100
1532,30,40,37,77,3,100
1533,30,44,74,118,3,100
1534,30,33,46,79,3,100
1535,30,12,40,52,3,100
1536,30,8,13,21,3,100
1537,30,17,33,50,3,100
1538,30,24,18,42,3,100
1539,30,6,18,24,3,100
1540,30,35,32,67,3,100
1541,30,15,14,29,3,100
1542,30,69,117,186,3,100
1543,30,120,127,247,3,100
1544,30,7,57,64,3,100
1545,30,33,45,78,3,100
1546,30,55,72,127,3,100
1547,30,87,101,188,3,100
1548,30,38,71,109,3,100
1549,30,23,86,109,3,100
1550,30,51,49,100,3,100
1551,30,59,111,170,3,100
1552,30,44,56,100,3,100
1553,30,18,45,63,3,100
1554,30,81,109,190,3,100
1555,30,34,50,84,3,100
1556,30,65,97,162,3,100
1557,30,106,22,128,3,100
1558,30,45,51,96,3,100
1559,30,67,112,179,3,100
1560,30,29,34,63,3,100
1561,30,64,121,185,3,100
1562,30,58,43,101,3,100
1563,30,27,48,75,3,100
1564,30,121,181,302,3,100
1565,30,60,72,132,3,100
1566,30,39,58,97,3,100
1567,30,23,37,60,3,100
1568,30,9,15,24,3,100
1569,30,24,67,91,3,100
1570,30,15,20,35,3,100
1571,30,61,87,148,3,100
1572,30,73,102,175,3,100
1573,30,74,74,148,3,100
1574,30,61,73,134,3,100
1575,30,44,50,94,3,100
1576,30,9,31,40,3,100
1577,30,43,73,116,3,100
1578,30,33,65,98,3,100
1579,30,23,21,44,3,100
1580,30,46,24,70,3,100
1581,30,13,45,58,3,100
1582,30,39,26,65,3,100
1583,30,56,52,108,3,100
1584,30,33,48,81,3,100
1585,30,14,31,45,3,100
1586,30,4,13,17,3,100
1587,30,26,19,45,3,100
1588,30,16,24,40,3,100
1589,30,48,59,107,3,100
1590,30,37,35,72,3,100
1591,30,26,29,55,3,100
1592,30,8,5,13,3,100
1593,30,68,77,145,3,100
1594,30,10,43,53,3,100
1595,30,49,59,108,3,100
1596,30,26,38,64,3,100
1597,30,39,47,86,3,100
1598,30,47,67,114,3,100
1599,30,40,60,100,3,100
1600,30,26,45,71,3,100
1601,30,42,64,106,3,100
1602,30,18,27,45,3,100
1603,30,72,54,126,3,100
1604,30,25,29,54,3,100
1605,30,31,49,80,3,100
1606,30,32,32,64,3,100
1607,30,35,54,89,3,100
1608,30,9,1,10,3,100
1609,30,29,33,62,3,100
1610,30,24,10,34,3,100
1611,30,153,204,357,3,100
1612,30,48,76,124,3,100
1613,30,82,30,112,3,100
1614,30,25,78,103,3,100
1615,30,75,107,182,3,100
1616,30,110,103,213,3,100
1617,30,75,79,154,3,100
1618,30,34,83,117,3,100
1619,30,60,117,177,3,100
1620,30,36,72,108,3,100
1621,30,84,73,157,3,100
1622,30,90,115,205,3,100
1623,30,19,25,44,3,100
1624,30,17,35,52,3,100
1625,30,2,21,23,3,100
1626,30,18,37,55,3,100
1627,30,32,63,95,3,100
1628,30,15,29,44,3,100
1629,30,35,42,77,3,100
1630,30,1,1,2,3,100
1631,30,24,30,54,3,100
1632,30,31,73,104,3,100
1633,30,53,61,114,3,100
1634,30,84,103,187,3,100
1635,30,8,17,25,3,100
1636,30,41,46,87,3,100
1637,30,51,73,124,3,100
1638,30,26,42,68,3,100
1639,30,45,106,151,3,100
1640,30,34,68,102,3,100
1641,30,37,84,121,3,100
1642,30,43,48,91,3,100
1643,30,144,145,289,3,100
1644,30,29,53,82,3,100
1645,30,40,24,64,3,100
1646,30,51,51,102,3,100
1647,30,30,50,80,3,100
1648,30,10,27,37,3,100
1649,30,25,36,61,3,100
1650,30,32,22,54,3,100
1651,30,20,4,24,3,100
1652,30,10,17,27,3,100
1653,30,84,114,198,3,100
1654,30,106,205,311,3,100
1655,30,43,70,113,3,100
1656,30,99,233,332,3,100
1657,30,21,64,85,3,100
1658,30,23,35,58,3,100
1659,30,48,87,135,3,100
1660,30,65,32,97,3,100
1661,30,40,83,123,3,100
1662,30,84,75,159,3,100
1663,30,97,91,188,3,100
1664,30,80,61,141,3,100
1665,30,90,115,205,3,100
1666,30,65,86,151,3,100
1667,30,146,133,279,3,100
1668,30,41,35,76,3,100
1669,30,126,129,255,3,100
1670,30,5,12,17,3,100
1671,30,36,54,90,3,100
1672,30,60,77,137,3,100
1673,30,22,58,80,3,100
1674,30,39,42,81,3,100
1675,30,72,77,149,3,100
1676,30,74,150,224,3,100
1677,30,30,32,62,3,100
1678,30,12,22,34,3,100
1679,30,53,81,134,3,100
1680,30,33,59,92,3,100
1681,30,48,88,136,3,100
1682,30,102,134,236,3,100
1683,30,49,88,137,3,100
1684,30,41,42,83,3,100
1685,30,34,41,75,3,100
1686,30,87,124,211,3,100
1687,30,61,72,133,3,100
1688,30,25,41,66,3,100
1689,30,38,31,69,3,100
1690,30,45,32,77,3,100
1691,30,7,25,32,3,100
1692,30,6,14,20,3,100
1693,30,18,7,25,3,100
1694,30,6,11,17,3,100
1695,30,66,57,123,3,100
1696,30,77,74,151,3,100
1697,30,25,31,56,3,100
1698,30,48,54,102,3,100
1699,30,39,74,113,3,100
1700,30,45,60,105,3,100
1701,30,63,76,139,3,100
1702,30,73,90,163,3,100
1703,30,14,20,34,3,100
1704,30,78,59,137,3,100
1705,30,48,45,93,3,100
1706,30,75,112,187,3,100
1707,30,39,81,120,3,100
1708,30,72,159,231,3,100
1709,30,34,36,70,3,100
1710,30,34,62,96,3,100
1711,30,46,61,107,3,100
1712,30,17,26,43,3,100
1713,30,20,5,25,3,100
1714,30,85,187,272,3,100
1715,30,18,39,57,3,100
1716,30,7,17,24,3,100
1717,30,34,34,68,3,100
1718,30,65,87,152,3,100
1719,30,38,60,98,3,100
1720,30,26,72,98,3,100
1721,30,27,42,69,3,100
1722,30,73,80,153,3,100
1723,30,60,50,110,3,100
1724,30,58,55,113,3,100
1725,30,60,71,131,3,100
1726,30,44,50,94,3,100
1727,30,30,35,65,3,100
1728,30,51,36,87,3,100
1729,30,18,28,46,3,100
1730,30,68,72,140,3,100
1731,30,56,68,124,3,100
1732,30,7,15,22,3,100
1733,30,63,46,109,3,100
1734,30,10,9,19,3,100
1735,30,34,24,58,3,100
1736,30,27,10,37,3,100
1737,30,31,38,69,3,100
1738,30,47,45,92,3,100
1739,30,92,103,195,3,100
1740,30,34,98,132,3,100
1741,30,30,58,88,3,100
1742,30,104,191,295,3,100
1743,30,9,21,30,3,100
1744,30,17,49,66,3,100
1745,30,125,204,329,3,100
1746,30,63,78,141,3,100
1747,30,39,29,68,3,100
1748,30,5,18,23,3,100
1749,30,33,42,75,3,100
1750,30,14,7,21,3,100
1751,30,47,79,126,3,100
1752,30,19,25,44,3,100
1753,30,59,52,111,3,100
1754,30,87,115,202,3,100
1755,30,10,8,18,3,100
1756,30,26,45,71,3,100
1757,30,31,35,66,3,100
1758,30,13,53,66,3,100
1759,30,55,50,105,3,100
1760,30,42,74,116,3,100
1761,30,19,118,137,3,100
1762,30,27,69,96,3,100
1763,30,38,67,105,3,100
1764,30,18,73,91,3,100
1765,30,111,213,324,3,100
1766,30,108,86,194,3,100
1767,30,27,47,74,3,100
1768,30,121,138,259,3,100
1769,30,42,44,86,3,100
1770,30,65,69,134,3,100
1771,30,21,31,52,3,100
1772,30,68,63,131,3,100
1773,30,73,97,170,3,100
1774,30,12,33,45,3,100
1775,30,42,28,70,3,100
1776,30,9,15,24,3,100
1777,30,41,34,75,3,100
1778,30,5,20,25,3,100
1779,30,60,68,128,3,100
1780,30,57,119,176,3,100
1781,30,99,42,141,3,100
1782,30,62,129,191,3,100
1783,30,23,42,65,3,100
1784,30,151,235,386,3,100
1785,30,45,74,119,3,100
1786,30,112,160,272,3,100
1787,30,111,149,260,3,100
1788,30,19,31,50,3,100
1789,30,113,191,304,3,100
1790,30,14,25,39,3,100
1791,30,80,93,173,3,100
1792,30,7,9,16,3,100
1793,30,36,43,79,3,100
1794,30,16,14,30,3,100
1795,30,34,44,78,3,100
1796,30,78,61,139,3,100
1797,30,52,55,107,3,100
1798,30,75,92,167,3,100
1799,30,68,88,156,3,100
1800,30,85,65,150,3,100
1801,30,103,117,220,3,100
1802,30,60,71,131,3,100
1803,30,27,40,67,3,100
1804,30,86,85,171,3,100
1805,30,51,56,107,3,100
1806,30,55,55,110,3,100
1807,30,30,40,70,3,100
1808,30,43,35,78,3,100
1809,30,26,28,54,3,100
1810,30,19,42,61,3,100
1811,30,33,33,66,3,100
1812,30,35,41,76,3,100
1813,30,19,27,46,3,100
1814,30,18,42,60,3,100
1815,30,29,11,40,3,100
1816,30,57,71,128,3,100
1817,30,49,78,127,3,100
1818,30,29,47,76,3,100
1819,30,22,32,54,3,100
1820,30,16,26,42,3,100
1821,30,86,92,178,3,100
1822,30,84,113,197,3,100
1823,30,22,29,51,3,100
1824,30,82,121,203,3,100
1825,30,56,68,124,3,100
1826,30,41,45,86,3,100
1827,30,6,7,13,3,100
1828,30,14,23,37,3,100
1829,30,14,14,28,3,100
1830,30,9,42,51,3,100
1831,30,24,54,78,3,100
1832,30,22,61,83,3,100
1833,30,17,50,67,3,100
1834,30,29,61,90,3,100
1835,30,41,38,79,3,100
1836,30,71,127,198,3,100
1837,30,38,39,77,3,100
1838,30,53,82,135,3,100
1839,30,68,92,160,3,100
1840,30,54,76,130,3,100
1841,30,10,18,28,3,100
1842,30,17,30,47,3,100
1843,30,21,28,49,3,100
1844,30,65,49,114,3,100
1845,30,70,86,156,3,100
1846,30,34,34,68,3,100
1847,30,78,126,204,3,100
1848,30,93,105,198,3,100
1849,30,11,46,57,3,100
1850,30,57,95,152,3,100
1851,30,12,14,26,3,100
1852,30,97,120,217,3,100
1853,30,18,31,49,3,100
1854,30,46,42,88,3,100
1855,30,34,28,62,3,100
1856,30,48,69,117,3,100
1857,30,55,45,100,3,100
1858,30,55,70,125,3,100
1859,30,101,106,207,3,100
1860,30,7,10,17,3,100
1861,30,63,39,102,3,100
1862,30,17,23,40,3,100
1863,30,28,54,82,3,100
1864,30,51,39,90,3,100
1865,30,57,67,124,3,100
1866,30,16,60,76,3,100
1867,30,181,250,431,3,100
1868,30,36,24,60,3,100
1869,30,23,30,53,3,100
1870,30,80,109,189,3,100
1871,30,108,191,299,3,100
1872,30,35,25,60,3,100
1873,30,64,49,113,3,100
1874,30,38,80,118,3,100
1875,30,3,104,107,3,100
1876,30,62,78,140,3,100
1877,30,88,78,166,3,100
1878,30,83,101,184,3,100
1879,30,13,27,40,3,100
1880,30,28,30,58,3,100
1881,30,41,95,136,3,100
1882,30,35,35,70,3,100
1883,30,19,74,93,3,100
1884,30,4,11,15,3,100
1885,30,4,10,14,3,100
1886,30,1,8,9,3,100
1887,30,84,68,152,3,100
1888,30,116,180,296,3,100
1889,30,73,91,164,3,100
1890,30,9,17,26,3,100
1891,30,29,18,47,3,100
1892,30,51,92,143,3,100
1893,30,28,31,59,3,100
1894,30,74,82,156,3,100
1895,30,14,27,41,3,100
1896,30,55,52,107,3,100
1897,30,16,33,49,3,100
1898,30,37,48,85,3,100
1899,30,28,48,76,3,100
1900,30,23,39,62,3,100
1901,40,17,49,66,3,100
1902,40,92,107,199,3,100
1903,40,90,104,194,3,100
1904,40,135,134,269,3,100
1905,40,31,22,53,3,100
1906,40,82,100,182,3,100
1907,40,40,56,96,3,100
1908,40,36,57,93,3,100
1909,40,27,63,90,3,100
1910,40,53,85,138,3,100
1911,40,74,98,172,3,100
1912,40,65,91,156,3,100
1913,40,47,48,95,3,100
1914,40,87,134,221,3,100
1915,40,31,36,67,3,100
1916,40,43,41,84,3,100
1917,40,30,55,85,3,100
1918,40,26,46,72,3,100
1919,40,66,75,141,3,100
1920,40,22,29,51,3,100
1921,40,10,11,21,3,100
1922,40,65,94,159,3,100
1923,40,64,104,168,3,100
1924,40,31,97,128,3,100
1925,40,83,95,178,3,100
1926,40,19,41,60,3,100
1927,40,144,172,316,3,100
1928,40,19,43,62,3,100
1929,40,72,127,199,3,100
1930,40,13,28,41,3,100
1931,40,19,17,36,3,100
1932,40,406,647,1053,3,100
1933,40,118,159,277,3,100
1934,40,82,74,156,3,100
1935,40,18,58,76,3,100
1936,40,19,33,52,3,100
1937,40,19,27,46,3,100
1938,40,29,40,69,3,100
1939,40,37,48,85,3,100
1940,40,21,49,70,3,100
1941,40,137,171,308,3,100
1942,40,23,23,46,3,100
1943,40,36,70,106,3,100
1944,40,122,166,288,3,100
1945,40,10,31,41,3,100
1946,40,126,238,364,3,100
1947,40,71,126,197,3,100
1948,40,63,51,114,3,100
1949,40,10,13,23,3,100
1950,40,69,101,170,3,100
1951,40,145,123,268,3,100
1952,40,5,11,16,3,100
1953,40,79,99,178,3,100
1954,40,66,65,131,3,100
1955,40,49,113,162,3,100
1956,40,3,11,14,3,100
1957,40,9,18,27,3,100
1958,40,53,74,127,3,100
1959,40,29,35,64,3,100
1960,40,54,102,156,3,100
1961,40,39,49,88,3,100
1962,40,12,28,40,3,100
1963,40,76,155,231,3,100
1964,40,79,46,125,3,100
1965,40,8,29,37,3,100
1966,40,22,78,100,3,100
1967,40,76,135,211,3,100
1968,40,46,38,84,3,100
1969,40,74,83,157,3,100
1970,40,11,27,38,3,100
1971,40,110,140,250,3,100
1972,40,4,15,19,3,100
1973,40,2,19,21,3,100
1974,40,19,22,41,3,100
1975,40,132,204,336,3,100
1976,40,65,58,123,3,100
1977,40,33,37,70,3,100
1978,40,51,68,119,3,100
1979,40,24,29,53,3,100
1980,40,0,9,9,3,100
1981,40,28,64,92,3,100
1982,40,53,49,102,3,100
1983,40,71,139,210,3,100
1984,40,145,202,347,3,100
1985,40,42,57,99,3,100
1986,40,89,143,232,3,100
1987,40,141,146,287,3,100
1988,40,72,110,182,3,100
1989,40,56,75,131,3,100
1990,40,49,51,100,3,100
1991,40,66,122,188,3,100
1992,40,65,101,166,3,100
1993,40,69,63,132,3,100
1994,40,53,47,100,3,100
1995,40,72,94,166,3,100
1996,40,5,14,19,3,100
1997,40,10,15,25,3,100
1998,40,2,1,3,3,100
1999,40,34,20,54,3,100
2000,40,10,32,42,3,100
2001,40,35,51,86,3,100
2002,40,34,40,74,3,100
2003,40,121,110,231,3,100
2004,40,62,48,110,3,100
2005,40,118,139,257,3,100
2006,40,79,68,147,3,100
2007,40,61,84,145,3,100
2008,40,18,19,37,3,100
2009,40,97,56,153,3,100
2010,40,57,121,178,3,100
2011,40,124,135,259,3,100
2012,40,49,35,84,3,100
2013,40,54,64,118,3,100
2014,40,20,32,52,3,100
2015,40,32,32,64,3,100
2016,40,41,50,91,3,100
2017,40,19,29,48,3,100
2018,40,6,14,20,3,100
2019,40,15,70,85,3,100
2020,40,0,0,0,3,100
2021,40,29,52,81,3,100
2022,40,24,46,70,3,100
2023,40,75,123,198,3,100
2024,40,30,30,60,3,100
2025,40,75,91,166,3,100
2026,40,136,172,308,3,100
2027,40,43,77,120,3,100
2028,40,49,80,129,3,100
2029,40,9,23,32,3,100
2030,40,124,121,245,3,100
2031,40,18,36,54,3,100
2032,40,62,100,162,3,100
2033,40,22,35,57,3,100
2034,40,6,37,43,3,100
2035,40,14,31,45,3,100
2036,40,77,63,140,3,100
2037,40,72,76,148,3,100
2038,40,65,102,167,3,100
2039,40,45,76,121,3,100
2040,40,63,77,140,3,100
2041,40,135,132,267,3,100
2042,40,50,98,148,3,100
2043,40,39,39,78,3,100
2044,40,24,31,55,3,100
2045,40,19,16,35,3,100
2046,40,50,75,125,3,100
2047,40,4,18,22,3,100
2048,40,17,67,84,3,100
2049,40,125,83,208,3,100
2050,40,27,32,59,3,100
2051,40,107,252,359,3,100
2052,40,78,90,168,3,100
2053,40,33,47,80,3,100
2054,40,137,111,248,3,100
2055,40,38,92,130,3,100
2056,40,39,56,95,3,100
2057,40,83,134,217,3,100
2058,40,110,99,209,3,100
2059,40,27,74,101,3,100
2060,40,98,55,153,3,100
2061,40,28,47,75,3,100
2062,40,65,68,133,3,100
2063,40,20,26,46,3,100
2064,40,120,51,171,3,100
2065,40,34,28,62,3,100
2066,40,37,33,70,3,100
2067,40,52,51,103,3,100
2068,40,7,13,20,3,100
2069,40,55,53,108,3,100
2070,40,49,82,131,3,100
2071,40,34,88,122,3,100
2072,40,8,27,35,3,100
2073,40,31,52,83,3,100
2074,40,59,131,190,3,100
2075,40,94,73,167,3,100
2076,40,46,66,112,3,100
2077,40,8,37,45,3,100
2078,40,8,10,18,3,100
2079,40,75,95,170,3,100
2080,40,29,30,59,3,100
2081,40,93,138,231,3,100
2082,40,99,114,213,3,100
2083,40,55,87,142,3,100
2084,40,32,56,88,3,100
2085,40,68,122,190,3,100
2086,40,43,141,184,3,100
2087,40,28,41,69,3,100
2088,40,93,117,210,3,100
2089,40,112,129,241,3,100
2090,40,26,33,59,3,100
2091,40,53,43,96,3,100
2092,40,69,101,170,3,100
2093,40,17,90,107,3,100
2094,40,31,41,72,3,100
2095,40,40,62,102,3,100
2096,40,9,18,27,3,100
2097,40,67,71,138,3,100
2098,40,76,100,176,3,100
2099,40,3,18,21,3,100
2100,40,14,47,61,3,100
2101,40,27,42,69,3,100
2102,40,81,96,177,3,100
2103,40,137,188,325,3,100
2104,40,164,189,353,3,100
2105,40,62,83,145,3,100
2106,40,37,69,106,3,100
2107,40,72,120,192,3,100
2108,40,20,26,46,3,100
2109,40,98,113,211,3,100
2110,40,8,14,22,3,100
2111,40,44,77,121,3,100
2112,40,68,59,127,3,100
2113,40,49,86,135,3,100
2114,40,27,23,50,3,100
2115,40,100,132,232,3,100
2116,40,61,115,176,3,100
2117,40,72,103,175,3,100
2118,40,22,19,41,3,100
2119,40,139,128,267,3,100
2120,40,31,50,81,3,100
2121,40,42,43,85,3,100
2122,40,5,12,17,3,100
2123,40,48,103,151,3,100
2124,40,18,17,35,3,100
2125,40,21,50,71,3,100
2126,40,52,51,103,3,100
2127,40,2,7,9,3,100
2128,40,1,6,7,3,100
2129,40,87,94,181,3,100
2130,40,195,224,419,3,100
2131,40,43,55,98,3,100
2132,40,85,88,173,3,100
2133,40,118,217,335,3,100
2134,40,53,81,134,3,100
2135,40,126,221,347,3,100
2136,40,80,81,161,3,100
2137,40,116,118,234,3,100
2138,40,127,133,260,3,100
2139,40,23,37,60,3,100
2140,40,64,29,93,3,100
2141,40,14,36,50,3,100
2142,40,30,51,81,3,100
2143,40,6,20,26,3,100
2144,40,12,30,42,3,100
2145,40,79,102,181,3,100
2146,40,37,58,95,3,100
2147,40,91,128,219,3,100
2148,40,22,32,54,3,100
2149,40,75,66,141,3,100
2150,40,168,237,405,3,100
2151,40,26,38,64,3,100
2152,40,52,51,103,3,100
2153,40,60,99,159,3,100
2154,40,98,132,230,3,100
2155,40,59,84,143,3,100
2156,40,58,67,125,3,100
2157,40,51,53,104,3,100
2158,40,33,77,110,3,100
2159,40,21,42,63,3,100
2160,40,22,29,51,3,100
2161,40,12,14,26,3,100
2162,40,7,17,24,3,100
2163,40,37,50,87,3,100
2164,40,75,107,182,3,100
2165,40,45,42,87,3,100
2166,40,119,149,268,3,100
2167,40,54,81,135,3,100
2168,40,6,5,11,3,100
2169,40,34,21,55,3,100
2170,40,90,102,192,3,100
2171,40,64,53,117,3,100
2172,40,63,174,237,3,100
2173,40,25,47,72,3,100
2174,40,40,61,101,3,100
2175,40,48,50,98,3,100
2176,40,48,88,136,3,100
2177,40,39,69,108,3,100
2178,40,72,96,168,3,100
2179,40,78,157,235,3,100
2180,40,76,93,169,3,100
2181,40,88,97,185,3,100
2182,40,49,73,122,3,100
2183,40,8,35,43,3,100
2184,40,89,160,249,3,100
2185,40,2,11,13,3,100
2186,40,58,141,199,3,100
2187,40,106,127,233,3,100
2188,40,29,81,110,3,100
2189,40,62,31,93,3,100
2190,40,30,24,54,3,100
2191,40,29,35,64,3,100
2192,40,90,78,168,3,100
2193,40,61,118,179,3,100
2194,40,14,16,30,3,100
2195,40,35,40,75,3,100
2196,40,2,9,11,3,100
2197,40,25,57,82,3,100
2198,40,25,11,36,3,100
2199,40,33,56,89,3,100
2200,40,116,156,272,3,100
2201,40,43,39,82,3,100
2202,40,36,71,107,3,100
2203,40,14,41,55,3,100
2204,40,95,111,206,3,100
2205,40,37,76,113,3,100
2206,40,22,61,83,3,100
2207,40,43,49,92,3,100
2208,40,10,51,61,3,100
2209,40,41,68,109,3,100
2210,40,93,111,204,3,100
2211,40,43,66,109,3,100
2212,40,53,81,134,3,100
2213,40,71,76,147,3,100
2214,40,23,11,34,3,100
2215,40,85,58,143,3,100
2216,40,88,183,271,3,100
2217,40,94,62,156,3,100
2218,40,88,59,147,3,100
2219,40,5,24,29,3,100
2220,40,103,137,240,3,100
2221,40,34,53,87,3,100
2222,40,6,30,36,3,100
2223,40,84,78,162,3,100
2224,40,39,133,172,3,100
2225,40,22,25,47,3,100
2226,40,21,34,55,3,100
2227,40,10,18,28,3,100
2228,40,33,49,82,3,100
2229,40,38,33,71,3,100
2230,40,31,37,68,3,100
2231,40,38,68,106,3,100
2232,40,27,38,65,3,100
2233,40,16,34,50,3,100
2234,40,30,33,63,3,100
2235,40,23,71,94,3,100
2236,40,25,103,128,3,100
2237,40,68,71,139,3,100
2238,40,39,73,112,3,100
2239,40,38,41,79,3,100
2240,40,52,71,123,3,100
2241,40,10,12,22,3,100
2242,40,35,83,118,3,100
2243,40,86,53,139,3,100
2244,40,87,101,188,3,100
2245,40,26,36,62,3,100
2246,40,41,70,111,3,100
2247,40,28,29,57,3,100
2248,40,27,75,102,3,100
2249,40,39,95,134,3,100
2250,40,15,24,39,3,100
2251,40,34,38,72,3,100
2252,40,33,65,98,3,100
2253,40,1,3,4,3,100
2254,40,13,34,47,3,100
2255,40,61,86,147,3,100
2256,40,84,157,241,3,100
2257,40,45,56,101,3,100
2258,40,29,65,94,3,100
2259,40,98,133,231,3,100
2260,40,32,51,83,3,100
2261,40,35,82,117,3,100
2262,40,89,113,202,3,100
2263,40,25,49,74,3,100
2264,40,21,135,156,3,100
2265,40,76,147,223,3,100
2266,40,95,135,230,3,100
2267,40,87,106,193,3,100
2268,40,80,79,159,3,100
2269,40,0,14,14,3,100
2270,40,48,41,89,3,100
2271,40,110,118,228,3,100
2272,40,51,45,96,3,100
2273,40,161,212,373,3,100
2274,40,102,106,208,3,100
2275,40,123,156,279,3,100
2276,40,49,28,77,3,100
2277,40,105,152,257,3,100
2278,40,24,36,60,3,100
2279,40,65,73,138,3,100
2280,40,27,68,95,3,100
2281,40,84,106,190,3,100
2282,40,95,103,198,3,100
2283,40,97,78,175,3,100
2284,40,68,90,158,3,100
2285,40,3,16,19,3,100
2286,40,58,90,148,3,100
2287,40,13,28,41,3,100
2288,40,140,173,313,3,100
2289,40,16,31,47,3,100
2290,40,114,65,179,3,100
2291,40,55,76,131,3,100
2292,40,45,61,106,3,100
2293,40,40,205,245,3,100
2294,40,32,43,75,3,100
2295,40,52,103,155,3,100
2296,40,29,43,72,3,100
2297,40,61,65,126,3,100
2298,40,70,42,112,3,100
2299,40,55,42,97,3,100
2300,40,51,63,114,3,100
2301,40,19,24,43,3,100
2302,40,12,15,27,3,100
2303,40,13,15,28,3,100
2304,40,12,19,31,3,100
2305,40,10,13,23,3,100
2306,40,39,44,83,3,100
2307,40,61,85,146,3,100
2308,40,31,48,79,3,100
2309,40,39,105,144,3,100
2310,40,36,70,106,3,100
2311,40,54,89,143,3,100
2312,40,50,99,149,3,100
2313,40,85,149,234,3,100
2314,40,89,99,188,3,100
2315,40,22,17,39,3,100
2316,40,108,171,279,3,100
2317,40,38,26,64,3,100
2318,40,74,87,161,3,100
2319,40,81,57,138,3,100
2320,40,38,100,138,3,100
2321,40,40,85,125,3,100
2322,40,69,81,150,3,100
2323,40,57,101,158,3,100
2324,40,58,138,196,3,100
2325,40,20,28,48,3,100
2326,40,89,84,173,3,100
2327,40,78,112,190,3,100
2328,40,47,55,102,3,100
2329,40,52,68,120,3,100
2330,40,112,113,225,3,100
2331,40,42,74,116,3,100
2332,40,71,64,135,3,100
2333,40,29,42,71,3,100
2334,40,24,63,87,3,100
2335,40,46,43,89,3,100
2336,40,36,51,87,3,100
2337,40,97,86,183,3,100
2338,40,79,122,201,3,100
2339,40,45,56,101,3,100
2340,40,93,151,244,3,100
2341,40,71,81,152,3,100
2342,40,58,85,143,3,100
2343,40,42,38,80,3,100
2344,40,77,105,182,3,100
2345,40,99,157,256,3,100
2346,40,79,73,152,3,100
2347,40,170,169,339,3,100
2348,40,66,54,120,3,100
2349,40,1,15,16,3,100
2350,40,32,10,42,3,100
2351,40,47,83,130,3,100
2352,40,170,369,539,3,100
2353,40,87,72,159,3,100
2354,40,72,31,103,3,100
2355,40,89,59,148,3,100
2356,40,100,95,195,3,100
2357,40,41,40,81,3,100
2358,40,52,70,122,3,100
2359,40,91,100,191,3,100
2360,40,63,85,148,3,100
2361,40,94,81,175,3,100
2362,40,144,182,326,3,100
2363,40,15,42,57,3,100
2364,40,14,54,68,3,100
2365,40,95,137,232,3,100
2366,40,27,30,57,3,100
2367,40,74,108,182,3,100
2368,40,36,67,103,3,100
2369,40,65,113,178,3,100
2370,40,48,52,100,3,100
2371,40,100,44,144,3,100
2372,40,89,75,164,3,100
2373,40,122,116,238,3,100
2374,40,47,43,90,3,100
2375,40,51,47,98,3,100
2376,40,82,66,148,3,100
2377,40,25,63,88,3,100
2378,40,45,76,121,3,100
2379,40,83,107,190,3,100
2380,40,49,101,150,3,100
2381,40,49,78,127,3,100
2382,40,34,14,48,3,100
2383,40,36,94,130,3,100
2384,40,109,152,261,3,100
2385,40,77,93,170,3,100
2386,40,90,116,206,3,100
2387,40,52,42,94,3,100
2388,40,51,67,118,3,100
2389,40,33,53,86,3,100
2390,40,41,50,91,3,100
2391,40,52,150,202,3,100
2392,40,4,12,16,3,100
2393,40,102,96,198,3,100
2394,40,27,39,66,3,100
2395,40,4,16,20,3,100
2396,40,57,69,126,3,100
2397,40,2,5,7,3,100
2398,40,3,7,10,3,100
2399,40,52,52,104,3,100
2400,40,63,84,147,3,100
2401,40,26,44,70,3,100
2402,40,49,102,151,3,100
2403,40,42,63,105,3,100
2404,40,61,71,132,3,100
2405,40,36,49,85,3,100
2406,40,69,65,134,3,100
2407,40,47,101,148,3,100
2408,40,69,85,154,3,100
2409,40,89,110,199,3,100
2410,40,29,67,96,3,100
2411,40,47,81,128,3,100
2412,40,59,94,153,3,100
2413,40,20,15,35,3,100
2414,40,16,43,59,3,100
2415,50,32,57,89,3,100
2416,50,23,48,71,3,100
2417,50,84,77,161,3,100
2418,50,70,165,235,3,100
2419,50,29,62,91,3,100
2420,50,60,52,112,3,100
2421,50,63,108,171,3,100
2422,50,334,310,644,3,100
2423,50,105,186,291,3,100
2424,50,135,235,370,3,100
2425,50,112,168,280,3,100
2426,50,114,133,247,3,100
2427,50,99,156,255,3,100
2428,50,18,54,72,3,100
2429,50,92,80,172,3,100
2430,50,100,112,212,3,100
2431,50,54,35,89,3,100
2432,50,38,45,83,3,100
2433,50,49,88,137,3,100
2434,50,75,102,177,3,100
2435,50,48,100,148,3,100
2436,50,59,146,205,3,100
2437,50,7,25,32,3,100
2438,50,129,188,317,3,100
2439,50,35,80,115,3,100
2440,50,110,229,339,3,100
2441,50,45,40,85,3,100
2442,50,102,136,238,3,100
2443,50,73,126,199,3,100
2444,50,53,89,142,3,100
2445,50,38,58,96,3,100
2446,50,38,31,69,3,100
2447,50,88,113,201,3,100
2448,50,19,32,51,3,100
2449,50,18,30,48,3,100
2450,50,21,58,79,3,100
2451,50,42,62,104,3,100
2452,50,11,25,36,3,100
2453,50,111,108,219,3,100
2454,50,14,28,42,3,100
2455,50,40,91,131,3,100
2456,50,14,11,25,3,100
2457,50,37,27,64,3,100
2458,50,145,241,386,3,100
2459,50,16,83,99,3,100
2460,50,85,125,210,3,100
2461,50,107,230,337,3,100
2462,50,79,137,216,3,100
2463,50,86,48,134,3,100
2464,50,86,111,197,3,100
2465,50,61,113,174,3,100
2466,50,61,121,182,3,100
2467,50,20,39,59,3,100
2468,50,72,185,257,3,100
2469,50,163,170,333,3,100
2470,50,93,118,211,3,100
2471,50,43,74,117,3,100
2472,50,50,66,116,3,100
2473,50,53,101,154,3,100
2474,50,108,144,252,3,100
2475,50,26,32,58,3,100
2476,50,37,78,115,3,100
2477,50,14,49,63,3,100
2478,50,63,49,112,3,100
2479,50,25,49,74,3,100
2480,50,35,104,139,3,100
2481,50,22,7,29,3,100
2482,50,77,119,196,3,100
2483,50,110,156,266,3,100
2484,50,89,101,190,3,100
2485,50,61,101,162,3,100
2486,50,58,159,217,3,100
2487,50,24,28,52,3,100
2488,50,69,81,150,3,100
2489,50,99,141,240,3,100
2490,50,60,109,169,3,100
2491,50,59,35,94,3,100
2492,50,117,148,265,3,100
2493,50,37,33,70,3,100
2494,50,38,52,90,3,100
2495,50,112,81,193,3,100
2496,50,39,47,86,3,100
2497,50,60,65,125,3,100
2498,50,59,66,125,3,100
2499,50,59,108,167,3,100
2500,50,2,5,7,3,100
2501,50,14,26,40,3,100
2502,50,8,11,19,3,100
2503,50,35,49,84,3,100
2504,50,134,107,241,3,100
2505,50,161,225,386,3,100
2506,50,128,195,323,3,100
2507,50,55,87,142,3,100
2508,50,53,76,129,3,100
2509,50,183,222,405,3,100
2510,50,99,156,255,3,100
2511,50,134,193,327,3,100
2512,50,83,197,280,3,100
2513,50,160,191,351,3,100
2514,50,38,77,115,3,100
2515,50,127,147,274,3,100
2516,50,46,33,79,3,100
2517,50,28,52,80,3,100
2518,50,28,48,76,3,100
2519,50,127,211,338,3,100
2520,50,12,28,40,3,100
2521,50,46,78,124,3,100
2522,50,82,124,206,3,100
2523,50,109,173,282,3,100
2524,50,136,202,338,3,100
2525,50,58,51,109,3,100
2526,50,106,107,213,3,100
2527,50,105,110,215,3,100
2528,50,44,137,181,3,100
2529,50,83,122,205,3,100
2530,50,54,77,131,3,100
2531,50,5,19,24,3,100
2532,50,26,45,71,3,100
2533,50,6,7,13,3,100
2534,50,35,78,113,3,100
2535,50,107,159,266,3,100
2536,50,47,87,134,3,100
2537,50,60,78,138,3,100
2538,50,51,228,279,3,100
2539,50,99,183,282,3,100
2540,50,60,112,172,3,100
2541,50,33,60,93,3,100
2542,50,152,257,409,3,100
2543,50,76,109,185,3,100
2544,50,29,85,114,3,100
2545,50,104,207,311,3,100
2546,50,83,126,209,3,100
2547,50,102,177,279,3,100
2548,50,139,108,247,3,100
2549,50,98,227,325,3,100
2550,50,68,93,161,3,100
2551,50,110,120,230,3,100
2552,50,65,58,123,3,100
2553,50,68,132,200,3,100
2554,50,65,116,181,3,100
2555,50,21,51,72,3,100
2556,50,6,14,20,3,100
2557,50,63,12,75,3,100
2558,50,71,129,200,3,100
2559,50,51,86,137,3,100
2560,50,99,72,171,3,100
2561,50,46,85,131,3,100
2562,50,66,73,139,3,100
2563,50,100,155,255,3,100
2564,50,75,130,205,3,100
2565,50,56,80,136,3,100
2566,50,117,176,293,3,100
2567,50,92,67,159,3,100
2568,50,41,20,61,3,100
2569,50,83,164,247,3,100
2570,50,58,60,118,3,100
2571,50,79,145,224,3,100
2572,50,124,99,223,3,100
2573,50,95,100,195,3,100
2574,50,117,154,271,3,100
2575,50,51,109,160,3,100
2576,50,41,59,100,3,100
2577,50,15,26,41,3,100
2578,50,77,170,247,3,100
2579,50,113,182,295,3,100
2580,50,27,38,65,3,100
2581,50,21,48,69,3,100
2582,50,22,59,81,3,100
2583,50,103,147,250,3,100
2584,50,107,187,294,3,100
2585,50,24,139,163,3,100
2586,50,112,109,221,3,100
2587,50,91,130,221,3,100
2588,50,125,191,316,3,100
2589,50,22,45,67,3,100
2590,50,120,204,324,3,100
2591,50,31,58,89,3,100
2592,50,141,196,337,3,100
2593,50,17,105,122,3,100
2594,50,40,49,89,3,100
2595,50,91,97,188,3,100
2596,50,18,78,96,3,100
2597,50,18,42,60,3,100
2598,50,3,1,4,3,100
2599,50,21,50,71,3,100
2600,50,153,107,260,3,100
2601,50,57,104,161,3,100
2602,50,102,167,269,3,100
2603,50,81,83,164,3,100
2604,50,95,121,216,3,100
2605,50,113,150,263,3,100
2606,50,42,63,105,3,100
2607,50,109,138,247,3,100
2608,50,87,146,233,3,100
2609,50,5,21,26,3,100
2610,50,43,122,165,3,100
2611,50,41,49,90,3,100
2612,50,8,26,34,3,100
2613,50,50,83,133,3,100
2614,50,76,91,167,3,100
2615,50,73,91,164,3,100
2616,50,35,85,120,3,100
2617,50,55,106,161,3,100
2618,50,86,91,177,3,100
2619,50,100,178,278,3,100
2620,50,32,104,136,3,100
2621,50,86,100,186,3,100
2622,50,14,77,91,3,100
2623,50,37,49,86,3,100
2624,50,69,122,191,3,100
2625,50,77,133,210,3,100
2626,50,120,204,324,3,100
2627,50,68,102,170,3,100
2628,50,55,50,105,3,100
2629,50,60,89,149,3,100
2630,50,44,68,112,3,100
2631,50,41,92,133,3,100
2632,50,55,89,144,3,100
2633,50,14,9,23,3,100
2634,50,11,35,46,3,100
2635,50,66,66,132,3,100
2636,50,86,58,144,3,100
2637,50,67,117,184,3,100
2638,50,104,176,280,3,100
2639,50,150,209,359,3,100
2640,50,31,85,116,3,100
2641,50,155,340,495,3,100
2642,50,25,53,78,3,100
2643,50,37,93,130,3,100
2644,50,135,294,429,3,100
2645,50,10,8,18,3,100
2646,50,20,34,54,3,100
2647,50,63,120,183,3,100
2648,50,12,11,23,3,100
2649,50,26,107,133,3,100
2650,50,149,185,334,3,100
2651,50,32,47,79,3,100
2652,50,30,25,55,3,100
2653,50,29,48,77,3,100
2654,50,41,59,100,3,100
2655,50,6,12,18,3,100
2656,50,59,82,141,3,100
2657,50,72,115,187,3,100
2658,50,13,76,89,3,100
2659,50,84,46,130,3,100
2660,50,38,54,92,3,100
2661,50,146,231,377,3,100
2662,50,122,149,271,3,100
2663,50,13,31,44,3,100
2664,50,95,154,249,3,100
2665,50,60,85,145,3,100
2666,50,10,37,47,3,100
2667,50,124,95,219,3,100
2668,50,146,138,284,3,100
2669,50,58,137,195,3,100
2670,50,1,10,11,3,100
2671,50,9,18,27,3,100
2672,50,54,123,177,3,100
2673,50,31,75,106,3,100
2674,50,91,137,228,3,100
2675,50,49,118,167,3,100
2676,50,50,93,143,3,100
2677,50,50,90,140,3,100
2678,50,14,58,72,3,100
2679,50,79,151,230,3,100
2680,50,44,67,111,3,100
2681,50,47,102,149,3,100
2682,50,44,62,106,3,100
2683,50,37,41,78,3,100
2684,50,27,26,53,3,100
2685,50,26,34,60,3,100
2686,50,71,76,147,3,100
2687,50,6,10,16,3,100
2688,50,91,141,232,3,100
2689,50,50,107,157,3,100
2690,50,7,45,52,3,100
2691,50,189,253,442,3,100
2692,50,48,78,126,3,100
2693,50,61,119,180,3,100
2694,50,14,38,52,3,100
2695,50,31,69,100,3,100
2696,50,42,76,118,3,100
2697,50,83,186,269,3,100
2698,50,138,178,316,3,100
2699,50,5,18,23,3,100
2700,50,99,59,158,3,100
2701,50,61,69,130,3,100
2702,50,50,59,109,3,100
2703,50,81,73,154,3,100
2704,50,45,52,97,3,100
2705,50,133,198,331,3,100
2706,50,17,37,54,3,100
2707,50,22,81,103,3,100
2708,50,67,126,193,3,100
2709,50,17,70,87,3,100
2710,50,67,91,158,3,100
2711,50,33,38,71,3,100
2712,50,52,72,124,3,100
2713,50,13,12,25,3,100
2714,50,28,82,110,3,100
2715,50,97,118,215,3,100
2716,50,37,70,107,3,100
2717,50,89,95,184,3,100
2718,50,4,11,15,3,100
2719,50,97,147,244,3,100
2720,50,15,226,241,3,100
2721,50,114,437,551,3,100
2722,50,80,122,202,3,100
2723,50,55,105,160,3,100
2724,50,62,100,162,3,100
2725,50,102,141,243,3,100
2726,50,25,39,64,3,100
2727,50,58,87,145,3,100
2728,50,16,25,41,3,100
2729,50,76,90,166,3,100
2730,50,4,6,10,3,100
2731,50,30,27,57,3,100
2732,50,14,17,31,3,100
2733,50,29,32,61,3,100
2734,50,28,62,90,3,100
2735,50,60,129,189,3,100
2736,50,40,26,66,3,100
2737,50,60,84,144,3,100
2738,50,20,63,83,3,100
2739,50,96,116,212,3,100
2740,50,55,76,131,3,100
2741,50,47,73,120,3,100
2742,50,42,42,84,3,100
2743,50,69,147,216,3,100
2744,50,38,90,128,3,100
2745,50,71,123,194,3,100
2746,50,34,113,147,3,100
2747,50,134,132,266,3,100
2748,50,53,113,166,3,100
2749,50,26,53,79,3,100
2750,50,73,125,198,3,100
2751,50,48,179,227,3,100
2752,50,73,123,196,3,100
2753,50,2,11,13,3,100
2754,50,66,66,132,3,100
2755,50,50,91,141,3,100
2756,50,4,18,22,3,100
2757,50,32,40,72,3,100
2758,50,15,24,39,3,100
2759,50,63,121,184,3,100
2760,50,31,61,92,3,100
2761,50,66,130,196,3,100
2762,50,300,457,757,3,100
2763,50,83,163,246,3,100
2764,50,119,174,293,3,100
2765,50,37,60,97,3,100
2766,50,39,102,141,3,100
2767,50,19,34,53,3,100
2768,50,95,128,223,3,100
2769,50,53,90,143,3,100
2770,50,38,90,128,3,100
2771,50,35,85,120,3,100
2772,50,102,190,292,3,100
2773,50,17,44,61,3,100
2774,50,80,108,188,3,100
2775,50,149,161,310,3,100
2776,50,168,232,400,3,100
2777,50,93,133,226,3,100
2778,50,126,158,284,3,100
2779,50,71,97,168,3,100
2780,50,162,209,371,3,100
2781,50,105,72,177,3,100
2782,50,52,136,188,3,100
2783,50,90,126,216,3,100
2784,50,27,65,92,3,100
2785,50,132,155,287,3,100
2786,50,50,87,137,3,100
2787,50,36,68,104,3,100
2788,50,74,114,188,3,100
2789,50,73,93,166,3,100
2790,50,27,41,68,3,100
2791,50,46,45,91,3,100
2792,50,19,23,42,3,100
2793,50,15,50,65,3,100
2794,50,85,109,194,3,100
2795,50,13,27,40,3,100
2796,50,100,215,315,3,100
2797,50,57,83,140,3,100
2798,50,98,166,264,3,100
2799,50,13,38,51,3,100
2800,50,4,11,15,3,100
2801,50,114,195,309,3,100
2802,50,49,86,135,3,100
2803,50,67,90,157,3,100
2804,50,55,97,152,3,100
2805,50,66,67,133,3,100
2806,50,16,57,73,3,100
2807,50,35,33,68,3,100
2808,50,41,107,148,3,100
2809,50,37,75,112,3,100
2810,50,124,152,276,3,100
2811,50,65,107,172,3,100
2812,50,48,83,131,3,100
2813,50,31,21,52,3,100
2814,50,62,109,171,3,100
2815,50,54,77,131,3,100
2816,50,68,137,205,3,100
2817,50,43,77,120,3,100
2818,50,31,59,90,3,100
2819,50,37,74,111,3,100
2820,50,27,37,64,3,100
2821,50,83,122,205,3,100
2822,50,74,63,137,3,100
2823,50,79,55,134,3,100
2824,50,77,76,153,3,100
2825,50,29,60,89,3,100
2826,50,39,112,151,3,100
2827,50,32,55,87,3,100
2828,50,56,83,139,3,100
2829,50,50,122,172,3,100
2830,50,125,171,296,3,100
2831,50,86,145,231,3,100
2832,50,88,162,250,3,100
2833,50,57,97,154,3,100
2834,50,91,137,228,3,100
2835,50,111,122,233,3,100
2836,50,64,105,169,3,100
2837,50,63,74,137,3,100
2838,50,178,76,254,3,100
2839,50,120,245,365,3,100
2840,50,113,148,261,3,100
2841,50,74,57,131,3,100
2842,50,29,47,76,3,100
2843,50,31,72,103,3,100
2844,50,65,93,158,3,100
2845,50,101,62,163,3,100
2846,50,54,118,172,3,100
2847,50,68,91,159,3,100
2848,50,81,136,217,3,100
2849,50,166,241,407,3,100
2850,50,66,123,189,3,100
2851,50,33,23,56,3,100
2852,50,103,108,211,3,100
2853,50,24,34,58,3,100
2854,50,64,113,177,3,100
2855,50,110,123,233,3,100
2856,50,21,51,72,3,100
2857,50,72,152,224,3,100
2858,50,72,81,153,3,100
2859,50,166,208,374,3,100
2860,50,35,63,98,3,100
2861,50,5,38,43,3,100
2862,50,173,195,368,3,100
2863,50,10,46,56,3,100
2864,50,77,130,207,3,100
2865,50,98,167,265,3,100
2866,50,89,157,246,3,100
2867,50,93,156,249,3,100
2868,50,81,49,130,3,100
2869,50,65,135,200,3,100
2870,50,79,92,171,3,100
2871,50,117,171,288,3,100
2872,50,63,147,210,3,100
2873,50,58,57,115,3,100
2874,50,63,74,137,3,100
2875,50,13,32,45,3,100
2876,50,55,123,178,3,100
2877,50,37,58,95,3,100
2878,50,61,100,161,3,100
2879,50,64,122,186,3,100
2880,50,44,117,161,3,100
2881,50,57,123,180,3,100
2882,50,133,162,295,3,100
2883,50,121,184,305,3,100
2884,50,118,174,292,3,100
2885,50,81,154,235,3,100
2886,50,26,42,68,3,100
2887,50,33,90,123,3,100
2888,50,19,50,69,3,100
2889,50,94,110,204,3,100
2890,50,61,87,148,3,100
2891,50,13,47,60,3,100
2892,50,45,40,85,3,100
2893,50,96,160,256,3,100
2894,50,40,87,127,3,100
2895,50,52,156,208,3,100
2896,50,6,13,19,3,100
2897,50,26,89,115,3,100
2898,50,44,54,98,3,100
2899,50,106,247,353,3,100
2900,50,13,41,54,3,100
2901,50,59,42,101,3,100
2902,50,11,25,36,3,100
2903,50,93,111,204,3,100
2904,50,83,96,179,3,100
2905,50,32,86,118,3,100
2906,50,117,134,251,3,100
2907,50,23,65,88,3,100
2908,50,13,29,42,3,100
2909,50,17,28,45,3,100
2910,50,107,122,229,3,100
2911,50,22,42,64,3,100
2912,50,61,60,121,3,100
2913,50,15,21,36,3,100
2914,50,52,69,121,3,100
2915,50,81,110,191,3,100
2916,50,73,144,217,3,100
2917,50,44,68,112,3,100
2918,50,53,116,169,3,100
2919,50,27,60,87,3,100
2920,50,82,139,221,3,100
2921,50,75,173,248,3,100
2922,50,49,85,134,3,100
2923,50,17,74,91,3,100
2924,50,30,91,121,3,100
2925,50,11,38,49,3,100
2926,50,22,42,64,3,100
2927,50,51,87,138,3,100
2928,50,90,75,165,3,100
2929,50,81,103,184,3,100
2930,50,42,88,130,3,100
2931,50,52,93,145,3,100
2932,50,87,137,224,3,100
2933,50,55,88,143,3,100
2934,50,60,60,120,3,100
2935,50,114,143,257,3,100
2936,50,72,94,166,3,100
2937,50,67,126,193,3,100
2938,50,45,98,143,3,100
2939,50,30,85,115,3,100
2940,50,61,82,143,3,100
2941,50,182,206,388,3,100
2942,50,15,25,40,3,100
2943,50,14,52,66,3,100
2944,60,48,101,149,3,100
2945,60,35,47,82,3,100
2946,60,200,213,413,3,100
2947,60,140,171,311,3,100
2948,60,112,198,310,3,100
2949,60,50,124,174,3,100
2950,60,147,185,332,3,100
2951,60,234,463,697,3,100
2952,60,120,225,345,3,100
2953,60,95,168,263,3,100
2954,60,179,263,442,3,100
2955,60,124,174,298,3,100
2956,60,99,192,291,3,100
2957,60,95,141,236,3,100
2958,60,73,122,195,3,100
2959,60,96,79,175,3,100
2960,60,20,80,100,3,100
2961,60,47,117,164,3,100
2962,60,41,100,141,3,100
2963,60,58,89,147,3,100
2964,60,140,197,337,3,100
2965,60,42,47,89,3,100
2966,60,70,94,164,3,100
2967,60,87,157,244,3,100
2968,60,30,97,127,3,100
2969,60,44,81,125,3,100
2970,60,124,235,359,3,100
2971,60,81,101,182,3,100
2972,60,147,193,340,3,100
2973,60,164,177,341,3,100
2974,60,61,128,189,3,100
2975,60,30,96,126,3,100
2976,60,94,176,270,3,100
2977,60,19,40,59,3,100
2978,60,151,117,268,3,100
2979,60,4,16,20,3,100
2980,60,14,32,46,3,100
2981,60,98,241,339,3,100
2982,60,96,174,270,3,100
2983,60,27,46,73,3,100
2984,60,64,87,151,3,100
2985,60,75,170,245,3,100
2986,60,73,161,234,3,100
2987,60,62,89,151,3,100
2988,60,105,177,282,3,100
2989,60,79,211,290,3,100
2990,60,110,225,335,3,100
2991,60,44,37,81,3,100
2992,60,100,227,327,3,100
2993,60,110,114,224,3,100
2994,60,100,143,243,3,100
2995,60,86,155,241,3,100
2996,60,23,57,80,3,100
2997,60,8,22,30,3,100
2998,60,52,72,124,3,100
2999,60,50,80,130,3,100
3000,60,142,191,333,3,100
3001,60,108,217,325,3,100
3002,60,86,212,298,3,100
3003,60,29,53,82,3,100
3004,60,38,78,116,3,100
3005,60,50,177,227,3,100
3006,60,222,318,540,3,100
3007,60,29,40,69,3,100
3008,60,151,219,370,3,100
3009,60,28,81,109,3,100
3010,60,59,160,219,3,100
3011,60,129,201,330,3,100
3012,60,189,281,470,3,100
3013,60,54,62,116,3,100
3014,60,83,244,327,3,100
3015,60,105,103,208,3,100
3016,60,80,181,261,3,100
3017,60,203,191,394,3,100
3018,60,96,91,187,3,100
3019,60,74,86,160,3,100
3020,60,131,183,314,3,100
3021,60,133,278,411,3,100
3022,60,196,268,464,3,100
3023,60,91,200,291,3,100
3024,60,82,122,204,3,100
3025,60,51,92,143,3,100
3026,60,100,148,248,3,100
3027,60,82,143,225,3,100
3028,60,80,123,203,3,100
3029,60,116,295,411,3,100
3030,60,66,70,136,3,100
3031,60,68,174,242,3,100
3032,60,145,366,511,3,100
3033,60,76,106,182,3,100
3034,60,45,133,178,3,100
3035,60,120,235,355,3,100
3036,60,60,115,175,3,100
3037,60,28,79,107,3,100
3038,60,44,82,126,3,100
3039,60,60,134,194,3,100
3040,60,121,228,349,3,100
3041,60,48,129,177,3,100
3042,60,94,174,268,3,100
3043,60,126,294,420,3,100
3044,60,67,115,182,3,100
3045,60,96,155,251,3,100
3046,60,89,67,156,3,100
3047,60,124,210,334,3,100
3048,60,138,148,286,3,100
3049,60,84,133,217,3,100
3050,60,95,122,217,3,100
3051,60,46,109,155,3,100
3052,60,77,95,172,3,100
3053,60,106,152,258,3,100
3054,60,85,156,241,3,100
3055,60,136,298,434,3,100
3056,60,50,71,121,3,100
3057,60,59,91,150,3,100
3058,60,27,51,78,3,100
3059,60,93,75,168,3,100
3060,60,98,137,235,3,100
3061,60,84,157,241,3,100
3062,60,83,165,248,3,100
3063,60,32,38,70,3,100
3064,60,56,106,162,3,100
3065,60,61,89,150,3,100
3066,60,51,51,102,3,100
3067,60,122,209,331,3,100
3068,60,195,304,499,3,100
3069,60,73,150,223,3,100
3070,60,82,154,236,3,100
3071,60,60,68,128,3,100
3072,60,125,231,356,3,100
3073,60,123,180,303,3,100
3074,60,41,58,99,3,100
3075,60,105,230,335,3,100
3076,60,110,121,231,3,100
3077,60,42,45,87,3,100
3078,60,73,178,251,3,100
3079,60,93,148,241,3,100
3080,60,46,90,136,3,100
3081,60,75,112,187,3,100
3082,60,69,150,219,3,100
3083,60,31,71,102,3,100
3084,60,26,38,64,3,100
3085,60,77,229,306,3,100
3086,60,110,164,274,3,100
3087,60,9,24,33,3,100
3088,60,35,44,79,3,100
3089,60,29,54,83,3,100
3090,60,12,37,49,3,100
3091,60,48,62,110,3,100
3092,60,48,110,158,3,100
3093,60,112,196,308,3,100
3094,60,171,203,374,3,100
3095,60,162,222,384,3,100
3096,60,62,180,242,3,100
3097,60,52,127,179,3,100
3098,60,136,297,433,3,100
3099,60,38,115,153,3,100
3100,60,26,53,79,3,100
3101,60,108,149,257,3,100
3102,60,54,82,136,3,100
3103,60,86,115,201,3,100
3104,60,70,119,189,3,100
3105,60,60,147,207,3,100
3106,60,43,87,130,3,100
3107,60,18,25,43,3,100
3108,60,14,13,27,3,100
3109,60,73,96,169,3,100
3110,60,140,241,381,3,100
3111,60,100,164,264,3,100
3112,60,55,123,178,3,100
3113,60,126,281,407,3,100
3114,60,61,106,167,3,100
3115,60,71,111,182,3,100
3116,60,75,133,208,3,100
3117,60,71,94,165,3,100
3118,60,127,205,332,3,100
3119,60,6,20,26,3,100
3120,60,9,26,35,3,100
3121,60,48,91,139,3,100
3122,60,19,23,42,3,100
3123,60,30,38,68,3,100
3124,60,84,115,199,3,100
3125,60,103,146,249,3,100
3126,60,55,150,205,3,100
3127,60,42,90,132,3,100
3128,60,73,104,177,3,100
3129,60,99,198,297,3,100
3130,60,28,70,98,3,100
3131,60,40,75,115,3,100
3132,60,77,106,183,3,100
3133,60,128,234,362,3,100
3134,60,94,186,280,3,100
3135,60,36,47,83,3,100
3136,60,27,67,94,3,100
3137,60,88,153,241,3,100
3138,60,12,36,48,3,100
3139,60,46,67,113,3,100
3140,60,93,210,303,3,100
3141,60,63,136,199,3,100
3142,60,92,178,270,3,100
3143,60,48,79,127,3,100
3144,60,37,84,121,3,100
3145,60,151,381,532,3,100
3146,60,58,113,171,3,100
3147,60,42,131,173,3,100
3148,60,58,143,201,3,100
3149,60,41,115,156,3,100
3150,60,26,89,115,3,100
3151,60,83,211,294,3,100
3152,60,251,287,538,3,100
3153,60,229,245,474,3,100
3154,60,56,144,200,3,100
3155,60,55,94,149,3,100
3156,60,50,73,123,3,100
3157,60,64,174,238,3,100
3158,60,63,120,183,3,100
3159,60,38,87,125,3,100
3160,60,55,135,190,3,100
3161,60,139,204,343,3,100
3162,60,107,235,342,3,100
3163,60,12,16,28,3,100
3164,60,22,62,84,3,100
3165,60,103,208,311,3,100
3166,60,10,44,54,3,100
3167,60,76,160,236,3,100
3168,60,31,49,80,3,100
3169,60,77,178,255,3,100
3170,60,33,51,84,3,100
3171,60,97,118,215,3,100
3172,60,16,41,57,3,100
3173,60,99,174,273,3,100
3174,60,61,151,212,3,100
3175,60,67,95,162,3,100
3176,60,61,85,146,3,100
3177,60,57,95,152,3,100
3178,60,26,75,101,3,100
3179,60,74,138,212,3,100
3180,60,97,133,230,3,100
3181,60,20,29,49,3,100
3182,60,62,112,174,3,100
3183,60,118,230,348,3,100
3184,60,10,39,49,3,100
3185,60,55,90,145,3,100
3186,60,93,202,295,3,100
3187,60,149,311,460,3,100
3188,60,28,29,57,3,100
3189,60,159,288,447,3,100
3190,60,153,341,494,3,100
3191,60,74,148,222,3,100
3192,60,151,207,358,3,100
3193,60,103,265,368,3,100
3194,60,56,59,115,3,100
3195,60,8,54,62,3,100
3196,60,2,13,15,3,100
3197,60,61,97,158,3,100
3198,60,55,70,125,3,100
3199,60,8,30,38,3,100
3200,60,72,158,230,3,100
3201,60,15,23,38,3,100
3202,60,18,102,120,3,100
3203,60,97,112,209,3,100
3204,60,55,91,146,3,100
3205,60,17,39,56,3,100
3206,60,10,41,51,3,100
3207,60,56,133,189,3,100
3208,60,192,249,441,3,100
3209,60,113,141,254,3,100
3210,60,100,170,270,3,100
3211,60,22,48,70,3,100
3212,60,80,62,142,3,100
3213,60,51,76,127,3,100
3214,60,47,72,119,3,100
3215,60,43,36,79,3,100
3216,60,51,43,94,3,100
3217,60,67,130,197,3,100
3218,60,158,190,348,3,100
3219,60,85,142,227,3,100
3220,60,21,94,115,3,100
3221,60,36,96,132,3,100
3222,60,32,19,51,3,100
3223,60,113,194,307,3,100
3224,60,20,39,59,3,100
3225,60,52,158,210,3,100
3226,60,86,107,193,3,100
3227,60,63,121,184,3,100
3228,60,148,141,289,3,100
3229,60,52,92,144,3,100
3230,60,54,41,95,3,100
3231,60,108,90,198,3,100
3232,60,47,36,83,3,100
3233,60,142,172,314,3,100
3234,60,13,27,40,3,100
3235,60,45,126,171,3,100
3236,60,76,75,151,3,100
3237,60,32,202,234,3,100
3238,60,51,110,161,3,100
3239,60,66,49,115,3,100
3240,60,39,83,122,3,100
3241,60,76,90,166,3,100
3242,60,107,162,269,3,100
3243,60,136,272,408,3,100
3244,60,85,140,225,3,100
3245,60,122,197,319,3,100
3246,60,100,134,234,3,100
3247,60,91,63,154,3,100
3248,60,94,101,195,3,100
3249,60,29,77,106,3,100
3250,60,77,160,237,3,100
3251,60,49,95,144,3,100
3252,60,132,224,356,3,100
3253,60,73,93,166,3,100
3254,60,41,86,127,3,100
3255,60,18,141,159,3,100
3256,60,13,39,52,3,100
3257,60,140,225,365,3,100
3258,60,118,174,292,3,100
3259,60,132,118,250,3,100
3260,60,93,113,206,3,100
3261,60,116,181,297,3,100
3262,60,91,104,195,3,100
3263,60,88,116,204,3,100
3264,60,40,111,151,3,100
3265,60,143,212,355,3,100
3266,60,167,252,419,3,100
3267,60,112,277,389,3,100
3268,60,18,28,46,3,100
3269,60,76,92,168,3,100
3270,60,96,154,250,3,100
3271,60,75,139,214,3,100
3272,60,55,82,137,3,100
3273,60,21,59,80,3,100
3274,60,68,150,218,3,100
3275,60,129,120,249,3,100
3276,60,53,135,188,3,100
3277,60,106,146,252,3,100
3278,60,134,181,315,3,100
3279,60,90,204,294,3,100
3280,60,40,50,90,3,100
3281,60,41,42,83,3,100
3282,60,118,199,317,3,100
3283,60,75,108,183,3,100
3284,60,97,128,225,3,100
3285,60,32,29,61,3,100
3286,60,31,48,79,3,100
3287,60,36,74,110,3,100
3288,60,14,40,54,3,100
3289,60,2,26,28,3,100
3290,60,19,15,34,3,100
3291,60,12,21,33,3,100
3292,60,104,169,273,3,100
3293,60,17,46,63,3,100
3294,60,86,156,242,3,100
3295,60,56,130,186,3,100
3296,60,128,203,331,3,100
3297,60,88,110,198,3,100
3298,60,114,229,343,3,100
3299,60,200,244,444,3,100
3300,60,56,93,149,3,100
3301,60,177,130,307,3,100
3302,60,120,170,290,3,100
3303,60,133,169,302,3,100
3304,60,26,129,155,3,100
3305,60,105,194,299,3,100
3306,60,104,277,381,3,100
3307,60,100,108,208,3,100
3308,60,53,170,223,3,100
3309,60,28,41,69,3,100
3310,60,16,13,29,3,100
3311,60,146,168,314,3,100
3312,60,11,13,24,3,100
3313,60,17,46,63,3,100
3314,60,86,99,185,3,100
3315,60,109,168,277,3,100
3316,60,63,118,181,3,100
3317,60,121,115,236,3,100
3318,60,7,27,34,3,100
3319,60,67,95,162,3,100
3320,60,92,167,259,3,100
3321,60,42,97,139,3,100
3322,60,112,148,260,3,100
3323,60,113,131,244,3,100
3324,60,42,55,97,3,100
3325,60,92,94,186,3,100
3326,60,29,58,87,3,100
3327,60,32,71,103,3,100
3328,60,58,113,171,3,100
3329,60,89,134,223,3,100
3330,60,59,90,149,3,100
3331,60,47,90,137,3,100
3332,60,155,276,431,3,100
3333,60,70,101,171,3,100
3334,60,122,173,295,3,100
3335,60,112,167,279,3,100
3336,60,81,165,246,3,100
3337,60,45,41,86,3,100
3338,60,20,66,86,3,100
3339,60,81,107,188,3,100
3340,60,32,61,93,3,100
3341,60,73,106,179,3,100
3342,60,69,83,152,3,100
3343,60,74,136,210,3,100
3344,60,35,114,149,3,100
3345,60,40,72,112,3,100
3346,60,43,71,114,3,100
3347,60,108,110,218,3,100
3348,60,151,139,290,3,100
3349,60,77,158,235,3,100
3350,60,127,195,322,3,100
3351,60,88,173,261,3,100
3352,60,21,55,76,3,100
3353,60,112,172,284,3,100
3354,60,108,208,316,3,100
3355,60,55,182,237,3,100
3356,60,130,279,409,3,100
3357,60,113,169,282,3,100
3358,60,37,49,86,3,100
3359,60,91,143,234,3,100
3360,60,137,181,318,3,100
3361,60,73,121,194,3,100
3362,60,41,86,127,3,100
3363,60,10,37,47,3,100
3364,60,9,22,31,3,100
3365,60,34,62,96,3,100
3366,60,96,141,237,3,100
3367,60,77,114,191,3,100
3368,60,127,196,323,3,100
3369,60,94,168,262,3,100
3370,60,126,187,313,3,100
3371,60,74,84,158,3,100
3372,60,53,72,125,3,100
3373,60,100,128,228,3,100
3374,60,115,226,341,3,100
3375,60,77,136,213,3,100
3376,60,122,189,311,3,100
3377,60,106,173,279,3,100
3378,60,23,25,48,3,100
3379,60,79,94,173,3,100
3380,60,111,201,312,3,100
3381,60,66,120,186,3,100
3382,60,14,59,73,3,100
3383,60,82,184,266,3,100
3384,60,42,88,130,3,100
3385,60,82,143,225,3,100
3386,60,84,171,255,3,100
3387,60,16,54,70,3,100
3388,60,151,160,311,3,100
3389,60,152,155,307,3,100
3390,60,73,134,207,3,100
3391,60,153,216,369,3,100
3392,60,45,110,155,3,100
3393,60,6,31,37,3,100
3394,60,87,161,248,3,100
3395,60,67,78,145,3,100
3396,60,106,169,275,3,100
3397,60,26,28,54,3,100
3398,60,59,61,120,3,100
3399,60,6,16,22,3,100
3400,60,134,237,371,3,100
3401,60,123,100,223,3,100
3402,60,75,64,139,3,100
3403,60,111,105,216,3,100
3404,60,138,216,354,3,100
3405,60,81,113,194,3,100
3406,60,150,308,458,3,100
3407,60,83,112,195,3,100
3408,60,50,87,137,3,100
3409,60,88,185,273,3,100
3410,60,43,24,67,3,100
3411,60,45,116,161,3,100
3412,60,65,90,155,3,100
3413,60,45,46,91,3,100
3414,60,149,270,419,3,100
3415,60,92,135,227,3,100
3416,60,75,134,209,3,100
3417,60,7,47,54,3,100
3418,60,25,32,57,3,100
3419,60,41,58,99,3,100
3420,60,32,144,176,3,100
3421,75,140,247,387,3,100
3422,75,94,192,286,3,100
3423,75,78,121,199,3,100
3424,75,29,57,86,3,100
3425,75,59,44,103,3,100
3426,75,165,368,533,3,100
3427,75,45,136,181,3,100
3428,75,117,231,348,3,100
3429,75,125,184,309,3,100
3430,75,55,95,150,3,100
3431,75,80,115,195,3,100
3432,75,65,105,170,3,100
3433,75,112,154,266,3,100
3434,75,43,117,160,3,100
3435,75,155,227,382,3,100
3436,75,87,116,203,3,100
3437,75,184,217,401,3,100
3438,75,145,349,494,3,100
3439,75,151,198,349,3,100
3440,75,54,206,260,3,100
3441,75,76,159,235,3,100
3442,75,36,67,103,3,100
3443,75,61,72,133,3,100
3444,75,34,66,100,3,100
3445,75,113,118,231,3,100
3446,75,38,58,96,3,100
3447,75,15,94,109,3,100
3448,75,159,241,400,3,100
3449,75,39,103,142,3,100
3450,75,123,174,297,3,100
3451,75,132,220,352,3,100
3452,75,77,183,260,3,100
3453,75,148,140,288,3,100
3454,75,142,222,364,3,100
3455,75,120,193,313,3,100
3456,75,140,264,404,3,100
3457,75,69,124,193,3,100
3458,75,94,296,390,3,100
3459,75,110,229,339,3,100
3460,75,103,143,246,3,100
3461,75,21,148,169,3,100
3462,75,82,175,257,3,100
3463,75,5,29,34,3,100
3464,75,29,109,138,3,100
3465,75,88,101,189,3,100
3466,75,12,6,18,3,100
3467,75,46,79,125,3,100
3468,75,17,156,173,3,100
3469,75,17,57,74,3,100
3470,75,91,201,292,3,100
3471,75,94,209,303,3,100
3472,75,94,170,264,3,100
3473,75,98,177,275,3,100
3474,75,72,127,199,3,100
3475,75,91,178,269,3,100
3476,75,85,149,234,3,100
3477,75,82,120,202,3,100
3478,75,59,106,165,3,100
3479,75,122,182,304,3,100
3480,75,31,85,116,3,100
3481,75,157,234,391,3,100
3482,75,17,30,47,3,100
3483,75,105,166,271,3,100
3484,75,4,35,39,3,100
3485,75,90,132,222,3,100
3486,75,98,108,206,3,100
3487,75,86,166,252,3,100
3488,75,41,84,125,3,100
3489,75,90,103,193,3,100
3490,75,169,368,537,3,100
3491,75,124,286,410,3,100
3492,75,83,122,205,3,100
3493,75,120,230,350,3,100
3494,75,96,139,235,3,100
3495,75,127,150,277,3,100
3496,75,110,149,259,3,100
3497,75,134,289,423,3,100
3498,75,28,106,134,3,100
3499,75,65,112,177,3,100
3500,75,186,413,599,3,100
3501,75,102,196,298,3,100
3502,75,62,214,276,3,100
3503,75,144,196,340,3,100
3504,75,80,183,263,3,100
3505,75,144,321,465,3,100
3506,75,71,166,237,3,100
3507,75,92,187,279,3,100
3508,75,121,232,353,3,100
3509,75,40,58,98,3,100
3510,75,104,140,244,3,100
3511,75,125,59,184,3,100
3512,75,54,47,101,3,100
3513,75,121,246,367,3,100
3514,75,77,209,286,3,100
3515,75,97,190,287,3,100
3516,75,65,221,286,3,100
3517,75,46,175,221,3,100
3518,75,97,160,257,3,100
3519,75,66,213,279,3,100
3520,75,105,256,361,3,100
3521,75,25,19,44,3,100
3522,75,42,32,74,3,100
3523,75,89,137,226,3,100
3524,75,107,108,215,3,100
3525,75,13,158,171,3,100
3526,75,12,37,49,3,100
3527,75,99,126,225,3,100
3528,75,96,245,341,3,100
3529,75,204,212,416,3,100
3530,75,87,130,217,3,100
3531,75,70,152,222,3,100
3532,75,62,105,167,3,100
3533,75,92,184,276,3,100
3534,75,91,180,271,3,100
3535,75,90,151,241,3,100
3536,75,73,155,228,3,100
3537,75,212,266,478,3,100
3538,75,71,141,212,3,100
3539,75,139,169,308,3,100
3540,75,32,27,59,3,100
3541,75,40,26,66,3,100
3542,75,61,185,246,3,100
3543,75,22,21,43,3,100
3544,75,91,150,241,3,100
3545,75,80,182,262,3,100
3546,75,174,322,496,3,100
3547,75,268,578,846,3,100
3548,75,36,74,110,3,100
3549,75,130,245,375,3,100
3550,75,49,63,112,3,100
3551,75,57,84,141,3,100
3552,75,76,183,259,3,100
3553,75,174,348,522,3,100
3554,75,54,108,162,3,100
3555,75,179,337,516,3,100
3556,75,134,181,315,3,100
3557,75,72,115,187,3,100
3558,75,36,117,153,3,100
3559,75,80,59,139,3,100
3560,75,34,76,110,3,100
3561,75,91,50,141,3,100
3562,75,94,154,248,3,100
3563,75,110,334,444,3,100
3564,75,118,185,303,3,100
3565,75,77,150,227,3,100
3566,75,74,152,226,3,100
3567,75,73,121,194,3,100
3568,75,74,119,193,3,100
3569,75,54,107,161,3,100
3570,75,39,83,122,3,100
3571,75,73,168,241,3,100
3572,75,87,201,288,3,100
3573,75,117,186,303,3,100
3574,75,113,197,310,3,100
3575,75,92,156,248,3,100
3576,75,129,266,395,3,100
3577,75,69,125,194,3,100
3578,75,40,104,144,3,100
3579,75,99,254,353,3,100
3580,75,62,72,134,3,100
3581,75,47,67,114,3,100
3582,75,30,40,70,3,100
3583,75,41,28,69,3,100
3584,75,30,25,55,3,100
3585,75,31,49,80,3,100
3586,75,114,89,203,3,100
3587,75,9,33,42,3,100
3588,75,178,169,347,3,100
3589,75,16,84,100,3,100
3590,75,83,219,302,3,100
3591,75,140,117,257,3,100
3592,75,72,138,210,3,100
3593,75,72,112,184,3,100
3594,75,39,93,132,3,100
3595,75,47,69,116,3,100
3596,75,31,54,85,3,100
3597,75,45,80,125,3,100
3598,75,143,227,370,3,100
3599,75,81,151,232,3,100
3600,75,78,211,289,3,100
3601,75,20,32,52,3,100
3602,75,77,209,286,3,100
3603,75,60,45,105,3,100
3604,75,96,118,214,3,100
3605,75,115,81,196,3,100
3606,75,168,343,511,3,100
3607,75,47,98,145,3,100
3608,75,150,295,445,3,100
3609,75,133,117,250,3,100
3610,75,10,27,37,3,100
3611,75,101,219,320,3,100
3612,75,28,74,102,3,100
3613,75,7,27,34,3,100
3614,75,8,75,83,3,100
3615,75,94,121,215,3,100
3616,75,122,166,288,3,100
3617,75,160,217,377,3,100
3618,75,20,60,80,3,100
3619,75,100,231,331,3,100
3620,75,148,229,377,3,100
3621,75,57,154,211,3,100
3622,75,52,89,141,3,100
3623,75,103,161,264,3,100
3624,75,50,115,165,3,100
3625,75,45,91,136,3,100
3626,75,122,138,260,3,100
3627,75,51,120,171,3,100
3628,75,42,95,137,3,100
3629,75,45,91,136,3,100
3630,75,152,261,413,3,100
3631,75,38,62,100,3,100
3632,75,138,256,394,3,100
3633,75,65,149,214,3,100
3634,75,45,53,98,3,100
3635,75,61,155,216,3,100
3636,75,140,289,429,3,100
3637,75,48,119,167,3,100
3638,75,108,201,309,3,100
3639,75,127,199,326,3,100
3640,75,34,64,98,3,100
3641,75,50,140,190,3,100
3642,75,8,38,46,3,100
3643,75,132,185,317,3,100
3644,75,98,237,335,3,100
3645,75,174,224,398,3,100
3646,75,228,315,543,3,100
3647,75,53,67,120,3,100
3648,75,98,246,344,3,100
3649,75,95,162,257,3,100
3650,75,46,88,134,3,100
3651,75,102,213,315,3,100
3652,75,44,73,117,3,100
3653,75,126,210,336,3,100
3654,75,28,96,124,3,100
3655,75,27,64,91,3,100
3656,75,26,38,64,3,100
3657,75,105,211,316,3,100
3658,75,53,124,177,3,100
3659,75,109,311,420,3,100
3660,75,94,174,268,3,100
3661,75,61,114,175,3,100
3662,75,96,373,469,3,100
3663,75,76,134,210,3,100
3664,75,52,118,170,3,100
3665,75,133,275,408,3,100
3666,75,24,33,57,3,100
3667,75,36,102,138,3,100
3668,75,62,76,138,3,100
3669,75,76,202,278,3,100
3670,75,104,275,379,3,100
3671,75,55,88,143,3,100
3672,75,156,268,424,3,100
3673,75,86,191,277,3,100
3674,75,112,272,384,3,100
3675,75,138,233,371,3,100
3676,75,92,170,262,3,100
3677,75,103,119,222,3,100
3678,75,32,64,96,3,100
3679,75,73,148,221,3,100
3680,75,89,173,262,3,100
3681,75,128,205,333,3,100
3682,75,111,166,277,3,100
3683,75,51,124,175,3,100
3684,75,60,227,287,3,100
3685,75,117,243,360,3,100
3686,75,65,99,164,3,100
3687,75,43,76,119,3,100
3688,75,75,172,247,3,100
3689,75,128,146,274,3,100
3690,75,78,148,226,3,100
3691,75,133,183,316,3,100
3692,75,156,218,374,3,100
3693,75,7,21,28,3,100
3694,75,108,206,314,3,100
3695,75,80,157,237,3,100
3696,75,74,160,234,3,100
3697,75,72,171,243,3,100
3698,75,58,111,169,3,100
3699,75,170,286,456,3,100
3700,75,90,95,185,3,100
3701,75,45,101,146,3,100
3702,75,129,242,371,3,100
3703,75,73,88,161,3,100
3704,75,61,59,120,3,100
3705,75,49,79,128,3,100
3706,75,169,273,442,3,100
3707,75,111,206,317,3,100
3708,75,45,131,176,3,100
3709,75,106,143,249,3,100
3710,75,35,32,67,3,100
3711,75,24,50,74,3,100
3712,75,53,204,257,3,100
3713,75,15,30,45,3,100
3714,75,104,202,306,3,100
3715,75,12,33,45,3,100
3716,75,81,193,274,3,100
3717,75,149,260,409,3,100
3718,75,36,149,185,3,100
3719,75,103,179,282,3,100
3720,75,120,275,395,3,100
3721,75,181,305,486,3,100
3722,75,15,36,51,3,100
3723,75,203,263,466,3,100
3724,75,55,133,188,3,100
3725,75,106,79,185,3,100
3726,75,61,88,149,3,100
3727,75,145,244,389,3,100
3728,75,69,72,141,3,100
3729,75,83,96,179,3,100
3730,75,96,217,313,3,100
3731,75,33,72,105,3,100
3732,75,116,117,233,3,100
3733,75,123,263,386,3,100
3734,75,139,183,322,3,100
3735,75,11,21,32,3,100
3736,75,47,105,152,3,100
3737,75,129,252,381,3,100
3738,75,49,73,122,3,100
3739,75,114,201,315,3,100
3740,75,61,49,110,3,100
3741,75,21,95,116,3,100
3742,75,78,123,201,3,100
3743,75,57,97,154,3,100
3744,75,72,133,205,3,100
3745,75,3,7,10,3,100
3746,75,120,86,206,3,100
3747,75,93,140,233,3,100
3748,75,72,101,173,3,100
3749,75,89,161,250,3,100
3750,75,88,144,232,3,100
3751,75,63,110,173,3,100
3752,75,40,116,156,3,100
3753,75,175,240,415,3,100
3754,75,60,68,128,3,100
3755,75,108,31,139,3,100
3756,75,144,203,347,3,100
3757,75,116,207,323,3,100
3758,75,92,154,246,3,100
3759,75,107,235,342,3,100
3760,75,88,119,207,3,100
3761,75,37,133,170,3,100
3762,75,94,187,281,3,100
3763,75,83,178,261,3,100
3764,75,22,47,69,3,100
3765,75,33,39,72,3,100
3766,75,8,50,58,3,100
3767,75,61,114,175,3,100
3768,75,31,85,116,3,100
3769,75,46,124,170,3,100
3770,75,153,214,367,3,100
3771,75,39,107,146,3,100
3772,75,29,54,83,3,100
3773,75,208,343,551,3,100
3774,75,57,98,155,3,100
3775,75,105,231,336,3,100
3776,75,49,64,113,3,100
3777,75,110,128,238,3,100
3778,75,45,108,153,3,100
3779,75,82,136,218,3,100
3780,75,50,73,123,3,100
3781,75,69,135,204,3,100
3782,75,58,95,153,3,100
3783,75,91,72,163,3,100
3784,75,79,138,217,3,100
3785,75,131,128,259,3,100
3786,75,76,110,186,3,100
3787,75,28,58,86,3,100
3788,75,83,214,297,3,100
3789,75,177,81,258,3,100
3790,75,76,154,230,3,100
3791,75,82,251,333,3,100
3792,75,149,219,368,3,100
3793,75,41,147,188,3,100
3794,75,191,266,457,3,100
3795,75,71,179,250,3,100
3796,75,91,240,331,3,100
3797,75,67,151,218,3,100
3798,75,24,30,54,3,100
3799,75,103,133,236,3,100
3800,75,50,90,140,3,100
3801,75,104,102,206,3,100
3802,75,35,59,94,3,100
3803,75,56,29,85,3,100
3804,75,87,160,247,3,100
3805,75,92,197,289,3,100
3806,75,46,69,115,3,100
3807,75,153,335,488,3,100
3808,75,118,114,232,3,100
3809,75,42,97,139,3,100
3810,75,93,170,263,3,100
3811,75,92,145,237,3,100
3812,75,12,26,38,3,100
3813,75,29,37,66,3,100
3814,75,55,159,214,3,100
3815,75,52,96,148,3,100
3816,75,88,186,274,3,100
3817,75,113,207,320,3,100
3818,75,64,92,156,3,100
3819,75,98,282,380,3,100
3820,75,137,133,270,3,100
3821,75,53,191,244,3,100
3822,75,191,431,622,3,100
3823,75,98,110,208,3,100
3824,75,154,259,413,3,100
3825,75,221,511,732,3,100
3826,75,99,177,276,3,100
3827,75,91,187,278,3,100
3828,75,68,83,151,3,100
3829,75,72,110,182,3,100
3830,75,56,149,205,3,100
3831,75,148,243,391,3,100
3832,75,71,133,204,3,100
3833,75,59,136,195,3,100
3834,75,64,86,150,3,100
3835,75,71,121,192,3,100
3836,75,90,208,298,3,100
3837,75,76,110,186,3,100
3838,75,63,131,194,3,100
3839,75,384,150,534,3,100
3840,75,39,61,100,3,100
3841,75,71,80,151,3,100
3842,75,124,194,318,3,100
3843,75,311,204,515,3,100
3844,75,76,125,201,3,100
3845,75,96,110,206,3,100
3846,75,212,165,377,3,100
3847,75,86,202,288,3,100
3848,75,53,108,161,3,100
3849,75,44,108,152,3,100
3850,75,68,127,195,3,100
3851,75,41,89,130,3,100
3852,75,32,76,108,3,100
3853,75,122,225,347,3,100
3854,75,29,46,75,3,100
3855,75,148,135,283,3,100
3856,75,56,150,206,3,100
3857,75,83,141,224,3,100
3858,75,81,172,253,3,100
3859,75,124,188,312,3,100
3860,75,94,340,434,3,100
3861,75,61,196,257,3,100
3862,75,60,47,107,3,100
3863,75,83,87,170,3,100
3864,75,60,123,183,3,100
3865,75,28,52,80,3,100
3866,75,202,263,465,3,100
3867,75,49,76,125,3,100
3868,75,206,247,453,3,100
3869,75,40,104,144,3,100
3870,75,153,234,387,3,100
3871,75,148,154,302,3,100
3872,75,122,165,287,3,100
3873,75,40,53,93,3,100
3874,75,200,258,458,3,100
3875,75,93,177,270,3,100
3876,75,110,198,308,3,100
3877,75,66,167,233,3,100
3878,75,74,120,194,3,100
3879,75,64,131,195,3,100
3880,75,81,69,150,3,100
3881,90,33,46,79,3,100
3882,90,21,15,36,3,100
3883,90,46,82,128,3,100
3884,90,51,110,161,3,100
3885,90,116,158,274,3,100
3886,90,12,46,58,3,100
3887,90,161,287,448,3,100
3888,90,147,282,429,3,100
3889,90,98,180,278,3,100
3890,90,89,91,180,3,100
3891,90,139,172,311,3,100
3892,90,122,180,302,3,100
3893,90,28,63,91,3,100
3894,90,12,24,36,3,100
3895,90,101,264,365,3,100
3896,90,64,69,133,3,100
3897,90,75,134,209,3,100
3898,90,51,111,162,3,100
3899,90,86,173,259,3,100
3900,90,34,94,128,3,100
3901,90,55,121,176,3,100
3902,90,51,104,155,3,100
3903,90,141,190,331,3,100
3904,90,89,145,234,3,100
3905,90,98,194,292,3,100
3906,90,105,157,262,3,100
3907,90,127,146,273,3,100
3908,90,11,21,32,3,100
3909,90,66,135,201,3,100
3910,90,71,144,215,3,100
3911,90,132,212,344,3,100
3912,90,94,183,277,3,100
3913,90,56,99,155,3,100
3914,90,113,72,185,3,100
3915,90,55,137,192,3,100
3916,90,49,160,209,3,100
3917,90,185,282,467,3,100
3918,90,15,44,59,3,100
3919,90,170,257,427,3,100
3920,90,42,75,117,3,100
3921,90,34,69,103,3,100
3922,90,48,86,134,3,100
3923,90,70,131,201,3,100
3924,90,27,54,81,3,100
3925,90,58,117,175,3,100
3926,90,35,53,88,3,100
3927,90,17,39,56,3,100
3928,90,61,171,232,3,100
3929,90,15,62,77,3,100
3930,90,49,74,123,3,100
3931,90,17,39,56,3,100
3932,90,70,418,488,3,100
3933,90,37,63,100,3,100
3934,90,50,114,164,3,100
3935,90,75,177,252,3,100
3936,90,88,92,180,3,100
3937,90,23,16,39,3,100
3938,90,37,44,81,3,100
3939,90,68,181,249,3,100
3940,90,68,147,215,3,100
3941,90,53,93,146,3,100
3942,90,113,171,284,3,100
3943,90,75,193,268,3,100
3944,90,60,81,141,3,100
3945,90,85,167,252,3,100
3946,90,148,312,460,3,100
3947,90,110,134,244,3,100
3948,90,113,257,370,3,100
3949,90,44,118,162,3,100
3950,90,66,139,205,3,100
3951,90,2,16,18,3,100
3952,90,24,34,58,3,100
3953,90,45,36,81,3,100
3954,90,73,134,207,3,100
3955,90,105,134,239,3,100
3956,90,107,111,218,3,100
3957,90,138,188,326,3,100
3958,90,12,56,68,3,100
3959,90,85,121,206,3,100
3960,90,101,196,297,3,100
3961,90,108,227,335,3,100
3962,90,188,212,400,3,100
3963,90,99,166,265,3,100
3964,90,135,272,407,3,100
3965,90,179,234,413,3,100
3966,90,65,129,194,3,100
3967,90,67,182,249,3,100
3968,90,55,129,184,3,100
3969,90,65,190,255,3,100
3970,90,64,65,129,3,100
3971,90,79,148,227,3,100
3972,90,64,152,216,3,100
3973,90,108,209,317,3,100
3974,90,37,48,85,3,100
3975,90,70,124,194,3,100
3976,90,86,133,219,3,100
3977,90,75,160,235,3,100
3978,90,126,179,305,3,100
3979,90,64,105,169,3,100
3980,90,153,265,418,3,100
3981,90,73,130,203,3,100
3982,90,131,195,326,3,100
3983,90,80,136,216,3,100
3984,90,46,43,89,3,100
3985,90,76,94,170,3,100
3986,90,121,256,377,3,100
3987,90,275,460,735,3,100
3988,90,150,210,360,3,100
3989,90,48,67,115,3,100
3990,90,69,143,212,3,100
3991,90,134,221,355,3,100
3992,90,108,137,245,3,100
3993,90,27,122,149,3,100
3994,90,21,46,67,3,100
3995,90,57,161,218,3,100
3996,90,33,59,92,3,100
3997,90,34,116,150,3,100
3998,90,94,74,168,3,100
3999,90,24,53,77,3,100
4000,90,66,101,167,3,100
4001,90,11,43,54,3,100
4002,90,36,61,97,3,100
4003,90,179,157,336,3,100
4004,90,95,187,282,3,100
4005,90,75,154,229,3,100
4006,90,127,174,301,3,100
4007,90,43,96,139,3,100
4008,90,71,156,227,3,100
4009,90,111,321,432,3,100
4010,90,68,117,185,3,100
4011,90,149,193,342,3,100
4012,90,128,291,419,3,100
4013,90,116,219,335,3,100
4014,90,118,196,314,3,100
4015,90,115,193,308,3,100
4016,90,100,111,211,3,100
4017,90,31,36,67,3,100
4018,90,25,30,55,3,100
4019,90,53,87,140,3,100
4020,90,25,114,139,3,100
4021,90,102,113,215,3,100
4022,90,28,70,98,3,100
4023,90,59,97,156,3,100
4024,90,132,292,424,3,100
4025,90,73,157,230,3,100
4026,90,56,123,179,3,100
4027,90,93,211,304,3,100
4028,90,58,107,165,3,100
4029,90,121,180,301,3,100
4030,90,117,241,358,3,100
4031,90,72,118,190,3,100
4032,90,96,131,227,3,100
4033,90,100,190,290,3,100
4034,90,71,107,178,3,100
4035,90,66,96,162,3,100
4036,90,82,153,235,3,100
4037,90,46,118,164,3,100
4038,90,104,113,217,3,100
4039,90,7,12,19,3,100
4040,90,72,120,192,3,100
4041,90,60,69,129,3,100
4042,90,83,132,215,3,100
4043,90,121,179,300,3,100
4044,90,120,208,328,3,100
4045,90,22,55,77,3,100
4046,90,102,128,230,3,100
4047,90,111,76,187,3,100
4048,90,47,95,142,3,100
4049,90,6,49,55,3,100
4050,90,52,134,186,3,100
4051,90,77,120,197,3,100
4052,90,24,39,63,3,100
4053,90,54,72,126,3,100
4054,90,24,34,58,3,100
4055,90,24,50,74,3,100
4056,90,59,22,81,3,100
4057,90,100,235,335,3,100
4058,90,108,160,268,3,100
4059,90,193,314,507,3,100
4060,90,119,206,325,3,100
4061,90,56,71,127,3,100
4062,90,149,93,242,3,100
4063,90,100,230,330,3,100
4064,90,186,289,475,3,100
4065,90,11,8,19,3,100
4066,90,33,69,102,3,100
4067,90,137,260,397,3,100
4068,90,32,113,145,3,100
4069,90,49,130,179,3,100
4070,90,148,285,433,3,100
4071,90,74,153,227,3,100
4072,90,13,43,56,3,100
4073,90,83,92,175,3,100
4074,90,84,134,218,3,100
4075,90,149,169,318,3,100
4076,90,134,163,297,3,100
4077,90,60,55,115,3,100
4078,90,66,103,169,3,100
4079,90,121,154,275,3,100
4080,90,95,137,232,3,100
4081,90,84,111,195,3,100
4082,90,85,146,231,3,100
4083,90,73,122,195,3,100
4084,90,113,112,225,3,100
4085,90,122,171,293,3,100
4086,90,76,137,213,3,100
4087,90,65,123,188,3,100
4088,90,52,71,123,3,100
4089,90,79,140,219,3,100
4090,90,97,134,231,3,100
4091,90,61,120,181,3,100
4092,90,63,126,189,3,100
4093,90,81,99,180,3,100
4094,90,221,227,448,3,100
4095,90,120,235,355,3,100
4096,90,129,162,291,3,100
4097,90,62,128,190,3,100
4098,90,255,321,576,3,100
4099,90,143,238,381,3,100
4100,90,51,128,179,3,100
4101,90,74,184,258,3,100
4102,90,15,38,53,3,100
4103,90,67,117,184,3,100
4104,90,129,227,356,3,100
4105,90,21,38,59,3,100
4106,90,109,205,314,3,100
4107,90,58,157,215,3,100
4108,90,51,66,117,3,100
4109,90,147,174,321,3,100
4110,90,265,407,672,3,100
4111,90,8,13,21,3,100
4112,90,65,138,203,3,100
4113,90,79,77,156,3,100
4114,90,48,104,152,3,100
4115,90,78,114,192,3,100
4116,90,85,161,246,3,100
4117,90,49,93,142,3,100
4118,90,156,249,405,3,100
4119,90,26,53,79,3,100
4120,90,18,98,116,3,100
4121,90,61,79,140,3,100
4122,90,38,51,89,3,100
4123,90,160,191,351,3,100
4124,90,59,122,181,3,100
4125,90,27,104,131,3,100
4126,90,56,43,99,3,100
4127,90,120,167,287,3,100
4128,90,108,191,299,3,100
4129,90,118,127,245,3,100
4130,90,91,97,188,3,100
4131,90,153,252,405,3,100
4132,90,115,175,290,3,100
4133,90,168,358,526,3,100
4134,90,103,154,257,3,100
4135,90,63,66,129,3,100
4136,90,116,171,287,3,100
4137,90,184,272,456,3,100
4138,90,45,102,147,3,100
4139,90,58,177,235,3,100
4140,90,125,237,362,3,100
4141,90,84,134,218,3,100
4142,90,15,59,74,3,100
4143,90,73,106,179,3,100
4144,90,81,126,207,3,100
4145,90,34,38,72,3,100
4146,90,50,152,202,3,100
4147,90,123,167,290,3,100
4148,90,86,87,173,3,100
4149,90,74,132,206,3,100
4150,90,133,206,339,3,100
4151,90,72,184,256,3,100
4152,90,117,205,322,3,100
4153,90,109,92,201,3,100
4154,90,77,193,270,3,100
4155,90,125,183,308,3,100
4156,90,96,175,271,3,100
4157,90,75,67,142,3,100
4158,90,35,79,114,3,100
4159,90,126,224,350,3,100
4160,90,69,168,237,3,100
4161,90,56,98,154,3,100
4162,90,92,224,316,3,100
4163,90,97,269,366,3,100
4164,90,89,222,311,3,100
4165,90,75,222,297,3,100
4166,90,101,176,277,3,100
4167,90,117,206,323,3,100
4168,90,147,257,404,3,100
4169,90,19,27,46,3,100
4170,90,175,123,298,3,100
4171,90,8,24,32,3,100
4172,90,287,84,371,3,100
4173,90,164,301,465,3,100
4174,90,138,178,316,3,100
4175,90,89,169,258,3,100
4176,90,155,248,403,3,100
4177,90,128,178,306,3,100
4178,90,119,259,378,3,100
4179,90,41,76,117,3,100
4180,90,86,104,190,3,100
4181,90,81,72,153,3,100
4182,90,145,182,327,3,100
4183,90,182,206,388,3,100
4184,90,33,26,59,3,100
4185,90,37,55,92,3,100
4186,90,60,204,264,3,100
4187,90,155,262,417,3,100
4188,90,133,221,354,3,100
4189,90,124,183,307,3,100
4190,90,113,212,325,3,100
4191,90,35,33,68,3,100
4192,90,88,111,199,3,100
4193,90,98,119,217,3,100
4194,90,94,179,273,3,100
4195,90,88,134,222,3,100
4196,90,115,156,271,3,100
4197,90,107,121,228,3,100
4198,90,106,161,267,3,100
4199,90,150,259,409,3,100
4200,90,98,146,244,3,100
4201,90,90,134,224,3,100
4202,90,65,115,180,3,100
4203,90,68,103,171,3,100
4204,90,58,149,207,3,100
4205,90,45,67,112,3,100
4206,90,16,60,76,3,100
4207,90,88,168,256,3,100
4208,90,126,241,367,3,100
4209,90,122,202,324,3,100
4210,90,66,82,148,3,100
4211,90,108,216,324,3,100
4212,90,81,172,253,3,100
4213,90,101,263,364,3,100
4214,90,112,250,362,3,100
4215,90,15,50,65,3,100
4216,90,203,422,625,3,100
4217,90,41,117,158,3,100
4218,90,13,65,78,3,100
4219,90,128,193,321,3,100
4220,90,14,51,65,3,100
4221,90,48,62,110,3,100
4222,90,58,82,140,3,100
4223,90,84,122,206,3,100
4224,90,29,38,67,3,100
4225,90,73,220,293,3,100
4226,90,106,259,365,3,100
4227,90,172,336,508,3,100
4228,90,107,290,397,3,100
4229,90,119,186,305,3,100
4230,90,35,74,109,3,100
4231,90,80,154,234,3,100
4232,90,104,268,372,3,100
4233,90,92,243,335,3,100
4234,90,115,208,323,3,100
4235,90,245,622,867,3,100
4236,90,155,205,360,3,100
4237,90,226,293,519,3,100
4238,90,108,188,296,3,100
4239,90,152,304,456,3,100
4240,90,163,248,411,3,100
4241,90,115,221,336,3,100
4242,90,60,193,253,3,100
4243,90,103,155,258,3,100
4244,90,55,43,98,3,100
4245,90,74,137,211,3,100
4246,90,39,82,121,3,100
4247,90,88,137,225,3,100
4248,90,61,67,128,3,100
4249,90,228,304,532,3,100
4250,90,159,300,459,3,100
4251,90,88,86,174,3,100
4252,90,135,307,442,3,100
4253,90,37,87,124,3,100
4254,90,115,175,290,3,100
4255,90,36,42,78,3,100
4256,90,50,133,183,3,100
4257,90,106,230,336,3,100
4258,90,38,84,122,3,100
4259,90,32,51,83,3,100
4260,90,116,210,326,3,100
4261,90,130,325,455,3,100
4262,90,89,156,245,3,100
4263,90,83,183,266,3,100
4264,90,32,124,156,3,100
4265,90,100,121,221,3,100
4266,90,104,142,246,3,100
4267,90,97,202,299,3,100
4268,90,82,171,253,3,100
4269,90,105,251,356,3,100
4270,90,15,63,78,3,100
4271,90,84,124,208,3,100
4272,90,102,163,265,3,100
4273,90,38,104,142,3,100
4274,90,84,163,247,3,100
4275,90,87,279,366,3,100
4276,90,36,52,88,3,100
4277,90,104,255,359,3,100
4278,90,86,120,206,3,100
4279,90,243,605,848,3,100
4280,90,54,63,117,3,100
4281,90,205,450,655,3,100
4282,90,138,175,313,3,100
4283,90,116,186,302,3,100
4284,90,156,254,410,3,100
4285,90,69,105,174,3,100
4286,90,74,85,159,3,100
4287,90,31,80,111,3,100
4288,90,18,34,52,3,100
4289,90,91,188,279,3,100
4290,90,54,126,180,3,100
4291,90,77,219,296,3,100
4292,90,19,23,42,3,100
4293,90,61,156,217,3,100
4294,90,56,132,188,3,100
4295,90,146,253,399,3,100
4296,90,82,226,308,3,100
4297,90,166,311,477,3,100
4298,90,96,146,242,3,100
4299,90,72,207,279,3,100
4300,90,61,38,99,3,100
4301,90,130,261,391,3,100
4302,90,45,129,174,3,100
4303,90,70,112,182,3,100
4304,90,78,157,235,3,100
4305,90,89,141,230,3,100
4306,90,176,187,363,3,100
4307,90,131,275,406,3,100
4308,90,108,227,335,3,100
4309,90,114,116,230,3,100
4310,90,57,123,180,3,100
4311,90,71,121,192,3,100
4312,90,31,40,71,3,100
4313,90,61,9,70,3,100
4314,90,72,174,246,3,100
4315,90,32,49,81,3,100
4316,90,44,171,215,3,100
4317,90,83,115,198,3,100
4318,90,27,81,108,3,100
4319,90,74,132,206,3,100
4320,90,115,340,455,3,100
4321,90,153,122,275,3,100
4322,90,50,143,193,3,100
4323,90,52,68,120,3,100
4324,90,75,162,237,3,100
4325,90,68,162,230,3,100
4326,90,120,283,403,3,100
4327,90,42,73,115,3,100
4328,90,48,121,169,3,100
4329,90,85,164,249,3,100
4330,90,8,50,58,3,100
4331,90,64,85,149,3,100
4332,90,36,64,100,3,100
4333,90,75,128,203,3,100
4334,90,55,146,201,3,100
4335,90,93,176,269,3,100
4336,90,54,108,162,3,100
4337,90,149,261,410,3,100
4338,90,173,420,593,3,100
4339,90,132,200,332,3,100
4340,90,283,284,567,3,100
4341,90,80,165,245,3,100
4342,120,103,130,233,3,100
4343,120,78,219,297,3,100
4344,120,127,262,389,3,100
4345,120,97,175,272,3,100
4346,120,270,445,715,3,100
4347,120,77,200,277,3,100
4348,120,59,94,153,3,100
4349,120,153,335,488,3,100
4350,120,50,136,186,3,100
4351,120,146,230,376,3,100
4352,120,132,187,319,3,100
4353,120,43,116,159,3,100
4354,120,36,72,108,3,100
4355,120,37,102,139,3,100
4356,120,20,39,59,3,100
4357,120,112,157,269,3,100
4358,120,10,31,41,3,100
4359,120,92,117,209,3,100
4360,120,25,40,65,3,100
4361,120,96,162,258,3,100
4362,120,72,124,196,3,100
4363,120,60,251,311,3,100
4364,120,82,90,172,3,100
4365,120,142,320,462,3,100
4366,120,130,138,268,3,100
4367,120,36,85,121,3,100
4368,120,65,85,150,3,100
4369,120,41,55,96,3,100
4370,120,56,154,210,3,100
4371,120,96,76,172,3,100
4372,120,79,118,197,3,100
4373,120,19,29,48,3,100
4374,120,56,113,169,3,100
4375,120,148,265,413,3,100
4376,120,18,63,81,3,100
4377,120,63,124,187,3,100
4378,120,143,187,330,3,100
4379,120,73,153,226,3,100
4380,120,139,243,382,3,100
4381,120,92,251,343,3,100
4382,120,78,201,279,3,100
4383,120,85,150,235,3,100
4384,120,87,194,281,3,100
4385,120,57,166,223,3,100
4386,120,119,264,383,3,100
4387,120,83,149,232,3,100
4388,120,62,110,172,3,100
4389,120,112,146,258,3,100
4390,120,28,33,61,3,100
4391,120,27,26,53,3,100
4392,120,57,112,169,3,100
4393,120,136,183,319,3,100
4394,120,83,129,212,3,100
4395,120,161,229,390,3,100
4396,120,275,145,420,3,100
4397,120,215,171,386,3,100
4398,120,25,78,103,3,100
4399,120,103,118,221,3,100
4400,120,151,134,285,3,100
4401,120,115,105,220,3,100
4402,120,99,191,290,3,100
4403,120,18,65,83,3,100
4404,120,120,208,328,3,100
4405,120,49,76,125,3,100
4406,120,58,88,146,3,100
4407,120,46,106,152,3,100
4408,120,59,99,158,3,100
4409,120,49,88,137,3,100
4410,120,46,93,139,3,100
4411,120,84,211,295,3,100
4412,120,31,65,96,3,100
4413,120,36,98,134,3,100
4414,120,77,109,186,3,100
4415,120,12,18,30,3,100
4416,120,61,85,146,3,100
4417,120,72,164,236,3,100
4418,120,141,216,357,3,100
4419,120,63,31,94,3,100
4420,120,42,48,90,3,100
4421,120,82,136,218,3,100
4422,120,156,239,395,3,100
4423,120,164,287,451,3,100
4424,120,22,38,60,3,100
4425,120,106,221,327,3,100
4426,120,56,113,169,3,100
4427,120,58,72,130,3,100
4428,120,64,90,154,3,100
4429,120,42,105,147,3,100
4430,120,150,271,421,3,100
4431,120,53,100,153,3,100
4432,120,7,34,41,3,100
4433,120,19,57,76,3,100
4434,120,10,25,35,3,100
4435,120,3,20,23,3,100
4436,120,147,362,509,3,100
4437,120,124,82,206,3,100
4438,120,130,275,405,3,100
4439,120,186,293,479,3,100
4440,120,77,136,213,3,100
4441,120,50,89,139,3,100
4442,120,126,189,315,3,100
4443,120,43,89,132,3,100
4444,120,125,172,297,3,100
4445,120,54,101,155,3,100
4446,120,60,108,168,3,100
4447,120,68,112,180,3,100
4448,120,44,72,116,3,100
4449,120,54,78,132,3,100
4450,120,100,167,267,3,100
4451,120,37,196,233,3,100
4452,120,129,160,289,3,100
4453,120,77,169,246,3,100
4454,120,101,211,312,3,100
4455,120,54,83,137,3,100
4456,120,134,166,300,3,100
4457,120,141,254,395,3,100
4458,120,84,172,256,3,100
4459,120,50,117,167,3,100
4460,120,35,77,112,3,100
4461,120,90,136,226,3,100
4462,120,43,111,154,3,100
4463,120,95,87,182,3,100
4464,120,157,294,451,3,100
4465,120,148,213,361,3,100
4466,120,59,105,164,3,100
4467,120,55,77,132,3,100
4468,120,58,90,148,3,100
4469,120,71,131,202,3,100
4470,120,68,109,177,3,100
4471,120,68,150,218,3,100
4472,120,90,57,147,3,100
4473,120,42,71,113,3,100
4474,120,90,170,260,3,100
4475,120,134,149,283,3,100
4476,120,3,72,75,3,100
4477,120,140,248,388,3,100
4478,120,119,234,353,3,100
4479,120,86,190,276,3,100
4480,120,42,57,99,3,100
4481,120,43,164,207,3,100
4482,120,106,197,303,3,100
4483,120,93,132,225,3,100
4484,120,57,100,157,3,100
4485,120,13,34,47,3,100
4486,120,61,132,193,3,100
4487,120,61,89,150,3,100
4488,120,72,135,207,3,100
4489,120,59,115,174,3,100
4490,120,59,74,133,3,100
4491,120,11,13,24,3,100
4492,120,40,89,129,3,100
4493,120,57,31,88,3,100
4494,120,50,65,115,3,100
4495,120,45,132,177,3,100
4496,120,30,45,75,3,100
4497,120,72,65,137,3,100
4498,120,51,101,152,3,100
4499,120,46,54,100,3,100
4500,120,112,199,311,3,100
4501,120,73,98,171,3,100
4502,120,93,128,221,3,100
4503,120,116,175,291,3,100
4504,120,67,130,197,3,100
4505,120,129,99,228,3,100
4506,120,79,114,193,3,100
4507,120,44,84,128,3,100
4508,120,125,211,336,3,100
4509,120,35,72,107,3,100
4510,120,82,146,228,3,100
4511,120,49,104,153,3,100
4512,120,69,96,165,3,100
4513,120,78,158,236,3,100
4514,120,103,130,233,3,100
4515,120,90,184,274,3,100
4516,120,65,108,173,3,100
4517,120,88,112,200,3,100
4518,120,108,185,293,3,100
4519,120,70,137,207,3,100
4520,120,67,58,125,3,100
4521,120,100,97,197,3,100
4522,120,123,193,316,3,100
4523,120,51,49,100,3,100
4524,120,169,209,378,3,100
4525,120,105,149,254,3,100
4526,120,53,137,190,3,100
4527,120,90,139,229,3,100
4528,120,45,95,140,3,100
4529,120,47,68,115,3,100
4530,120,76,167,243,3,100
4531,120,50,60,110,3,100
4532,120,19,21,40,3,100
4533,120,81,159,240,3,100
4534,120,94,167,261,3,100
4535,120,79,155,234,3,100
4536,120,51,147,198,3,100
4537,120,85,164,249,3,100
4538,120,133,341,474,3,100
4539,120,75,117,192,3,100
4540,120,43,127,170,3,100
4541,120,78,137,215,3,100
4542,120,57,70,127,3,100
4543,120,54,126,180,3,100
4544,120,55,122,177,3,100
4545,120,77,137,214,3,100
4546,120,9,31,40,3,100
4547,120,45,87,132,3,100
4548,120,17,20,37,3,100
4549,120,24,7,31,3,100
4550,120,33,87,120,3,100
4551,120,71,130,201,3,100
4552,120,75,154,229,3,100
4553,120,86,128,214,3,100
4554,120,100,158,258,3,100
4555,120,100,156,256,3,100
4556,120,169,147,316,3,100
4557,120,119,188,307,3,100
4558,120,125,86,211,3,100
4559,120,107,140,247,3,100
4560,120,78,109,187,3,100
4561,120,33,95,128,3,100
4562,120,89,111,200,3,100
4563,120,115,194,309,3,100
4564,120,83,107,190,3,100
4565,120,41,37,78,3,100
4566,120,74,106,180,3,100
4567,120,27,69,96,3,100
4568,120,21,77,98,3,100
4569,120,11,46,57,3,100
4570,120,39,63,102,3,100
4571,120,63,137,200,3,100
4572,120,70,133,203,3,100
4573,120,113,143,256,3,100
4574,120,104,139,243,3,100
4575,120,44,53,97,3,100
4576,120,108,206,314,3,100
4577,120,122,155,277,3,100
4578,120,98,200,298,3,100
4579,120,134,172,306,3,100
4580,120,52,89,141,3,100
4581,120,116,131,247,3,100
4582,120,136,170,306,3,100
4583,120,154,241,395,3,100
4584,120,91,139,230,3,100
4585,120,69,127,196,3,100
4586,120,76,27,103,3,100
4587,120,47,83,130,3,100
4588,120,119,322,441,3,100
4589,120,57,87,144,3,100
4590,120,178,369,547,3,100
4591,120,171,292,463,3,100
4592,120,62,129,191,3,100
4593,120,185,272,457,3,100
4594,120,92,139,231,3,100
4595,120,55,25,80,3,100
4596,120,188,335,523,3,100
4597,120,116,230,346,3,100
4598,120,98,231,329,3,100
4599,120,39,66,105,3,100
4600,120,8,12,20,3,100
4601,120,75,89,164,3,100
4602,120,37,82,119,3,100
4603,120,30,44,74,3,100
4604,120,93,170,263,3,100
4605,120,52,146,198,3,100
4606,120,53,95,148,3,100
4607,120,39,80,119,3,100
4608,120,63,110,173,3,100
4609,120,132,304,436,3,100
4610,120,96,100,196,3,100
4611,120,13,38,51,3,100
4612,120,71,155,226,3,100
4613,120,119,299,418,3,100
4614,120,75,200,275,3,100
4615,120,56,157,213,3,100
4616,120,56,49,105,3,100
4617,120,32,32,64,3,100
4618,120,51,90,141,3,100
4619,120,198,86,284,3,100
4620,120,40,110,150,3,100
4621,120,65,114,179,3,100
4622,120,86,97,183,3,100
4623,120,18,104,122,3,100
4624,120,78,109,187,3,100
4625,120,48,80,128,3,100
4626,120,84,151,235,3,100
4627,120,174,149,323,3,100
4628,120,59,46,105,3,100
4629,120,53,113,166,3,100
4630,120,85,132,217,3,100
4631,120,89,118,207,3,100
4632,120,133,88,221,3,100
4633,120,67,144,211,3,100
4634,120,73,146,219,3,100
4635,120,46,129,175,3,100
4636,120,26,56,82,3,100
4637,120,22,59,81,3,100
4638,120,51,40,91,3,100
4639,120,131,264,395,3,100
4640,120,48,109,157,3,100
4641,120,15,17,32,3,100
4642,120,45,101,146,3,100
4643,120,67,99,166,3,100
4644,120,22,24,46,3,100
4645,120,57,130,187,3,100
4646,120,78,120,198,3,100
4647,120,131,199,330,3,100
4648,120,83,188,271,3,100
4649,120,41,53,94,3,100
4650,120,140,206,346,3,100
4651,120,32,47,79,3,100
4652,120,93,172,265,3,100
4653,120,30,48,78,3,100
4654,120,40,115,155,3,100
4655,120,150,322,472,3,100
4656,120,143,256,399,3,100
4657,120,98,148,246,3,100
4658,120,165,266,431,3,100
4659,120,37,78,115,3,100
4660,120,103,247,350,3,100
4661,120,78,127,205,3,100
4662,120,58,154,212,3,100
4663,120,80,162,242,3,100
4664,120,60,141,201,3,100
4665,120,41,115,156,3,100
4666,120,39,122,161,3,100
4667,120,165,376,541,3,100
4668,120,70,70,140,3,100
4669,120,36,90,126,3,100
4670,120,119,210,329,3,100
4671,120,119,231,350,3,100
4672,120,84,115,199,3,100
4673,120,116,189,305,3,100
4674,120,51,74,125,3,100
4675,120,58,149,207,3,100
4676,120,69,122,191,3,100
4677,120,68,160,228,3,100
4678,120,51,107,158,3,100
4679,120,80,102,182,3,100
4680,120,90,202,292,3,100
4681,120,84,125,209,3,100
4682,120,219,505,724,3,100
4683,120,163,232,395,3,100
4684,120,26,81,107,3,100
4685,120,76,175,251,3,100
4686,120,98,130,228,3,100
4687,120,45,69,114,3,100
4688,120,69,162,231,3,100
4689,120,31,52,83,3,100
4690,120,55,57,112,3,100
4691,120,96,104,200,3,100
4692,120,18,9,27,3,100
4693,120,28,103,131,3,100
4694,120,61,118,179,3,100
4695,120,57,147,204,3,100
4696,120,63,110,173,3,100
4697,120,62,95,157,3,100
4698,120,84,126,210,3,100
4699,120,107,109,216,3,100
4700,120,23,35,58,3,100
4701,120,64,33,97,3,100
4702,120,95,155,250,3,100
4703,120,136,195,331,3,100
4704,120,134,120,254,3,100
4705,120,64,213,277,3,100
4706,120,15,39,54,3,100
4707,120,124,103,227,3,100
4708,120,35,60,95,3,100
4709,120,32,98,130,3,100
4710,120,119,110,229,3,100
4711,120,58,108,166,3,100
4712,120,106,190,296,3,100
4713,120,97,176,273,3,100
4714,120,74,77,151,3,100
4715,120,100,66,166,3,100
4716,120,154,196,350,3,100
4717,120,100,176,276,3,100
4718,120,68,133,201,3,100
4719,120,42,83,125,3,100
4720,120,142,241,383,3,100
4721,120,119,145,264,3,100
4722,120,63,57,120,3,100
4723,120,149,162,311,3,100
4724,120,35,66,101,3,100
4725,120,34,123,157,3,100
4726,120,93,155,248,3,100
4727,120,99,120,219,3,100
4728,120,71,163,234,3,100
4729,120,32,83,115,3,100
4730,120,69,96,165,3,100
4731,120,32,87,119,3,100
4732,120,128,302,430,3,100
4733,120,81,77,158,3,100
4734,120,104,173,277,3,100
4735,120,191,327,518,3,100
4736,120,118,144,262,3,100
4737,120,29,29,58,3,100
4738,120,21,39,60,3,100
4739,120,19,19,38,3,100
4740,120,30,56,86,3,100
4741,120,78,151,229,3,100
4742,120,51,78,129,3,100
4743,120,74,200,274,3,100
4744,120,78,228,306,3,100
4745,120,35,19,54,3,100
4746,120,40,239,279,3,100
4747,120,30,168,198,3,100
4748,120,139,218,357,3,100
4749,120,148,267,415,3,100
4750,120,61,116,177,3,100
4751,120,55,90,145,3,100
4752,120,68,97,165,3,100
4753,120,53,130,183,3,100
4754,120,71,6,77,3,100
4755,120,41,66,107,3,100
4756,120,31,73,104,3,100
4757,120,73,131,204,3,100
4758,120,104,204,308,3,100
4759,120,29,36,65,3,100
4760,120,62,189,251,3,100
4761,120,108,184,292,3,100
4762,120,112,173,285,3,100
4763,120,147,164,311,3,100
4764,120,122,186,308,3,100
4765,120,73,120,193,3,100
4766,120,61,119,180,3,100
4767,120,84,129,213,3,100
4768,120,82,125,207,3,100
4769,120,24,46,70,3,100
4770,120,67,107,174,3,100
4771,120,64,130,194,3,100
4772,120,98,187,285,3,100
4773,120,169,207,376,3,100
4774,120,75,128,203,3,100
4775,120,46,98,144,3,100
4776,120,110,134,244,3,100
4777,120,46,78,124,3,100
4778,120,77,117,194,3,100
4779,120,76,110,186,3,100
4780,120,42,67,109,3,100
4781,120,49,83,132,3,100
4782,120,169,282,451,3,100
4783,120,34,102,136,3,100
4784,120,42,67,109,3,100
4785,120,27,52,79,3,100
4786,120,68,144,212,3,100
4787,120,14,27,41,3,100
4788,120,65,47,112,3,100
4789,120,30,30,60,3,100
4790,120,82,122,204,3,100
4791,120,81,152,233,3,100
4792,120,55,118,173,3,100
4793,120,134,320,454,3,100
4794,120,51,28,79,3,100
4795,120,150,232,382,3,100
4796,120,73,156,229,3,100
4797,120,48,122,170,3,100
4798,120,107,190,297,3,100
4799,120,46,65,111,3,100
4800,120,60,116,176,3,100
4801,120,52,113,165,3,100
4802,120,73,114,187,3,100
4803,120,36,82,118,3,100
4804,120,60,172,232,3,100
4805,120,54,108,162,3,100
4806,120,79,86,165,3,100
4807,120,76,107,183,3,100
4808,120,105,145,250,3,100
4809,120,158,323,481,3,100
4810,120,25,63,88,3,100
4811,120,172,288,460,3,100
4812,120,139,186,325,3,100
4813,120,139,175,314,3,100
4814,120,58,86,144,3,100
4815,120,81,132,213,3,100
4816,120,58,162,220,3,100
4817,120,61,166,227,3,100
4818,120,75,111,186,3,100
4819,120,39,14,53,3,100
4820,120,63,153,216,3,100
4821,120,124,180,304,3,100
4822,120,164,219,383,3,100
4823,120,187,222,409,3,100
4824,120,41,50,91,3,100
4825,120,192,427,619,3,100
4826,120,111,199,310,3,100
4827,120,71,121,192,3,100
4828,120,57,178,235,3,100
4829,120,97,208,305,3,100
4830,120,56,73,129,3,100
4831,120,82,175,257,3,100
4832,120,36,49,85,3,100
4833,120,70,89,159,3,100
4834,120,1,18,19,3,100
4835,150,91,227,318,3,100
4836,150,83,110,193,3,100
4837,150,82,89,171,3,100
4838,150,77,103,180,3,100
4839,150,50,65,115,3,100
4840,150,133,192,325,3,100
4841,150,87,83,170,3,100
4842,150,21,50,71,3,100
4843,150,30,82,112,3,100
4844,150,147,219,366,3,100
4845,150,34,43,77,3,100
4846,150,85,257,342,3,100
4847,150,68,66,134,3,100
4848,150,67,66,133,3,100
4849,150,35,67,102,3,100
4850,150,12,20,32,3,100
4851,150,92,102,194,3,100
4852,150,107,153,260,3,100
4853,150,95,93,188,3,100
4854,150,46,141,187,3,100
4855,150,65,84,149,3,100
4856,150,54,91,145,3,100
4857,150,69,139,208,3,100
4858,150,132,236,368,3,100
4859,150,179,277,456,3,100
4860,150,55,88,143,3,100
4861,150,42,127,169,3,100
4862,150,49,195,244,3,100
4863,150,11,39,50,3,100
4864,150,33,80,113,3,100
4865,150,157,258,415,3,100
4866,150,73,128,201,3,100
4867,150,119,160,279,3,100
4868,150,80,104,184,3,100
4869,150,80,95,175,3,100
4870,150,64,83,147,3,100
4871,150,77,148,225,3,100
4872,150,84,147,231,3,100
4873,150,28,62,90,3,100
4874,150,39,76,115,3,100
4875,150,60,116,176,3,100
4876,150,46,111,157,3,100
4877,150,47,87,134,3,100
4878,150,70,73,143,3,100
4879,150,119,198,317,3,100
4880,150,76,100,176,3,100
4881,150,122,152,274,3,100
4882,150,30,59,89,3,100
4883,150,111,85,196,3,100
4884,150,52,144,196,3,100
4885,150,47,52,99,3,100
4886,150,36,89,125,3,100
4887,150,36,49,85,3,100
4888,150,41,98,139,3,100
4889,150,107,180,287,3,100
4890,150,43,103,146,3,100
4891,150,13,35,48,3,100
4892,150,86,105,191,3,100
4893,150,34,108,142,3,100
4894,150,97,105,202,3,100
4895,150,81,160,241,3,100
4896,150,17,64,81,3,100
4897,150,56,118,174,3,100
4898,150,24,62,86,3,100
4899,150,54,74,128,3,100
4900,150,119,113,232,3,100
4901,150,53,80,133,3,100
4902,150,112,229,341,3,100
4903,150,114,185,299,3,100
4904,150,117,195,312,3,100
4905,150,20,51,71,3,100
4906,150,28,44,72,3,100
4907,150,91,211,302,3,100
4908,150,96,69,165,3,100
4909,150,67,139,206,3,100
4910,150,128,187,315,3,100
4911,150,115,183,298,3,100
4912,150,22,37,59,3,100
4913,150,119,120,239,3,100
4914,150,55,93,148,3,100
4915,150,12,18,30,3,100
4916,150,49,115,164,3,100
4917,150,48,80,128,3,100
4918,150,21,37,58,3,100
4919,150,11,59,70,3,100
4920,150,23,63,86,3,100
4921,150,32,65,97,3,100
4922,150,75,80,155,3,100
4923,150,23,26,49,3,100
4924,150,145,226,371,3,100
4925,150,114,199,313,3,100
4926,150,41,96,137,3,100
4927,150,75,98,173,3,100
4928,150,93,191,284,3,100
4929,150,44,84,128,3,100
4930,150,113,143,256,3,100
4931,150,42,37,79,3,100
4932,150,39,79,118,3,100
4933,150,34,40,74,3,100
4934,150,19,23,42,3,100
4935,150,37,62,99,3,100
4936,150,20,23,43,3,100
4937,150,48,100,148,3,100
4938,150,24,34,58,3,100
4939,150,13,21,34,3,100
4940,150,64,110,174,3,100
4941,150,124,298,422,3,100
4942,150,69,94,163,3,100
4943,150,63,82,145,3,100
4944,150,98,203,301,3,100
4945,150,64,141,205,3,100
4946,150,29,69,98,3,100
4947,150,50,101,151,3,100
4948,150,72,118,190,3,100
4949,150,89,102,191,3,100
4950,150,27,62,89,3,100
4951,150,41,27,68,3,100
4952,150,29,28,57,3,100
4953,150,25,46,71,3,100
4954,150,52,79,131,3,100
4955,150,7,19,26,3,100
4956,150,65,123,188,3,100
4957,150,91,75,166,3,100
4958,150,60,96,156,3,100
4959,150,20,31,51,3,100
4960,150,110,202,312,3,100
4961,150,84,162,246,3,100
4962,150,80,104,184,3,100
4963,150,106,188,294,3,100
4964,150,48,84,132,3,100
4965,150,118,146,264,3,100
4966,150,45,64,109,3,100
4967,150,2,15,17,3,100
4968,150,40,94,134,3,100
4969,150,117,197,314,3,100
4970,150,73,157,230,3,100
4971,150,71,89,160,3,100
4972,150,67,150,217,3,100
4973,150,48,104,152,3,100
4974,150,30,81,111,3,100
4975,150,88,175,263,3,100
4976,150,27,43,70,3,100
4977,150,83,134,217,3,100
4978,150,0,0,0,3,100
4979,150,95,159,254,3,100
4980,150,66,68,134,3,100
4981,150,15,13,28,3,100
4982,150,19,60,79,3,100
4983,150,32,56,88,3,100
4984,150,143,167,310,3,100
4985,150,46,81,127,3,100
4986,150,83,103,186,3,100
4987,150,68,96,164,3,100
4988,150,55,140,195,3,100
4989,150,26,80,106,3,100
4990,150,16,44,60,3,100
4991,150,126,214,340,3,100
4992,150,43,76,119,3,100
4993,150,27,84,111,3,100
4994,150,22,42,64,3,100
4995,150,54,45,99,3,100
4996,150,68,52,120,3,100
4997,150,54,72,126,3,100
4998,150,59,77,136,3,100
4999,150,26,92,118,3,100
5000,150,42,126,168,3,100
5001,150,115,142,257,3,100
5002,150,112,111,223,3,100
5003,150,47,56,103,3,100
5004,150,90,81,171,3,100
5005,150,37,85,122,3,100
5006,150,61,64,125,3,100
5007,150,37,59,96,3,100
5008,150,18,44,62,3,100
5009,150,82,135,217,3,100
5010,150,90,152,242,3,100
5011,150,92,91,183,3,100
5012,150,35,64,99,3,100
5013,150,253,300,553,3,100
5014,150,99,147,246,3,100
5015,150,84,122,206,3,100
5016,150,71,65,136,3,100
5017,150,127,156,283,3,100
5018,150,58,70,128,3,100
5019,150,29,58,87,3,100
5020,150,31,79,110,3,100
5021,150,27,50,77,3,100
5022,150,96,70,166,3,100
5023,150,54,134,188,3,100
5024,150,13,60,73,3,100
5025,150,8,25,33,3,100
5026,150,28,59,87,3,100
5027,150,6,80,86,3,100
5028,150,76,167,243,3,100
5029,150,100,155,255,3,100
5030,150,96,142,238,3,100
5031,150,21,143,164,3,100
5032,150,67,116,183,3,100
5033,150,102,170,272,3,100
5034,150,85,132,217,3,100
5035,150,18,52,70,3,100
5036,150,20,34,54,3,100
5037,150,44,83,127,3,100
5038,150,58,95,153,3,100
5039,150,36,82,118,3,100
5040,150,2,7,9,3,100
5041,150,57,144,201,3,100
5042,150,183,256,439,3,100
5043,150,42,83,125,3,100
5044,150,46,78,124,3,100
5045,150,59,82,141,3,100
5046,150,31,37,68,3,100
5047,150,101,115,216,3,100
5048,150,45,75,120,3,100
5049,150,186,190,376,3,100
5050,150,75,110,185,3,100
5051,150,88,131,219,3,100
5052,150,74,101,175,3,100
5053,150,99,146,245,3,100
5054,150,42,104,146,3,100
5055,150,57,68,125,3,100
5056,150,30,92,122,3,100
5057,150,54,72,126,3,100
5058,150,95,203,298,3,100
5059,150,44,123,167,3,100
5060,150,37,60,97,3,100
5061,150,20,46,66,3,100
5062,150,52,78,130,3,100
5063,150,75,273,348,3,100
5064,150,75,167,242,3,100
5065,150,9,27,36,3,100
5066,150,20,27,47,3,100
5067,150,94,30,124,3,100
5068,150,17,54,71,3,100
5069,150,39,52,91,3,100
5070,150,110,128,238,3,100
5071,150,101,142,243,3,100
5072,150,166,262,428,3,100
5073,150,79,110,189,3,100
5074,150,128,201,329,3,100
5075,150,56,81,137,3,100
5076,150,91,110,201,3,100
5077,150,52,89,141,3,100
5078,150,37,64,101,3,100
5079,150,35,71,106,3,100
5080,150,54,131,185,3,100
5081,150,36,47,83,3,100
5082,150,10,19,29,3,100
5083,150,57,50,107,3,100
5084,150,23,19,42,3,100
5085,150,71,152,223,3,100
5086,150,9,24,33,3,100
5087,150,82,138,220,3,100
5088,150,88,157,245,3,100
5089,150,106,31,137,3,100
5090,150,48,67,115,3,100
5091,150,67,110,177,3,100
5092,150,97,181,278,3,100
5093,150,89,97,186,3,100
5094,150,65,145,210,3,100
5095,150,86,132,218,3,100
5096,150,43,91,134,3,100
5097,150,154,141,295,3,100
5098,150,16,56,72,3,100
5099,150,42,57,99,3,100
5100,150,40,81,121,3,100
5101,150,49,23,72,3,100
5102,150,64,66,130,3,100
5103,150,17,49,66,3,100
5104,150,64,75,139,3,100
5105,150,39,145,184,3,100
5106,150,71,164,235,3,100
5107,150,47,100,147,3,100
5108,150,39,112,151,3,100
5109,150,51,145,196,3,100
5110,150,51,68,119,3,100
5111,150,100,105,205,3,100
5112,150,130,160,290,3,100
5113,150,33,156,189,3,100
5114,150,51,69,120,3,100
5115,150,96,118,214,3,100
5116,150,101,192,293,3,100
5117,150,133,129,262,3,100
5118,150,45,65,110,3,100
5119,150,116,138,254,3,100
5120,150,67,82,149,3,100
5121,150,48,51,99,3,100
5122,150,31,73,104,3,100
5123,150,17,37,54,3,100
5124,150,15,24,39,3,100
5125,150,100,150,250,3,100
5126,150,189,204,393,3,100
5127,150,106,166,272,3,100
5128,150,120,87,207,3,100
5129,150,100,143,243,3,100
5130,150,124,120,244,3,100
5131,150,45,61,106,3,100
5132,150,35,70,105,3,100
5133,150,66,90,156,3,100
5134,150,55,68,123,3,100
5135,150,87,102,189,3,100
5136,150,62,107,169,3,100
5137,150,29,45,74,3,100
5138,150,72,87,159,3,100
5139,150,13,21,34,3,100
5140,150,24,77,101,3,100
5141,150,51,81,132,3,100
5142,150,34,54,88,3,100
5143,150,27,68,95,3,100
5144,150,24,41,65,3,100
5145,150,33,48,81,3,100
5146,150,66,140,206,3,100
5147,150,70,121,191,3,100
5148,150,60,111,171,3,100
5149,150,45,67,112,3,100
5150,150,110,167,277,3,100
5151,150,70,105,175,3,100
5152,150,27,55,82,3,100
5153,150,91,117,208,3,100
5154,150,51,87,138,3,100
5155,150,38,76,114,3,100
5156,150,29,28,57,3,100
5157,150,108,152,260,3,100
5158,150,69,88,157,3,100
5159,150,81,183,264,3,100
5160,150,93,169,262,3,100
5161,150,61,121,182,3,100
5162,150,81,172,253,3,100
5163,150,80,95,175,3,100
5164,150,57,104,161,3,100
5165,150,52,114,166,3,100
5166,150,74,125,199,3,100
5167,150,43,53,96,3,100
5168,150,79,107,186,3,100
5169,150,48,95,143,3,100
5170,150,35,58,93,3,100
5171,150,29,97,126,3,100
5172,150,72,120,192,3,100
5173,150,77,121,198,3,100
5174,150,63,58,121,3,100
5175,150,14,29,43,3,100
5176,150,66,163,229,3,100
5177,150,30,40,70,3,100
5178,150,130,232,362,3,100
5179,150,303,369,672,3,100
5180,150,24,28,52,3,100
5181,150,39,58,97,3,100
5182,150,120,180,300,3,100
5183,150,28,66,94,3,100
5184,150,78,124,202,3,100
5185,150,72,78,150,3,100
5186,150,81,216,297,3,100
5187,150,134,170,304,3,100
5188,150,54,140,194,3,100
5189,150,91,183,274,3,100
5190,150,66,123,189,3,100
5191,150,29,79,108,3,100
5192,150,57,95,152,3,100
5193,150,39,107,146,3,100
5194,150,17,65,82,3,100
5195,150,9,57,66,3,100
5196,150,46,102,148,3,100
5197,150,80,178,258,3,100
5198,150,63,161,224,3,100
5199,150,85,142,227,3,100
5200,150,80,147,227,3,100
5201,150,90,268,358,3,100
5202,150,34,90,124,3,100
5203,150,52,162,214,3,100
5204,150,90,204,294,3,100
5205,150,24,203,227,3,100
5206,150,62,184,246,3,100
5207,150,59,71,130,3,100
5208,150,41,101,142,3,100
5209,150,19,82,101,3,100
5210,150,145,216,361,3,100
5211,150,7,30,37,3,100
5212,150,64,122,186,3,100
5213,150,28,44,72,3,100
5214,150,77,49,126,3,100
5215,150,92,137,229,3,100
5216,150,46,128,174,3,100
5217,150,209,331,540,3,100
5218,150,86,192,278,3,100
5219,150,41,114,155,3,100
5220,150,96,155,251,3,100
5221,150,24,76,100,3,100
5222,150,148,312,460,3,100
5223,150,42,150,192,3,100
5224,150,150,336,486,3,100
5225,150,43,126,169,3,100
5226,150,151,254,405,3,100
5227,150,51,111,162,3,100
5228,150,77,223,300,3,100
5229,150,68,100,168,3,100
5230,150,26,40,66,3,100
5231,150,124,168,292,3,100
5232,150,30,34,64,3,100
5233,150,95,196,291,3,100
5234,150,135,222,357,3,100
5235,150,78,150,228,3,100
5236,150,113,201,314,3,100
5237,150,134,182,316,3,100
5238,150,71,186,257,3,100
5239,150,39,101,140,3,100
5240,150,154,183,337,3,100
5241,150,98,60,158,3,100
5242,150,3,21,24,3,100
5243,150,78,127,205,3,100
5244,150,77,140,217,3,100
5245,150,110,257,367,3,100
5246,150,114,151,265,3,100
5247,150,131,143,274,3,100
5248,150,190,335,525,3,100
5249,150,130,235,365,3,100
5250,150,182,254,436,3,100
5251,150,183,205,388,3,100
5252,150,221,150,371,3,100
5253,150,59,214,273,3,100
5254,150,108,209,317,3,100
5255,150,28,107,135,3,100
5256,150,74,155,229,3,100
5257,150,53,81,134,3,100
5258,150,23,29,52,3,100
5259,150,38,99,137,3,100
5260,150,83,170,253,3,100
5261,150,63,32,95,3,100
5262,150,104,184,288,3,100
5263,150,114,324,438,3,100
5264,150,124,268,392,3,100
5265,150,105,415,520,3,100
5266,150,79,133,212,3,100
5267,150,136,351,487,3,100
5268,150,94,253,347,3,100
5269,150,134,238,372,3,100
5270,150,53,254,307,3,100
5271,150,78,157,235,3,100
5272,150,41,65,106,3,100
5273,150,125,248,373,3,100
5274,150,89,194,283,3,100
5275,150,112,210,322,3,100
5276,150,126,102,228,3,100
5277,150,32,31,63,3,100
5278,150,28,81,109,3,100
5279,150,169,380,549,3,100
5280,150,30,53,83,3,100
5281,150,137,280,417,3,100
5282,150,128,245,373,3,100
5283,150,123,391,514,3,100
5284,150,145,331,476,3,100
5285,150,42,51,93,3,100
5286,150,25,71,96,3,100
5287,150,122,183,305,3,100
5288,150,54,104,158,3,100
5289,150,16,34,50,3,100
5290,150,64,139,203,3,100
5291,150,38,87,125,3,100
5292,150,16,71,87,3,100
5293,150,14,23,37,3,100
5294,150,28,25,53,3,100
5295,150,81,178,259,3,100
5296,150,88,183,271,3,100
5297,150,93,216,309,3,100
5298,150,47,134,181,3,100
5299,150,129,283,412,3,100
5300,150,184,432,616,3,100
5301,150,105,294,399,3,100
5302,150,65,122,187,3,100
5303,150,63,231,294,3,100
5304,150,40,191,231,3,100
5305,150,55,151,206,3,100
5306,150,84,103,187,3,100
5307,150,47,196,243,3,100
5308,150,25,38,63,3,100
5309,150,65,71,136,3,100
5310,150,19,74,93,3,100
5311,150,76,274,350,3,100
5312,150,57,168,225,3,100
5313,150,83,192,275,3,100
5314,150,81,184,265,3,100
5315,150,59,96,155,3,100
5316,150,198,470,668,3,100
5317,150,72,226,298,3,100
5318,150,148,207,355,3,100
5319,150,64,147,211,3,100
5320,150,176,264,440,3,100
5321,150,102,162,264,3,100
5322,150,99,229,328,3,100
5323,150,109,244,353,3,100
5324,150,66,146,212,3,100
5325,150,10,84,94,3,100
5326,150,122,240,362,3,100
5327,150,34,98,132,3,100
5328,180,90,133,223,3,100
5329,180,44,113,157,3,100
5330,180,150,239,389,3,100
5331,180,171,173,344,3,100
5332,180,85,112,197,3,100
5333,180,58,160,218,3,100
5334,180,162,235,397,3,100
5335,180,106,190,296,3,100
5336,180,97,174,271,3,100
5337,180,74,192,266,3,100
5338,180,10,47,57,3,100
5339,180,38,63,101,3,100
5340,180,83,102,185,3,100
5341,180,145,149,294,3,100
5342,180,72,100,172,3,100
5343,180,72,143,215,3,100
5344,180,32,114,146,3,100
5345,180,244,265,509,3,100
5346,180,152,204,356,3,100
5347,180,63,109,172,3,100
5348,180,100,203,303,3,100
5349,180,76,120,196,3,100
5350,180,82,137,219,3,100
5351,180,29,52,81,3,100
5352,180,129,252,381,3,100
5353,180,87,208,295,3,100
5354,180,62,108,170,3,100
5355,180,59,128,187,3,100
5356,180,58,155,213,3,100
5357,180,28,36,64,3,100
5358,180,19,19,38,3,100
5359,180,19,57,76,3,100
5360,180,125,159,284,3,100
5361,180,109,119,228,3,100
5362,180,138,146,284,3,100
5363,180,124,236,360,3,100
5364,180,129,142,271,3,100
5365,180,68,176,244,3,100
5366,180,22,51,73,3,100
5367,180,123,242,365,3,100
5368,180,122,275,397,3,100
5369,180,64,89,153,3,100
5370,180,55,77,132,3,100
5371,180,70,85,155,3,100
5372,180,45,51,96,3,100
5373,180,63,82,145,3,100
5374,180,44,48,92,3,100
5375,180,24,102,126,3,100
5376,180,28,66,94,3,100
5377,180,26,43,69,3,100
5378,180,13,22,35,3,100
5379,180,40,145,185,3,100
5380,180,49,149,198,3,100
5381,180,29,12,41,3,100
5382,180,21,47,68,3,100
5383,180,101,188,289,3,100
5384,180,52,96,148,3,100
5385,180,102,188,290,3,100
5386,180,87,140,227,3,100
5387,180,175,207,382,3,100
5388,180,107,196,303,3,100
5389,180,183,242,425,3,100
5390,180,37,69,106,3,100
5391,180,71,226,297,3,100
5392,180,41,68,109,3,100
5393,180,20,38,58,3,100
5394,180,21,44,65,3,100
5395,180,45,91,136,3,100
5396,180,79,104,183,3,100
5397,180,82,157,239,3,100
5398,180,65,72,137,3,100
5399,180,73,65,138,3,100
5400,180,62,72,134,3,100
5401,180,40,137,177,3,100
5402,180,54,73,127,3,100
5403,180,45,69,114,3,100
5404,180,101,182,283,3,100
5405,180,66,113,179,3,100
5406,180,67,82,149,3,100
5407,180,42,61,103,3,100
5408,180,96,197,293,3,100
5409,180,53,97,150,3,100
5410,180,74,43,117,3,100
5411,180,36,62,98,3,100
5412,180,54,81,135,3,100
5413,180,28,33,61,3,100
5414,180,51,95,146,3,100
5415,180,74,123,197,3,100
5416,180,23,42,65,3,100
5417,180,37,70,107,3,100
5418,180,75,69,144,3,100
5419,180,36,80,116,3,100
5420,180,140,265,405,3,100
5421,180,48,79,127,3,100
5422,180,104,215,319,3,100
5423,180,76,126,202,3,100
5424,180,74,175,249,3,100
5425,180,36,103,139,3,100
5426,180,38,62,100,3,100
5427,180,28,53,81,3,100
5428,180,11,47,58,3,100
5429,180,78,225,303,3,100
5430,180,68,123,191,3,100
5431,180,41,175,216,3,100
5432,180,86,203,289,3,100
5433,180,97,171,268,3,100
5434,180,83,107,190,3,100
5435,180,33,115,148,3,100
5436,180,51,110,161,3,100
5437,180,69,125,194,3,100
5438,180,49,72,121,3,100
5439,180,156,242,398,3,100
5440,180,38,79,117,3,100
5441,180,10,50,60,3,100
5442,180,77,134,211,3,100
5443,180,27,42,69,3,100
5444,180,32,76,108,3,100
5445,180,22,73,95,3,100
5446,180,95,86,181,3,100
5447,180,69,81,150,3,100
5448,180,54,46,100,3,100
5449,180,50,103,153,3,100
5450,180,70,88,158,3,100
5451,180,100,119,219,3,100
5452,180,89,103,192,3,100
5453,180,98,137,235,3,100
5454,180,144,253,397,3,100
5455,180,39,78,117,3,100
5456,180,118,237,355,3,100
5457,180,145,292,437,3,100
5458,180,33,80,113,3,100
5459,180,41,88,129,3,100
5460,180,49,111,160,3,100
5461,180,25,90,115,3,100
5462,180,126,143,269,3,100
5463,180,59,35,94,3,100
5464,180,16,39,55,3,100
5465,180,72,138,210,3,100
5466,180,30,115,145,3,100
5467,180,59,111,170,3,100
5468,180,83,208,291,3,100
5469,180,73,180,253,3,100
5470,180,53,135,188,3,100
5471,180,18,60,78,3,100
5472,180,62,118,180,3,100
5473,180,43,108,151,3,100
5474,180,23,58,81,3,100
5475,180,90,106,196,3,100
5476,180,30,104,134,3,100
5477,180,16,82,98,3,100
5478,180,30,53,83,3,100
5479,180,48,88,136,3,100
5480,180,108,202,310,3,100
5481,180,63,75,138,3,100
5482,180,44,92,136,3,100
5483,180,84,86,170,3,100
5484,180,57,46,103,3,100
5485,180,89,172,261,3,100
5486,180,82,114,196,3,100
5487,180,133,171,304,3,100
5488,180,56,166,222,3,100
5489,180,84,113,197,3,100
5490,180,53,101,154,3,100
5491,180,47,114,161,3,100
5492,180,61,109,170,3,100
5493,180,36,57,93,3,100
5494,180,14,32,46,3,100
5495,180,117,175,292,3,100
5496,180,120,243,363,3,100
5497,180,69,140,209,3,100
5498,180,141,235,376,3,100
5499,180,106,45,151,3,100
5500,180,82,165,247,3,100
5501,180,166,257,423,3,100
5502,180,40,71,111,3,100
5503,180,31,48,79,3,100
5504,180,147,181,328,3,100
5505,180,154,152,306,3,100
5506,180,38,72,110,3,100
5507,180,92,155,247,3,100
5508,180,56,131,187,3,100
5509,180,24,51,75,3,100
5510,180,114,176,290,3,100
5511,180,111,187,298,3,100
5512,180,94,220,314,3,100
5513,180,111,140,251,3,100
5514,180,116,244,360,3,100
5515,180,98,143,241,3,100
5516,180,19,41,60,3,100
5517,180,104,182,286,3,100
5518,180,53,89,142,3,100
5519,180,14,24,38,3,100
5520,180,59,117,176,3,100
5521,180,21,46,67,3,100
5522,180,28,44,72,3,100
5523,180,160,258,418,3,100
5524,180,65,41,106,3,100
5525,180,66,91,157,3,100
5526,180,131,200,331,3,100
5527,180,33,55,88,3,100
5528,180,55,117,172,3,100
5529,180,135,235,370,3,100
5530,180,89,165,254,3,100
5531,180,31,51,82,3,100
5532,180,123,224,347,3,100
5533,180,26,47,73,3,100
5534,180,39,206,245,3,100
5535,180,16,34,50,3,100
5536,180,20,15,35,3,100
5537,180,105,170,275,3,100
5538,180,23,31,54,3,100
5539,180,22,61,83,3,100
5540,180,7,50,57,3,100
5541,180,172,293,465,3,100
5542,180,28,51,79,3,100
5543,180,46,60,106,3,100
5544,180,105,147,252,3,100
5545,180,248,457,705,3,100
5546,180,98,125,223,3,100
5547,180,70,112,182,3,100
5548,180,42,71,113,3,100
5549,180,21,74,95,3,100
5550,180,62,70,132,3,100
5551,180,56,102,158,3,100
5552,180,62,54,116,3,100
5553,180,42,73,115,3,100
5554,180,86,104,190,3,100
5555,180,144,219,363,3,100
5556,180,40,94,134,3,100
5557,180,64,153,217,3,100
5558,180,134,211,345,3,100
5559,180,86,130,216,3,100
5560,180,76,129,205,3,100
5561,180,85,189,274,3,100
5562,180,132,215,347,3,100
5563,180,125,242,367,3,100
5564,180,71,195,266,3,100
5565,180,86,84,170,3,100
5566,180,56,102,158,3,100
5567,180,57,61,118,3,100
5568,180,60,55,115,3,100
5569,180,38,50,88,3,100
5570,180,36,44,80,3,100
5571,180,44,64,108,3,100
5572,180,75,151,226,3,100
5573,180,72,163,235,3,100
5574,180,13,31,44,3,100
5575,180,67,98,165,3,100
5576,180,74,139,213,3,100
5577,180,60,107,167,3,100
5578,180,87,207,294,3,100
5579,180,64,122,186,3,100
5580,180,97,139,236,3,100
5581,180,34,50,84,3,100
5582,180,133,268,401,3,100
5583,180,158,229,387,3,100
5584,180,120,128,248,3,100
5585,180,27,54,81,3,100
5586,180,132,254,386,3,100
5587,180,93,130,223,3,100
5588,180,24,46,70,3,100
5589,180,110,156,266,3,100
5590,180,64,48,112,3,100
5591,180,38,94,132,3,100
5592,180,104,192,296,3,100
5593,180,40,83,123,3,100
5594,180,55,70,125,3,100
5595,180,75,126,201,3,100
5596,180,57,105,162,3,100
5597,180,84,196,280,3,100
5598,180,113,46,159,3,100
5599,180,42,134,176,3,100
5600,180,180,119,299,3,100
5601,180,118,122,240,3,100
5602,180,91,96,187,3,100
5603,180,54,106,160,3,100
5604,180,53,89,142,3,100
5605,180,78,136,214,3,100
5606,180,43,66,109,3,100
5607,180,89,153,242,3,100
5608,180,116,165,281,3,100
5609,180,81,191,272,3,100
5610,180,7,32,39,3,100
5611,180,21,57,78,3,100
5612,180,26,55,81,3,100
5613,180,86,123,209,3,100
5614,180,204,166,370,3,100
5615,180,74,136,210,3,100
5616,180,104,205,309,3,100
5617,180,61,128,189,3,100
5618,180,60,97,157,3,100
5619,180,71,181,252,3,100
5620,180,61,49,110,3,100
5621,180,77,96,173,3,100
5622,180,65,102,167,3,100
5623,180,56,59,115,3,100
5624,180,16,15,31,3,100
5625,180,54,62,116,3,100
5626,180,137,118,255,3,100
5627,180,23,34,57,3,100
5628,180,92,64,156,3,100
5629,180,43,45,88,3,100
5630,180,93,100,193,3,100
5631,180,48,94,142,3,100
5632,180,144,176,320,3,100
5633,180,86,108,194,3,100
5634,180,118,203,321,3,100
5635,180,115,175,290,3,100
5636,180,132,196,328,3,100
5637,180,86,148,234,3,100
5638,180,59,97,156,3,100
5639,180,131,161,292,3,100
5640,180,76,91,167,3,100
5641,180,194,251,445,3,100
5642,180,40,62,102,3,100
5643,180,107,233,340,3,100
5644,180,35,153,188,3,100
5645,180,116,154,270,3,100
5646,180,95,190,285,3,100
5647,180,208,205,413,3,100
5648,180,173,229,402,3,100
5649,180,70,178,248,3,100
5650,180,81,134,215,3,100
5651,180,66,72,138,3,100
5652,180,71,146,217,3,100
5653,180,99,182,281,3,100
5654,180,47,93,140,3,100
5655,180,35,80,115,3,100
5656,180,62,103,165,3,100
5657,180,13,33,46,3,100
5658,180,22,48,70,3,100
5659,180,34,39,73,3,100
5660,180,33,71,104,3,100
5661,180,27,62,89,3,100
5662,180,28,117,145,3,100
5663,180,47,92,139,3,100
5664,180,39,96,135,3,100
5665,180,94,145,239,3,100
5666,180,49,58,107,3,100
5667,180,156,265,421,3,100
5668,180,79,57,136,3,100
5669,180,46,124,170,3,100
5670,180,80,91,171,3,100
5671,180,75,121,196,3,100
5672,180,61,93,154,3,100
5673,180,44,100,144,3,100
5674,180,101,136,237,3,100
5675,180,81,73,154,3,100
5676,180,74,146,220,3,100
5677,180,16,78,94,3,100
5678,180,48,119,167,3,100
5679,180,67,85,152,3,100
5680,180,73,152,225,3,100
5681,180,101,135,236,3,100
5682,180,42,88,130,3,100
5683,180,77,108,185,3,100
5684,180,101,156,257,3,100
5685,180,51,68,119,3,100
5686,180,41,75,116,3,100
5687,180,92,130,222,3,100
5688,180,60,106,166,3,100
5689,180,59,46,105,3,100
5690,180,99,145,244,3,100
5691,180,49,83,132,3,100
5692,180,96,109,205,3,100
5693,180,69,97,166,3,100
5694,180,39,67,106,3,100
5695,180,109,143,252,3,100
5696,180,96,101,197,3,100
5697,180,42,151,193,3,100
5698,180,5,17,22,3,100
5699,180,102,151,253,3,100
5700,180,64,126,190,3,100
5701,180,109,167,276,3,100
5702,180,34,110,144,3,100
5703,180,86,122,208,3,100
5704,180,117,153,270,3,100
5705,180,88,117,205,3,100
5706,180,53,123,176,3,100
5707,180,159,223,382,3,100
5708,180,75,102,177,3,100
5709,180,58,186,244,3,100
5710,180,78,175,253,3,100
5711,180,11,46,57,3,100
5712,180,146,151,297,3,100
5713,180,48,35,83,3,100
5714,180,61,98,159,3,100
5715,180,48,182,230,3,100
5716,180,82,77,159,3,100
5717,180,54,122,176,3,100
5718,180,61,117,178,3,100
5719,180,32,93,125,3,100
5720,180,39,46,85,3,100
5721,180,138,118,256,3,100
5722,180,112,134,246,3,100
5723,180,72,110,182,3,100
5724,180,33,62,95,3,100
5725,180,37,47,84,3,100
5726,180,60,88,148,3,100
5727,180,11,17,28,3,100
5728,180,17,25,42,3,100
5729,180,11,54,65,3,100
5730,180,65,154,219,3,100
5731,180,128,151,279,3,100
5732,180,47,98,145,3,100
5733,180,107,160,267,3,100
5734,180,68,128,196,3,100
5735,180,79,136,215,3,100
5736,180,62,109,171,3,100
5737,180,62,163,225,3,100
5738,180,77,66,143,3,100
5739,180,48,49,97,3,100
5740,180,110,168,278,3,100
5741,180,83,96,179,3,100
5742,180,20,91,111,3,100
5743,180,65,139,204,3,100
5744,180,41,88,129,3,100
5745,180,17,36,53,3,100
5746,180,53,110,163,3,100
5747,180,55,119,174,3,100
5748,180,165,193,358,3,100
5749,180,140,205,345,3,100
5750,180,75,131,206,3,100
5751,180,90,206,296,3,100
5752,180,142,187,329,3,100
5753,180,83,151,234,3,100
5754,180,28,60,88,3,100
5755,180,133,208,341,3,100
5756,180,62,91,153,3,100
5757,180,81,166,247,3,100
5758,180,77,149,226,3,100
5759,180,17,39,56,3,100
5760,180,21,18,39,3,100
5761,180,7,14,21,3,100
5762,180,1,7,8,3,100
5763,180,45,125,170,3,100
5764,180,11,45,56,3,100
5765,180,51,77,128,3,100
5766,180,95,62,157,3,100
5767,180,46,98,144,3,100
5768,180,108,167,275,3,100
5769,180,74,114,188,3,100
5770,180,93,71,164,3,100
5771,180,81,166,247,3,100
5772,180,112,188,300,3,100
5773,180,89,157,246,3,100
5774,180,27,74,101,3,100
5775,180,79,67,146,3,100
5776,180,255,142,397,3,100
5777,180,25,15,40,3,100
5778,180,14,80,94,3,100
5779,180,91,136,227,3,100
5780,180,102,162,264,3,100
5781,180,101,235,336,3,100
5782,180,80,117,197,3,100
5783,180,22,66,88,3,100
5784,180,59,109,168,3,100
5785,180,46,101,147,3,100
5786,180,110,155,265,3,100
5787,180,42,35,77,3,100
5788,180,61,143,204,3,100
5789,180,58,140,198,3,100
5790,180,31,68,99,3,100
5791,180,9,41,50,3,100
5792,180,72,171,243,3,100
5793,180,72,136,208,3,100
5794,180,28,45,73,3,100
5795,180,76,124,200,3,100
5796,180,84,189,273,3,100
5797,180,48,83,131,3,100
5798,180,170,297,467,3,100
5799,180,217,154,371,3,100
5800,180,21,28,49,3,100
5801,180,37,80,117,3,100
5802,180,140,143,283,3,100
5803,180,164,234,398,3,100
5804,180,66,97,163,3,100
5805,180,65,56,121,3,100
5806,180,11,22,33,3,100
5807,180,36,51,87,3,100
5808,180,32,57,89,3,100
5809,180,16,139,155,3,100
5810,180,78,113,191,3,100
5811,180,61,124,185,3,100
5812,180,37,65,102,3,100
5813,180,108,225,333,3,100
5814,180,148,257,405,3,100
5815,180,72,129,201,3,100
5816,180,93,202,295,3,100
5817,180,176,189,365,3,100
5818,180,18,32,50,3,100
5819,180,150,166,316,3,100
5820,180,94,138,232,3,100
5821,180,91,120,211,3,100
5822,180,89,73,162,3,100
5823,180,38,78,116,3,100
5824,180,89,121,210,3,100
5825,180,32,48,80,3,100
5826,180,104,158,262,3,100
5827,180,38,71,109,3,100
5828,180,15,58,73,3,100
